Fecha,Hora,Nivel_Escolar,Marca,Inventario_Inicial,Ventas,Inventario_Final
2025-08-01,9,Preescolar,SuperSchool,64,11,53
2025-08-01,9,Preescolar,SuperSchool,70,7,63
2025-08-01,9,Preescolar,EduMax,260,23,237
2025-08-01,9,Preescolar,TopKids,252,24,228
2025-08-01,9,Preescolar,SuperSchool,149,8,141
2025-08-01,9,Preescolar,TopKids,199,21,178
2025-08-01,9,Preescolar,EduMax,137,12,125
2025-08-01,9,Preescolar,EduMax,87,2,85
2025-08-01,9,Preescolar,SuperSchool,210,12,198
2025-08-01,9,Preescolar,EduMax,71,12,59
2025-08-01,9,Preescolar,SuperSchool,98,10,88
2025-08-01,9,Kínder,TopKids,239,15,224
2025-08-01,9,Kínder,EduMax,100,12,88
2025-08-01,9,Kínder,TopKids,293,3,290
2025-08-01,9,Kínder,SuperSchool,100,7,93
2025-08-01,9,Kínder,SuperSchool,122,7,115
2025-08-01,9,Kínder,EduMax,181,14,167
2025-08-01,9,Kínder,EduMax,299,9,290
2025-08-01,9,Kínder,EduMax,102,2,100
2025-08-01,9,Kínder,TopKids,237,7,230
2025-08-01,9,Kínder,SuperSchool,57,15,42
2025-08-01,9,Kínder,TopKids,255,17,238
2025-08-01,9,Kínder,EduMax,153,4,149
2025-08-01,9,Kínder,EduMax,183,22,161
2025-08-01,9,Kínder,EduMax,53,22,31
2025-08-01,9,Kínder,SuperSchool,240,18,222
2025-08-01,9,Kínder,EduMax,93,2,91
2025-08-01,9,Primaria 1°,EduMax,277,14,263
2025-08-01,9,Primaria 1°,TopKids,97,15,82
2025-08-01,9,Primaria 1°,EduMax,264,8,256
2025-08-01,9,Primaria 1°,SuperSchool,257,13,244
2025-08-01,9,Primaria 1°,EduMax,160,21,139
2025-08-01,9,Primaria 1°,EduMax,266,13,253
2025-08-01,9,Primaria 1°,SuperSchool,206,15,191
2025-08-01,9,Primaria 1°,SuperSchool,114,7,107
2025-08-01,9,Primaria 1°,SuperSchool,137,1,136
2025-08-01,9,Primaria 1°,TopKids,188,19,169
2025-08-01,9,Primaria 1°,SuperSchool,185,3,182
2025-08-01,9,Primaria 1°,TopKids,82,5,77
2025-08-01,9,Primaria 1°,EduMax,280,9,271
2025-08-01,9,Primaria 1°,TopKids,250,8,242
2025-08-01,9,Primaria 2°,EduMax,82,16,66
2025-08-01,9,Primaria 2°,TopKids,200,24,176
2025-08-01,9,Primaria 2°,SuperSchool,148,12,136
2025-08-01,9,Primaria 2°,EduMax,268,3,265
2025-08-01,9,Primaria 2°,SuperSchool,276,5,271
2025-08-01,9,Primaria 2°,TopKids,255,3,252
2025-08-01,9,Primaria 2°,SuperSchool,54,23,31
2025-08-01,9,Primaria 2°,TopKids,191,7,184
2025-08-01,9,Primaria 2°,TopKids,186,15,171
2025-08-01,9,Primaria 2°,TopKids,139,10,129
2025-08-01,9,Primaria 2°,SuperSchool,228,7,221
2025-08-01,9,Primaria 2°,SuperSchool,101,4,97
2025-08-01,9,Primaria 2°,EduMax,278,23,255
2025-08-01,9,Primaria 2°,TopKids,286,15,271
2025-08-01,9,Primaria 2°,TopKids,78,4,74
2025-08-01,9,Primaria 2°,SuperSchool,209,7,202
2025-08-01,9,Primaria 3°,TopKids,135,2,133
2025-08-01,9,Primaria 3°,EduMax,94,21,73
2025-08-01,9,Primaria 3°,EduMax,77,12,65
2025-08-01,9,Primaria 3°,EduMax,239,11,228
2025-08-01,9,Primaria 3°,EduMax,296,7,289
2025-08-01,9,Primaria 3°,EduMax,274,1,273
2025-08-01,9,Primaria 3°,SuperSchool,76,20,56
2025-08-01,9,Primaria 3°,SuperSchool,282,3,279
2025-08-01,9,Primaria 3°,TopKids,247,8,239
2025-08-01,9,Primaria 3°,TopKids,186,5,181
2025-08-01,9,Primaria 3°,SuperSchool,100,10,90
2025-08-01,9,Primaria 3°,TopKids,108,22,86
2025-08-01,9,Primaria 3°,SuperSchool,229,17,212
2025-08-01,9,Primaria 3°,EduMax,290,20,270
2025-08-01,9,Primaria 3°,EduMax,88,2,86
2025-08-01,9,Primaria 4°,SuperSchool,150,17,133
2025-08-01,9,Primaria 4°,SuperSchool,236,17,219
2025-08-01,9,Primaria 4°,EduMax,179,22,157
2025-08-01,9,Primaria 4°,TopKids,278,1,277
2025-08-01,9,Primaria 4°,SuperSchool,196,2,194
2025-08-01,9,Primaria 4°,SuperSchool,221,6,215
2025-08-01,9,Primaria 4°,TopKids,117,23,94
2025-08-01,9,Primaria 5°,TopKids,194,6,188
2025-08-01,9,Primaria 5°,SuperSchool,165,2,163
2025-08-01,9,Primaria 5°,EduMax,263,11,252
2025-08-01,9,Primaria 5°,TopKids,289,16,273
2025-08-01,9,Primaria 5°,SuperSchool,250,6,244
2025-08-01,9,Primaria 5°,SuperSchool,52,20,32
2025-08-01,9,Primaria 5°,TopKids,213,19,194
2025-08-01,9,Primaria 5°,EduMax,244,19,225
2025-08-01,9,Primaria 5°,TopKids,101,9,92
2025-08-01,9,Primaria 5°,SuperSchool,217,7,210
2025-08-01,9,Primaria 5°,EduMax,153,1,152
2025-08-01,9,Primaria 5°,TopKids,269,18,251
2025-08-01,9,Primaria 5°,TopKids,208,10,198
2025-08-01,9,Primaria 5°,TopKids,56,16,40
2025-08-01,9,Primaria 5°,EduMax,161,20,141
2025-08-01,9,Primaria 6°,SuperSchool,51,1,50
2025-08-01,9,Primaria 6°,EduMax,189,5,184
2025-08-01,9,Primaria 6°,SuperSchool,209,23,186
2025-08-01,9,Primaria 6°,SuperSchool,282,3,279
2025-08-01,9,Primaria 6°,TopKids,97,16,81
2025-08-01,9,Primaria 6°,TopKids,197,24,173
2025-08-01,9,Primaria 6°,EduMax,169,1,168
2025-08-01,9,Primaria 6°,TopKids,162,8,154
2025-08-01,9,Primaria 6°,EduMax,153,20,133
2025-08-01,9,Primaria 6°,EduMax,276,16,260
2025-08-01,9,Primaria 6°,EduMax,266,3,263
2025-08-01,9,Primaria 6°,SuperSchool,142,18,124
2025-08-01,9,Primaria 6°,EduMax,131,2,129
2025-08-01,9,Primaria 6°,EduMax,212,16,196
2025-08-01,9,Primaria 6°,SuperSchool,218,4,214
2025-08-01,9,Primaria 6°,SuperSchool,117,1,116
2025-08-01,10,Preescolar,SuperSchool,97,20,77
2025-08-01,10,Preescolar,TopKids,244,17,227
2025-08-01,10,Preescolar,SuperSchool,225,12,213
2025-08-01,10,Preescolar,TopKids,164,22,142
2025-08-01,10,Preescolar,TopKids,71,14,57
2025-08-01,10,Preescolar,EduMax,87,6,81
2025-08-01,10,Preescolar,SuperSchool,100,22,78
2025-08-01,10,Preescolar,TopKids,76,2,74
2025-08-01,10,Preescolar,SuperSchool,79,1,78
2025-08-01,10,Preescolar,TopKids,241,1,240
2025-08-01,10,Preescolar,SuperSchool,110,16,94
2025-08-01,10,Preescolar,TopKids,53,3,50
2025-08-01,10,Preescolar,SuperSchool,66,12,54
2025-08-01,10,Preescolar,EduMax,270,14,256
2025-08-01,10,Preescolar,SuperSchool,55,3,52
2025-08-01,10,Preescolar,SuperSchool,86,24,62
2025-08-01,10,Preescolar,SuperSchool,290,14,276
2025-08-01,10,Preescolar,SuperSchool,144,3,141
2025-08-01,10,Kínder,SuperSchool,165,21,144
2025-08-01,10,Kínder,TopKids,210,3,207
2025-08-01,10,Kínder,EduMax,74,10,64
2025-08-01,10,Kínder,TopKids,103,3,100
2025-08-01,10,Kínder,EduMax,73,18,55
2025-08-01,10,Kínder,TopKids,135,23,112
2025-08-01,10,Kínder,EduMax,176,10,166
2025-08-01,10,Kínder,EduMax,267,17,250
2025-08-01,10,Kínder,SuperSchool,186,11,175
2025-08-01,10,Kínder,EduMax,225,7,218
2025-08-01,10,Kínder,SuperSchool,219,23,196
2025-08-01,10,Kínder,EduMax,148,18,130
2025-08-01,10,Kínder,SuperSchool,201,13,188
2025-08-01,10,Kínder,EduMax,184,4,180
2025-08-01,10,Kínder,SuperSchool,69,1,68
2025-08-01,10,Kínder,EduMax,193,14,179
2025-08-01,10,Primaria 1°,TopKids,264,15,249
2025-08-01,10,Primaria 1°,EduMax,115,23,92
2025-08-01,10,Primaria 1°,TopKids,135,19,116
2025-08-01,10,Primaria 1°,SuperSchool,235,22,213
2025-08-01,10,Primaria 1°,EduMax,107,22,85
2025-08-01,10,Primaria 1°,SuperSchool,229,10,219
2025-08-01,10,Primaria 1°,EduMax,64,22,42
2025-08-01,10,Primaria 1°,TopKids,237,5,232
2025-08-01,10,Primaria 1°,SuperSchool,57,21,36
2025-08-01,10,Primaria 1°,SuperSchool,152,4,148
2025-08-01,10,Primaria 1°,EduMax,158,20,138
2025-08-01,10,Primaria 1°,EduMax,96,3,93
2025-08-01,10,Primaria 1°,TopKids,217,20,197
2025-08-01,10,Primaria 1°,SuperSchool,163,10,153
2025-08-01,10,Primaria 1°,EduMax,196,17,179
2025-08-01,10,Primaria 1°,TopKids,68,23,45
2025-08-01,10,Primaria 2°,SuperSchool,267,21,246
2025-08-01,10,Primaria 2°,EduMax,72,9,63
2025-08-01,10,Primaria 2°,SuperSchool,178,1,177
2025-08-01,10,Primaria 2°,TopKids,83,22,61
2025-08-01,10,Primaria 2°,SuperSchool,281,13,268
2025-08-01,10,Primaria 2°,SuperSchool,178,16,162
2025-08-01,10,Primaria 2°,SuperSchool,280,5,275
2025-08-01,10,Primaria 2°,EduMax,142,23,119
2025-08-01,10,Primaria 2°,TopKids,125,16,109
2025-08-01,10,Primaria 2°,TopKids,278,22,256
2025-08-01,10,Primaria 2°,SuperSchool,78,14,64
2025-08-01,10,Primaria 2°,SuperSchool,96,17,79
2025-08-01,10,Primaria 2°,EduMax,287,20,267
2025-08-01,10,Primaria 2°,SuperSchool,253,16,237
2025-08-01,10,Primaria 3°,EduMax,225,21,204
2025-08-01,10,Primaria 3°,TopKids,149,1,148
2025-08-01,10,Primaria 3°,EduMax,271,5,266
2025-08-01,10,Primaria 3°,TopKids,299,10,289
2025-08-01,10,Primaria 3°,EduMax,118,4,114
2025-08-01,10,Primaria 3°,EduMax,229,10,219
2025-08-01,10,Primaria 3°,EduMax,196,1,195
2025-08-01,10,Primaria 3°,SuperSchool,286,4,282
2025-08-01,10,Primaria 3°,TopKids,51,17,34
2025-08-01,10,Primaria 3°,TopKids,133,24,109
2025-08-01,10,Primaria 3°,EduMax,212,1,211
2025-08-01,10,Primaria 3°,SuperSchool,238,19,219
2025-08-01,10,Primaria 3°,TopKids,150,12,138
2025-08-01,10,Primaria 3°,TopKids,114,1,113
2025-08-01,10,Primaria 4°,EduMax,92,12,80
2025-08-01,10,Primaria 4°,SuperSchool,190,12,178
2025-08-01,10,Primaria 4°,TopKids,95,2,93
2025-08-01,10,Primaria 4°,SuperSchool,292,18,274
2025-08-01,10,Primaria 4°,TopKids,264,17,247
2025-08-01,10,Primaria 4°,EduMax,57,10,47
2025-08-01,10,Primaria 4°,EduMax,211,19,192
2025-08-01,10,Primaria 4°,SuperSchool,184,4,180
2025-08-01,10,Primaria 4°,EduMax,294,18,276
2025-08-01,10,Primaria 4°,SuperSchool,124,24,100
2025-08-01,10,Primaria 4°,SuperSchool,70,4,66
2025-08-01,10,Primaria 4°,EduMax,150,9,141
2025-08-01,10,Primaria 5°,TopKids,226,3,223
2025-08-01,10,Primaria 5°,EduMax,290,7,283
2025-08-01,10,Primaria 5°,TopKids,239,5,234
2025-08-01,10,Primaria 5°,SuperSchool,232,13,219
2025-08-01,10,Primaria 5°,TopKids,266,3,263
2025-08-01,10,Primaria 5°,SuperSchool,79,17,62
2025-08-01,10,Primaria 5°,SuperSchool,111,20,91
2025-08-01,10,Primaria 5°,SuperSchool,135,13,122
2025-08-01,10,Primaria 5°,TopKids,68,17,51
2025-08-01,10,Primaria 5°,SuperSchool,282,19,263
2025-08-01,10,Primaria 5°,SuperSchool,248,14,234
2025-08-01,10,Primaria 5°,TopKids,177,20,157
2025-08-01,10,Primaria 6°,EduMax,160,16,144
2025-08-01,10,Primaria 6°,SuperSchool,118,3,115
2025-08-01,10,Primaria 6°,SuperSchool,229,21,208
2025-08-01,10,Primaria 6°,SuperSchool,200,16,184
2025-08-01,10,Primaria 6°,SuperSchool,88,13,75
2025-08-01,10,Primaria 6°,SuperSchool,91,7,84
2025-08-01,10,Primaria 6°,EduMax,272,5,267
2025-08-01,11,Preescolar,TopKids,270,11,259
2025-08-01,11,Preescolar,TopKids,195,15,180
2025-08-01,11,Preescolar,SuperSchool,123,12,111
2025-08-01,11,Preescolar,SuperSchool,279,7,272
2025-08-01,11,Preescolar,EduMax,190,8,182
2025-08-01,11,Preescolar,EduMax,186,18,168
2025-08-01,11,Preescolar,TopKids,171,2,169
2025-08-01,11,Kínder,SuperSchool,214,6,208
2025-08-01,11,Kínder,TopKids,185,16,169
2025-08-01,11,Kínder,SuperSchool,114,22,92
2025-08-01,11,Kínder,SuperSchool,120,13,107
2025-08-01,11,Kínder,EduMax,208,19,189
2025-08-01,11,Kínder,SuperSchool,157,22,135
2025-08-01,11,Kínder,TopKids,140,10,130
2025-08-01,11,Kínder,EduMax,68,7,61
2025-08-01,11,Kínder,EduMax,244,13,231
2025-08-01,11,Primaria 1°,EduMax,269,20,249
2025-08-01,11,Primaria 1°,SuperSchool,176,9,167
2025-08-01,11,Primaria 1°,TopKids,50,3,47
2025-08-01,11,Primaria 1°,SuperSchool,141,17,124
2025-08-01,11,Primaria 1°,SuperSchool,105,1,104
2025-08-01,11,Primaria 1°,EduMax,166,6,160
2025-08-01,11,Primaria 1°,EduMax,93,13,80
2025-08-01,11,Primaria 1°,SuperSchool,110,15,95
2025-08-01,11,Primaria 1°,SuperSchool,129,22,107
2025-08-01,11,Primaria 1°,SuperSchool,252,5,247
2025-08-01,11,Primaria 1°,TopKids,196,20,176
2025-08-01,11,Primaria 1°,SuperSchool,195,15,180
2025-08-01,11,Primaria 1°,SuperSchool,98,14,84
2025-08-01,11,Primaria 1°,TopKids,208,1,207
2025-08-01,11,Primaria 1°,SuperSchool,103,22,81
2025-08-01,11,Primaria 1°,TopKids,193,23,170
2025-08-01,11,Primaria 1°,SuperSchool,252,12,240
2025-08-01,11,Primaria 2°,EduMax,253,24,229
2025-08-01,11,Primaria 2°,SuperSchool,57,4,53
2025-08-01,11,Primaria 2°,EduMax,185,18,167
2025-08-01,11,Primaria 2°,SuperSchool,90,4,86
2025-08-01,11,Primaria 2°,TopKids,295,17,278
2025-08-01,11,Primaria 2°,SuperSchool,210,21,189
2025-08-01,11,Primaria 2°,SuperSchool,269,16,253
2025-08-01,11,Primaria 2°,SuperSchool,190,14,176
2025-08-01,11,Primaria 2°,TopKids,183,18,165
2025-08-01,11,Primaria 2°,TopKids,246,15,231
2025-08-01,11,Primaria 2°,SuperSchool,243,10,233
2025-08-01,11,Primaria 2°,EduMax,291,13,278
2025-08-01,11,Primaria 2°,SuperSchool,168,24,144
2025-08-01,11,Primaria 2°,SuperSchool,167,1,166
2025-08-01,11,Primaria 3°,TopKids,226,11,215
2025-08-01,11,Primaria 3°,SuperSchool,75,22,53
2025-08-01,11,Primaria 3°,TopKids,76,17,59
2025-08-01,11,Primaria 3°,SuperSchool,210,2,208
2025-08-01,11,Primaria 3°,SuperSchool,148,1,147
2025-08-01,11,Primaria 3°,SuperSchool,289,23,266
2025-08-01,11,Primaria 4°,SuperSchool,246,5,241
2025-08-01,11,Primaria 4°,EduMax,52,21,31
2025-08-01,11,Primaria 4°,TopKids,278,21,257
2025-08-01,11,Primaria 4°,SuperSchool,251,10,241
2025-08-01,11,Primaria 4°,TopKids,194,21,173
2025-08-01,11,Primaria 4°,EduMax,250,14,236
2025-08-01,11,Primaria 4°,SuperSchool,100,13,87
2025-08-01,11,Primaria 4°,SuperSchool,53,1,52
2025-08-01,11,Primaria 4°,SuperSchool,281,2,279
2025-08-01,11,Primaria 4°,TopKids,121,7,114
2025-08-01,11,Primaria 5°,EduMax,211,22,189
2025-08-01,11,Primaria 5°,EduMax,52,18,34
2025-08-01,11,Primaria 5°,SuperSchool,103,12,91
2025-08-01,11,Primaria 5°,SuperSchool,271,17,254
2025-08-01,11,Primaria 5°,TopKids,96,23,73
2025-08-01,11,Primaria 5°,TopKids,278,21,257
2025-08-01,11,Primaria 5°,EduMax,115,11,104
2025-08-01,11,Primaria 5°,TopKids,152,6,146
2025-08-01,11,Primaria 5°,EduMax,87,18,69
2025-08-01,11,Primaria 5°,EduMax,131,15,116
2025-08-01,11,Primaria 5°,TopKids,228,2,226
2025-08-01,11,Primaria 5°,SuperSchool,215,1,214
2025-08-01,11,Primaria 5°,TopKids,79,23,56
2025-08-01,11,Primaria 5°,EduMax,100,17,83
2025-08-01,11,Primaria 6°,SuperSchool,181,10,171
2025-08-01,11,Primaria 6°,SuperSchool,123,17,106
2025-08-01,11,Primaria 6°,SuperSchool,83,6,77
2025-08-01,11,Primaria 6°,SuperSchool,243,13,230
2025-08-01,11,Primaria 6°,EduMax,284,11,273
2025-08-01,11,Primaria 6°,TopKids,164,15,149
2025-08-01,11,Primaria 6°,SuperSchool,200,23,177
2025-08-01,11,Primaria 6°,TopKids,252,22,230
2025-08-01,11,Primaria 6°,SuperSchool,244,3,241
2025-08-01,12,Preescolar,SuperSchool,209,18,191
2025-08-01,12,Preescolar,SuperSchool,171,19,152
2025-08-01,12,Preescolar,TopKids,70,5,65
2025-08-01,12,Preescolar,EduMax,141,10,131
2025-08-01,12,Preescolar,SuperSchool,71,21,50
2025-08-01,12,Preescolar,EduMax,50,5,45
2025-08-01,12,Preescolar,SuperSchool,61,14,47
2025-08-01,12,Preescolar,EduMax,226,14,212
2025-08-01,12,Preescolar,EduMax,94,9,85
2025-08-01,12,Preescolar,EduMax,298,15,283
2025-08-01,12,Preescolar,SuperSchool,263,15,248
2025-08-01,12,Preescolar,EduMax,156,16,140
2025-08-01,12,Preescolar,SuperSchool,130,4,126
2025-08-01,12,Preescolar,SuperSchool,57,17,40
2025-08-01,12,Preescolar,TopKids,229,15,214
2025-08-01,12,Kínder,TopKids,105,22,83
2025-08-01,12,Kínder,EduMax,267,23,244
2025-08-01,12,Kínder,EduMax,265,2,263
2025-08-01,12,Kínder,SuperSchool,203,14,189
2025-08-01,12,Kínder,TopKids,105,19,86
2025-08-01,12,Kínder,TopKids,52,15,37
2025-08-01,12,Kínder,TopKids,287,11,276
2025-08-01,12,Kínder,TopKids,286,18,268
2025-08-01,12,Kínder,EduMax,87,3,84
2025-08-01,12,Kínder,TopKids,64,23,41
2025-08-01,12,Kínder,SuperSchool,77,10,67
2025-08-01,12,Kínder,TopKids,234,17,217
2025-08-01,12,Kínder,TopKids,135,12,123
2025-08-01,12,Kínder,SuperSchool,194,13,181
2025-08-01,12,Kínder,SuperSchool,117,10,107
2025-08-01,12,Kínder,TopKids,282,13,269
2025-08-01,12,Kínder,EduMax,160,4,156
2025-08-01,12,Kínder,TopKids,263,2,261
2025-08-01,12,Kínder,TopKids,57,8,49
2025-08-01,12,Primaria 1°,TopKids,91,9,82
2025-08-01,12,Primaria 1°,SuperSchool,55,20,35
2025-08-01,12,Primaria 1°,EduMax,113,2,111
2025-08-01,12,Primaria 1°,TopKids,233,13,220
2025-08-01,12,Primaria 1°,EduMax,278,1,277
2025-08-01,12,Primaria 2°,EduMax,70,6,64
2025-08-01,12,Primaria 2°,EduMax,296,16,280
2025-08-01,12,Primaria 2°,EduMax,124,24,100
2025-08-01,12,Primaria 2°,TopKids,186,23,163
2025-08-01,12,Primaria 2°,TopKids,292,8,284
2025-08-01,12,Primaria 2°,SuperSchool,85,24,61
2025-08-01,12,Primaria 2°,TopKids,55,2,53
2025-08-01,12,Primaria 2°,TopKids,53,15,38
2025-08-01,12,Primaria 2°,EduMax,167,17,150
2025-08-01,12,Primaria 3°,EduMax,228,2,226
2025-08-01,12,Primaria 3°,TopKids,252,8,244
2025-08-01,12,Primaria 3°,EduMax,228,13,215
2025-08-01,12,Primaria 3°,SuperSchool,119,22,97
2025-08-01,12,Primaria 3°,TopKids,261,1,260
2025-08-01,12,Primaria 3°,SuperSchool,189,15,174
2025-08-01,12,Primaria 3°,SuperSchool,139,14,125
2025-08-01,12,Primaria 3°,EduMax,86,11,75
2025-08-01,12,Primaria 3°,TopKids,149,13,136
2025-08-01,12,Primaria 3°,TopKids,52,1,51
2025-08-01,12,Primaria 3°,EduMax,227,24,203
2025-08-01,12,Primaria 3°,EduMax,54,23,31
2025-08-01,12,Primaria 3°,EduMax,221,2,219
2025-08-01,12,Primaria 3°,SuperSchool,217,2,215
2025-08-01,12,Primaria 3°,SuperSchool,112,5,107
2025-08-01,12,Primaria 3°,SuperSchool,66,9,57
2025-08-01,12,Primaria 3°,TopKids,192,24,168
2025-08-01,12,Primaria 3°,EduMax,296,3,293
2025-08-01,12,Primaria 4°,TopKids,98,5,93
2025-08-01,12,Primaria 4°,EduMax,237,12,225
2025-08-01,12,Primaria 4°,EduMax,127,21,106
2025-08-01,12,Primaria 4°,TopKids,186,2,184
2025-08-01,12,Primaria 4°,TopKids,84,1,83
2025-08-01,12,Primaria 4°,EduMax,109,8,101
2025-08-01,12,Primaria 4°,TopKids,154,5,149
2025-08-01,12,Primaria 4°,EduMax,109,3,106
2025-08-01,12,Primaria 4°,SuperSchool,214,5,209
2025-08-01,12,Primaria 4°,TopKids,172,14,158
2025-08-01,12,Primaria 4°,EduMax,111,4,107
2025-08-01,12,Primaria 4°,SuperSchool,286,10,276
2025-08-01,12,Primaria 4°,SuperSchool,195,8,187
2025-08-01,12,Primaria 4°,TopKids,153,14,139
2025-08-01,12,Primaria 4°,TopKids,174,6,168
2025-08-01,12,Primaria 4°,SuperSchool,72,15,57
2025-08-01,12,Primaria 4°,SuperSchool,202,17,185
2025-08-01,12,Primaria 4°,SuperSchool,288,23,265
2025-08-01,12,Primaria 5°,EduMax,102,8,94
2025-08-01,12,Primaria 5°,TopKids,88,19,69
2025-08-01,12,Primaria 5°,EduMax,183,3,180
2025-08-01,12,Primaria 5°,TopKids,228,8,220
2025-08-01,12,Primaria 5°,EduMax,241,20,221
2025-08-01,12,Primaria 5°,TopKids,160,1,159
2025-08-01,12,Primaria 6°,EduMax,280,4,276
2025-08-01,12,Primaria 6°,SuperSchool,87,1,86
2025-08-01,12,Primaria 6°,SuperSchool,278,23,255
2025-08-01,12,Primaria 6°,SuperSchool,245,22,223
2025-08-01,12,Primaria 6°,EduMax,59,5,54
2025-08-01,12,Primaria 6°,TopKids,123,1,122
2025-08-01,12,Primaria 6°,EduMax,87,13,74
2025-08-01,12,Primaria 6°,TopKids,96,4,92
2025-08-01,13,Preescolar,TopKids,206,8,198
2025-08-01,13,Preescolar,SuperSchool,206,15,191
2025-08-01,13,Preescolar,SuperSchool,179,19,160
2025-08-01,13,Preescolar,TopKids,213,4,209
2025-08-01,13,Preescolar,EduMax,92,5,87
2025-08-01,13,Preescolar,TopKids,123,8,115
2025-08-01,13,Preescolar,EduMax,183,8,175
2025-08-01,13,Preescolar,TopKids,96,14,82
2025-08-01,13,Preescolar,TopKids,189,13,176
2025-08-01,13,Preescolar,EduMax,259,1,258
2025-08-01,13,Preescolar,TopKids,153,11,142
2025-08-01,13,Preescolar,SuperSchool,169,5,164
2025-08-01,13,Preescolar,TopKids,155,17,138
2025-08-01,13,Preescolar,TopKids,171,9,162
2025-08-01,13,Preescolar,EduMax,100,14,86
2025-08-01,13,Preescolar,SuperSchool,263,11,252
2025-08-01,13,Preescolar,TopKids,50,14,36
2025-08-01,13,Kínder,SuperSchool,139,14,125
2025-08-01,13,Kínder,EduMax,264,1,263
2025-08-01,13,Kínder,TopKids,231,23,208
2025-08-01,13,Kínder,TopKids,217,15,202
2025-08-01,13,Kínder,SuperSchool,224,9,215
2025-08-01,13,Kínder,SuperSchool,186,10,176
2025-08-01,13,Kínder,SuperSchool,166,9,157
2025-08-01,13,Kínder,TopKids,112,20,92
2025-08-01,13,Kínder,SuperSchool,139,11,128
2025-08-01,13,Primaria 1°,EduMax,184,18,166
2025-08-01,13,Primaria 1°,TopKids,211,17,194
2025-08-01,13,Primaria 1°,TopKids,236,12,224
2025-08-01,13,Primaria 1°,TopKids,228,22,206
2025-08-01,13,Primaria 1°,SuperSchool,248,20,228
2025-08-01,13,Primaria 1°,EduMax,294,24,270
2025-08-01,13,Primaria 1°,SuperSchool,226,11,215
2025-08-01,13,Primaria 1°,EduMax,203,18,185
2025-08-01,13,Primaria 1°,SuperSchool,98,7,91
2025-08-01,13,Primaria 1°,SuperSchool,133,9,124
2025-08-01,13,Primaria 2°,EduMax,135,8,127
2025-08-01,13,Primaria 2°,SuperSchool,120,1,119
2025-08-01,13,Primaria 2°,SuperSchool,271,23,248
2025-08-01,13,Primaria 2°,TopKids,172,24,148
2025-08-01,13,Primaria 2°,TopKids,111,17,94
2025-08-01,13,Primaria 3°,SuperSchool,79,16,63
2025-08-01,13,Primaria 3°,TopKids,67,1,66
2025-08-01,13,Primaria 3°,EduMax,164,15,149
2025-08-01,13,Primaria 3°,EduMax,243,22,221
2025-08-01,13,Primaria 3°,SuperSchool,163,6,157
2025-08-01,13,Primaria 3°,TopKids,112,4,108
2025-08-01,13,Primaria 3°,SuperSchool,57,23,34
2025-08-01,13,Primaria 3°,TopKids,180,10,170
2025-08-01,13,Primaria 3°,EduMax,260,14,246
2025-08-01,13,Primaria 3°,EduMax,173,1,172
2025-08-01,13,Primaria 3°,TopKids,104,18,86
2025-08-01,13,Primaria 3°,TopKids,142,8,134
2025-08-01,13,Primaria 3°,SuperSchool,106,23,83
2025-08-01,13,Primaria 3°,TopKids,265,23,242
2025-08-01,13,Primaria 3°,TopKids,121,22,99
2025-08-01,13,Primaria 3°,SuperSchool,288,5,283
2025-08-01,13,Primaria 3°,TopKids,100,1,99
2025-08-01,13,Primaria 4°,TopKids,57,2,55
2025-08-01,13,Primaria 4°,TopKids,145,24,121
2025-08-01,13,Primaria 4°,EduMax,81,24,57
2025-08-01,13,Primaria 4°,EduMax,284,16,268
2025-08-01,13,Primaria 4°,SuperSchool,231,21,210
2025-08-01,13,Primaria 4°,EduMax,272,23,249
2025-08-01,13,Primaria 4°,EduMax,56,10,46
2025-08-01,13,Primaria 4°,TopKids,210,23,187
2025-08-01,13,Primaria 4°,SuperSchool,196,16,180
2025-08-01,13,Primaria 4°,SuperSchool,196,4,192
2025-08-01,13,Primaria 4°,SuperSchool,237,18,219
2025-08-01,13,Primaria 4°,EduMax,178,15,163
2025-08-01,13,Primaria 4°,SuperSchool,197,11,186
2025-08-01,13,Primaria 4°,EduMax,179,3,176
2025-08-01,13,Primaria 4°,TopKids,168,12,156
2025-08-01,13,Primaria 4°,SuperSchool,86,6,80
2025-08-01,13,Primaria 5°,SuperSchool,275,21,254
2025-08-01,13,Primaria 5°,TopKids,293,22,271
2025-08-01,13,Primaria 5°,SuperSchool,251,24,227
2025-08-01,13,Primaria 5°,TopKids,287,23,264
2025-08-01,13,Primaria 5°,SuperSchool,163,19,144
2025-08-01,13,Primaria 5°,SuperSchool,63,9,54
2025-08-01,13,Primaria 5°,EduMax,286,7,279
2025-08-01,13,Primaria 5°,SuperSchool,295,22,273
2025-08-01,13,Primaria 5°,TopKids,287,4,283
2025-08-01,13,Primaria 5°,EduMax,235,13,222
2025-08-01,13,Primaria 5°,EduMax,264,5,259
2025-08-01,13,Primaria 5°,TopKids,119,18,101
2025-08-01,13,Primaria 5°,SuperSchool,91,4,87
2025-08-01,13,Primaria 5°,SuperSchool,215,2,213
2025-08-01,13,Primaria 5°,SuperSchool,214,6,208
2025-08-01,13,Primaria 5°,EduMax,125,23,102
2025-08-01,13,Primaria 5°,SuperSchool,155,22,133
2025-08-01,13,Primaria 5°,SuperSchool,76,6,70
2025-08-01,13,Primaria 6°,EduMax,61,13,48
2025-08-01,13,Primaria 6°,SuperSchool,102,7,95
2025-08-01,13,Primaria 6°,EduMax,222,17,205
2025-08-01,13,Primaria 6°,EduMax,262,14,248
2025-08-01,13,Primaria 6°,EduMax,103,11,92
2025-08-01,13,Primaria 6°,SuperSchool,100,21,79
2025-08-01,13,Primaria 6°,TopKids,75,21,54
2025-08-01,13,Primaria 6°,TopKids,89,11,78
2025-08-01,13,Primaria 6°,SuperSchool,236,7,229
2025-08-01,13,Primaria 6°,TopKids,103,2,101
2025-08-01,13,Primaria 6°,TopKids,160,24,136
2025-08-01,13,Primaria 6°,EduMax,199,5,194
2025-08-01,13,Primaria 6°,SuperSchool,299,4,295
2025-08-01,13,Primaria 6°,TopKids,197,19,178
2025-08-01,13,Primaria 6°,TopKids,293,11,282
2025-08-01,14,Preescolar,EduMax,158,11,147
2025-08-01,14,Preescolar,EduMax,250,2,248
2025-08-01,14,Preescolar,SuperSchool,122,9,113
2025-08-01,14,Preescolar,SuperSchool,178,11,167
2025-08-01,14,Preescolar,EduMax,74,7,67
2025-08-01,14,Kínder,TopKids,291,5,286
2025-08-01,14,Kínder,TopKids,271,6,265
2025-08-01,14,Kínder,EduMax,61,19,42
2025-08-01,14,Kínder,SuperSchool,93,17,76
2025-08-01,14,Kínder,SuperSchool,66,10,56
2025-08-01,14,Kínder,SuperSchool,104,17,87
2025-08-01,14,Kínder,TopKids,61,16,45
2025-08-01,14,Primaria 1°,TopKids,57,21,36
2025-08-01,14,Primaria 1°,SuperSchool,264,5,259
2025-08-01,14,Primaria 1°,EduMax,257,6,251
2025-08-01,14,Primaria 1°,SuperSchool,259,12,247
2025-08-01,14,Primaria 1°,TopKids,108,9,99
2025-08-01,14,Primaria 1°,SuperSchool,75,15,60
2025-08-01,14,Primaria 1°,EduMax,65,7,58
2025-08-01,14,Primaria 1°,SuperSchool,200,21,179
2025-08-01,14,Primaria 1°,EduMax,299,7,292
2025-08-01,14,Primaria 1°,EduMax,128,21,107
2025-08-01,14,Primaria 1°,TopKids,186,19,167
2025-08-01,14,Primaria 1°,EduMax,108,23,85
2025-08-01,14,Primaria 2°,EduMax,272,20,252
2025-08-01,14,Primaria 2°,TopKids,276,18,258
2025-08-01,14,Primaria 2°,TopKids,283,7,276
2025-08-01,14,Primaria 2°,SuperSchool,63,24,39
2025-08-01,14,Primaria 2°,TopKids,157,13,144
2025-08-01,14,Primaria 2°,EduMax,180,5,175
2025-08-01,14,Primaria 2°,TopKids,217,23,194
2025-08-01,14,Primaria 2°,TopKids,157,7,150
2025-08-01,14,Primaria 2°,TopKids,169,17,152
2025-08-01,14,Primaria 2°,SuperSchool,263,13,250
2025-08-01,14,Primaria 2°,EduMax,210,16,194
2025-08-01,14,Primaria 2°,SuperSchool,219,12,207
2025-08-01,14,Primaria 2°,EduMax,243,23,220
2025-08-01,14,Primaria 2°,TopKids,219,2,217
2025-08-01,14,Primaria 2°,EduMax,296,13,283
2025-08-01,14,Primaria 2°,SuperSchool,67,3,64
2025-08-01,14,Primaria 2°,TopKids,88,14,74
2025-08-01,14,Primaria 3°,SuperSchool,239,17,222
2025-08-01,14,Primaria 3°,SuperSchool,111,21,90
2025-08-01,14,Primaria 3°,SuperSchool,65,24,41
2025-08-01,14,Primaria 3°,TopKids,170,10,160
2025-08-01,14,Primaria 3°,EduMax,202,7,195
2025-08-01,14,Primaria 3°,SuperSchool,114,17,97
2025-08-01,14,Primaria 3°,TopKids,222,14,208
2025-08-01,14,Primaria 3°,EduMax,291,4,287
2025-08-01,14,Primaria 4°,EduMax,86,16,70
2025-08-01,14,Primaria 4°,SuperSchool,230,14,216
2025-08-01,14,Primaria 4°,TopKids,122,15,107
2025-08-01,14,Primaria 4°,SuperSchool,170,24,146
2025-08-01,14,Primaria 4°,TopKids,299,5,294
2025-08-01,14,Primaria 4°,SuperSchool,278,11,267
2025-08-01,14,Primaria 5°,EduMax,88,24,64
2025-08-01,14,Primaria 5°,TopKids,95,24,71
2025-08-01,14,Primaria 5°,TopKids,111,13,98
2025-08-01,14,Primaria 5°,EduMax,202,7,195
2025-08-01,14,Primaria 5°,TopKids,121,20,101
2025-08-01,14,Primaria 5°,SuperSchool,112,22,90
2025-08-01,14,Primaria 5°,SuperSchool,292,13,279
2025-08-01,14,Primaria 5°,EduMax,123,11,112
2025-08-01,14,Primaria 5°,EduMax,106,9,97
2025-08-01,14,Primaria 5°,SuperSchool,299,3,296
2025-08-01,14,Primaria 5°,EduMax,54,5,49
2025-08-01,14,Primaria 5°,EduMax,96,23,73
2025-08-01,14,Primaria 5°,SuperSchool,58,3,55
2025-08-01,14,Primaria 5°,EduMax,290,10,280
2025-08-01,14,Primaria 5°,TopKids,227,18,209
2025-08-01,14,Primaria 5°,EduMax,194,24,170
2025-08-01,14,Primaria 6°,TopKids,279,13,266
2025-08-01,14,Primaria 6°,SuperSchool,288,9,279
2025-08-01,14,Primaria 6°,EduMax,150,2,148
2025-08-01,14,Primaria 6°,TopKids,154,24,130
2025-08-01,14,Primaria 6°,TopKids,172,9,163
2025-08-01,14,Primaria 6°,TopKids,202,2,200
2025-08-01,14,Primaria 6°,EduMax,58,15,43
2025-08-01,15,Preescolar,SuperSchool,54,11,43
2025-08-01,15,Preescolar,TopKids,275,24,251
2025-08-01,15,Preescolar,TopKids,87,8,79
2025-08-01,15,Preescolar,TopKids,182,16,166
2025-08-01,15,Preescolar,EduMax,195,6,189
2025-08-01,15,Preescolar,SuperSchool,109,16,93
2025-08-01,15,Preescolar,SuperSchool,77,5,72
2025-08-01,15,Preescolar,SuperSchool,130,18,112
2025-08-01,15,Preescolar,SuperSchool,273,19,254
2025-08-01,15,Preescolar,EduMax,116,24,92
2025-08-01,15,Preescolar,EduMax,89,13,76
2025-08-01,15,Preescolar,SuperSchool,82,6,76
2025-08-01,15,Kínder,TopKids,129,8,121
2025-08-01,15,Kínder,SuperSchool,108,16,92
2025-08-01,15,Kínder,SuperSchool,62,11,51
2025-08-01,15,Kínder,SuperSchool,138,21,117
2025-08-01,15,Kínder,EduMax,149,6,143
2025-08-01,15,Kínder,TopKids,182,11,171
2025-08-01,15,Kínder,SuperSchool,107,19,88
2025-08-01,15,Kínder,TopKids,72,10,62
2025-08-01,15,Kínder,EduMax,209,11,198
2025-08-01,15,Kínder,SuperSchool,207,7,200
2025-08-01,15,Kínder,TopKids,131,4,127
2025-08-01,15,Kínder,EduMax,255,13,242
2025-08-01,15,Primaria 1°,TopKids,243,13,230
2025-08-01,15,Primaria 1°,EduMax,204,17,187
2025-08-01,15,Primaria 1°,SuperSchool,66,8,58
2025-08-01,15,Primaria 1°,TopKids,147,24,123
2025-08-01,15,Primaria 1°,SuperSchool,212,16,196
2025-08-01,15,Primaria 1°,EduMax,260,7,253
2025-08-01,15,Primaria 1°,EduMax,282,2,280
2025-08-01,15,Primaria 1°,TopKids,205,15,190
2025-08-01,15,Primaria 1°,EduMax,86,22,64
2025-08-01,15,Primaria 1°,EduMax,117,17,100
2025-08-01,15,Primaria 1°,EduMax,194,10,184
2025-08-01,15,Primaria 1°,EduMax,242,22,220
2025-08-01,15,Primaria 1°,EduMax,169,18,151
2025-08-01,15,Primaria 1°,EduMax,63,15,48
2025-08-01,15,Primaria 1°,SuperSchool,253,4,249
2025-08-01,15,Primaria 1°,TopKids,276,20,256
2025-08-01,15,Primaria 1°,SuperSchool,253,7,246
2025-08-01,15,Primaria 2°,TopKids,82,6,76
2025-08-01,15,Primaria 2°,TopKids,128,19,109
2025-08-01,15,Primaria 2°,TopKids,107,23,84
2025-08-01,15,Primaria 2°,EduMax,275,14,261
2025-08-01,15,Primaria 2°,EduMax,78,4,74
2025-08-01,15,Primaria 2°,SuperSchool,148,13,135
2025-08-01,15,Primaria 2°,SuperSchool,88,15,73
2025-08-01,15,Primaria 2°,TopKids,78,11,67
2025-08-01,15,Primaria 2°,EduMax,224,14,210
2025-08-01,15,Primaria 2°,EduMax,252,3,249
2025-08-01,15,Primaria 2°,SuperSchool,175,12,163
2025-08-01,15,Primaria 2°,SuperSchool,70,15,55
2025-08-01,15,Primaria 2°,SuperSchool,236,20,216
2025-08-01,15,Primaria 2°,EduMax,196,5,191
2025-08-01,15,Primaria 2°,TopKids,50,6,44
2025-08-01,15,Primaria 2°,TopKids,211,3,208
2025-08-01,15,Primaria 2°,SuperSchool,74,24,50
2025-08-01,15,Primaria 3°,EduMax,64,12,52
2025-08-01,15,Primaria 3°,TopKids,121,14,107
2025-08-01,15,Primaria 3°,SuperSchool,194,21,173
2025-08-01,15,Primaria 3°,TopKids,76,14,62
2025-08-01,15,Primaria 3°,EduMax,293,7,286
2025-08-01,15,Primaria 3°,TopKids,142,12,130
2025-08-01,15,Primaria 3°,SuperSchool,73,3,70
2025-08-01,15,Primaria 3°,EduMax,64,14,50
2025-08-01,15,Primaria 3°,TopKids,66,12,54
2025-08-01,15,Primaria 3°,SuperSchool,215,16,199
2025-08-01,15,Primaria 3°,SuperSchool,237,22,215
2025-08-01,15,Primaria 3°,EduMax,294,21,273
2025-08-01,15,Primaria 3°,EduMax,137,8,129
2025-08-01,15,Primaria 3°,TopKids,113,13,100
2025-08-01,15,Primaria 3°,SuperSchool,121,21,100
2025-08-01,15,Primaria 3°,EduMax,271,18,253
2025-08-01,15,Primaria 4°,TopKids,144,6,138
2025-08-01,15,Primaria 4°,TopKids,94,1,93
2025-08-01,15,Primaria 4°,EduMax,218,8,210
2025-08-01,15,Primaria 4°,TopKids,263,19,244
2025-08-01,15,Primaria 4°,SuperSchool,194,12,182
2025-08-01,15,Primaria 4°,SuperSchool,95,15,80
2025-08-01,15,Primaria 4°,EduMax,135,20,115
2025-08-01,15,Primaria 4°,SuperSchool,251,8,243
2025-08-01,15,Primaria 4°,EduMax,146,2,144
2025-08-01,15,Primaria 4°,SuperSchool,82,9,73
2025-08-01,15,Primaria 4°,SuperSchool,207,1,206
2025-08-01,15,Primaria 4°,SuperSchool,165,22,143
2025-08-01,15,Primaria 4°,TopKids,243,6,237
2025-08-01,15,Primaria 4°,TopKids,139,14,125
2025-08-01,15,Primaria 4°,EduMax,291,15,276
2025-08-01,15,Primaria 4°,EduMax,155,23,132
2025-08-01,15,Primaria 4°,SuperSchool,153,11,142
2025-08-01,15,Primaria 4°,SuperSchool,244,6,238
2025-08-01,15,Primaria 5°,EduMax,122,7,115
2025-08-01,15,Primaria 5°,TopKids,209,9,200
2025-08-01,15,Primaria 5°,EduMax,253,8,245
2025-08-01,15,Primaria 5°,EduMax,141,20,121
2025-08-01,15,Primaria 5°,EduMax,160,7,153
2025-08-01,15,Primaria 5°,TopKids,133,16,117
2025-08-01,15,Primaria 5°,EduMax,107,22,85
2025-08-01,15,Primaria 5°,EduMax,176,3,173
2025-08-01,15,Primaria 5°,TopKids,90,10,80
2025-08-01,15,Primaria 5°,EduMax,252,18,234
2025-08-01,15,Primaria 5°,EduMax,61,23,38
2025-08-01,15,Primaria 5°,SuperSchool,74,13,61
2025-08-01,15,Primaria 5°,TopKids,171,19,152
2025-08-01,15,Primaria 6°,EduMax,149,13,136
2025-08-01,15,Primaria 6°,SuperSchool,168,21,147
2025-08-01,15,Primaria 6°,TopKids,81,19,62
2025-08-01,15,Primaria 6°,EduMax,247,18,229
2025-08-01,15,Primaria 6°,TopKids,199,5,194
2025-08-01,15,Primaria 6°,SuperSchool,108,3,105
2025-08-01,15,Primaria 6°,EduMax,292,3,289
2025-08-01,15,Primaria 6°,SuperSchool,142,22,120
2025-08-01,15,Primaria 6°,TopKids,256,1,255
2025-08-01,15,Primaria 6°,TopKids,125,17,108
2025-08-01,15,Primaria 6°,EduMax,262,24,238
2025-08-01,16,Preescolar,SuperSchool,53,12,41
2025-08-01,16,Preescolar,EduMax,69,24,45
2025-08-01,16,Preescolar,EduMax,226,19,207
2025-08-01,16,Preescolar,SuperSchool,213,21,192
2025-08-01,16,Preescolar,EduMax,277,2,275
2025-08-01,16,Preescolar,TopKids,211,4,207
2025-08-01,16,Preescolar,EduMax,88,10,78
2025-08-01,16,Preescolar,TopKids,164,22,142
2025-08-01,16,Kínder,TopKids,286,18,268
2025-08-01,16,Kínder,SuperSchool,192,1,191
2025-08-01,16,Kínder,TopKids,75,8,67
2025-08-01,16,Kínder,EduMax,136,10,126
2025-08-01,16,Kínder,EduMax,127,2,125
2025-08-01,16,Kínder,TopKids,86,5,81
2025-08-01,16,Kínder,EduMax,286,9,277
2025-08-01,16,Kínder,EduMax,295,15,280
2025-08-01,16,Kínder,EduMax,297,7,290
2025-08-01,16,Kínder,SuperSchool,133,2,131
2025-08-01,16,Kínder,TopKids,119,17,102
2025-08-01,16,Kínder,TopKids,138,2,136
2025-08-01,16,Kínder,TopKids,278,5,273
2025-08-01,16,Kínder,TopKids,242,8,234
2025-08-01,16,Kínder,SuperSchool,200,15,185
2025-08-01,16,Kínder,TopKids,188,10,178
2025-08-01,16,Kínder,TopKids,167,14,153
2025-08-01,16,Primaria 1°,SuperSchool,59,12,47
2025-08-01,16,Primaria 1°,EduMax,154,1,153
2025-08-01,16,Primaria 1°,SuperSchool,69,8,61
2025-08-01,16,Primaria 1°,TopKids,253,1,252
2025-08-01,16,Primaria 1°,SuperSchool,113,22,91
2025-08-01,16,Primaria 1°,SuperSchool,156,5,151
2025-08-01,16,Primaria 1°,TopKids,278,12,266
2025-08-01,16,Primaria 1°,SuperSchool,98,17,81
2025-08-01,16,Primaria 1°,TopKids,256,6,250
2025-08-01,16,Primaria 1°,TopKids,238,20,218
2025-08-01,16,Primaria 1°,EduMax,127,2,125
2025-08-01,16,Primaria 1°,SuperSchool,86,20,66
2025-08-01,16,Primaria 1°,EduMax,78,1,77
2025-08-01,16,Primaria 1°,TopKids,84,6,78
2025-08-01,16,Primaria 2°,SuperSchool,108,5,103
2025-08-01,16,Primaria 2°,SuperSchool,290,19,271
2025-08-01,16,Primaria 2°,EduMax,61,10,51
2025-08-01,16,Primaria 2°,SuperSchool,291,24,267
2025-08-01,16,Primaria 2°,TopKids,92,2,90
2025-08-01,16,Primaria 2°,SuperSchool,99,7,92
2025-08-01,16,Primaria 2°,TopKids,233,15,218
2025-08-01,16,Primaria 2°,TopKids,227,23,204
2025-08-01,16,Primaria 2°,EduMax,133,23,110
2025-08-01,16,Primaria 3°,SuperSchool,101,16,85
2025-08-01,16,Primaria 3°,EduMax,283,23,260
2025-08-01,16,Primaria 3°,EduMax,134,1,133
2025-08-01,16,Primaria 3°,TopKids,57,6,51
2025-08-01,16,Primaria 3°,SuperSchool,288,22,266
2025-08-01,16,Primaria 3°,TopKids,83,1,82
2025-08-01,16,Primaria 3°,TopKids,168,11,157
2025-08-01,16,Primaria 3°,EduMax,207,18,189
2025-08-01,16,Primaria 3°,EduMax,194,8,186
2025-08-01,16,Primaria 3°,TopKids,281,17,264
2025-08-01,16,Primaria 3°,TopKids,121,14,107
2025-08-01,16,Primaria 3°,SuperSchool,50,19,31
2025-08-01,16,Primaria 3°,TopKids,257,14,243
2025-08-01,16,Primaria 3°,SuperSchool,97,5,92
2025-08-01,16,Primaria 3°,SuperSchool,139,2,137
2025-08-01,16,Primaria 3°,EduMax,241,6,235
2025-08-01,16,Primaria 3°,TopKids,122,1,121
2025-08-01,16,Primaria 3°,SuperSchool,138,16,122
2025-08-01,16,Primaria 4°,SuperSchool,294,13,281
2025-08-01,16,Primaria 4°,TopKids,282,11,271
2025-08-01,16,Primaria 4°,EduMax,174,6,168
2025-08-01,16,Primaria 4°,EduMax,181,6,175
2025-08-01,16,Primaria 4°,TopKids,247,2,245
2025-08-01,16,Primaria 4°,EduMax,190,9,181
2025-08-01,16,Primaria 4°,TopKids,132,13,119
2025-08-01,16,Primaria 4°,TopKids,178,24,154
2025-08-01,16,Primaria 4°,EduMax,103,7,96
2025-08-01,16,Primaria 4°,SuperSchool,262,15,247
2025-08-01,16,Primaria 4°,SuperSchool,125,7,118
2025-08-01,16,Primaria 4°,TopKids,198,19,179
2025-08-01,16,Primaria 4°,SuperSchool,266,1,265
2025-08-01,16,Primaria 4°,SuperSchool,273,17,256
2025-08-01,16,Primaria 4°,TopKids,221,6,215
2025-08-01,16,Primaria 4°,EduMax,60,3,57
2025-08-01,16,Primaria 4°,EduMax,255,10,245
2025-08-01,16,Primaria 5°,EduMax,58,3,55
2025-08-01,16,Primaria 5°,SuperSchool,75,8,67
2025-08-01,16,Primaria 5°,EduMax,247,21,226
2025-08-01,16,Primaria 5°,SuperSchool,203,12,191
2025-08-01,16,Primaria 5°,SuperSchool,275,16,259
2025-08-01,16,Primaria 5°,SuperSchool,256,12,244
2025-08-01,16,Primaria 6°,TopKids,92,16,76
2025-08-01,16,Primaria 6°,TopKids,119,14,105
2025-08-01,16,Primaria 6°,EduMax,157,11,146
2025-08-01,16,Primaria 6°,SuperSchool,70,23,47
2025-08-01,16,Primaria 6°,TopKids,296,16,280
2025-08-01,16,Primaria 6°,TopKids,166,15,151
2025-08-01,16,Primaria 6°,SuperSchool,85,11,74
2025-08-01,16,Primaria 6°,TopKids,64,4,60
2025-08-04,9,Preescolar,SuperSchool,263,19,244
2025-08-04,9,Preescolar,EduMax,127,4,123
2025-08-04,9,Preescolar,SuperSchool,101,14,87
2025-08-04,9,Preescolar,TopKids,206,15,191
2025-08-04,9,Preescolar,TopKids,185,16,169
2025-08-04,9,Preescolar,EduMax,213,18,195
2025-08-04,9,Preescolar,EduMax,226,13,213
2025-08-04,9,Preescolar,EduMax,138,11,127
2025-08-04,9,Preescolar,TopKids,144,12,132
2025-08-04,9,Kínder,TopKids,190,7,183
2025-08-04,9,Kínder,TopKids,105,17,88
2025-08-04,9,Kínder,EduMax,238,10,228
2025-08-04,9,Kínder,EduMax,56,22,34
2025-08-04,9,Kínder,SuperSchool,221,24,197
2025-08-04,9,Kínder,SuperSchool,155,15,140
2025-08-04,9,Kínder,TopKids,190,23,167
2025-08-04,9,Kínder,EduMax,167,21,146
2025-08-04,9,Kínder,EduMax,269,9,260
2025-08-04,9,Kínder,EduMax,58,15,43
2025-08-04,9,Kínder,EduMax,265,10,255
2025-08-04,9,Kínder,SuperSchool,203,5,198
2025-08-04,9,Kínder,EduMax,201,19,182
2025-08-04,9,Kínder,TopKids,251,18,233
2025-08-04,9,Primaria 1°,EduMax,274,23,251
2025-08-04,9,Primaria 1°,EduMax,118,15,103
2025-08-04,9,Primaria 1°,SuperSchool,276,12,264
2025-08-04,9,Primaria 1°,EduMax,210,23,187
2025-08-04,9,Primaria 1°,SuperSchool,258,22,236
2025-08-04,9,Primaria 1°,SuperSchool,192,3,189
2025-08-04,9,Primaria 1°,TopKids,209,11,198
2025-08-04,9,Primaria 2°,SuperSchool,127,13,114
2025-08-04,9,Primaria 2°,SuperSchool,234,2,232
2025-08-04,9,Primaria 2°,TopKids,56,21,35
2025-08-04,9,Primaria 2°,EduMax,116,10,106
2025-08-04,9,Primaria 2°,EduMax,174,7,167
2025-08-04,9,Primaria 2°,SuperSchool,290,11,279
2025-08-04,9,Primaria 2°,TopKids,73,14,59
2025-08-04,9,Primaria 2°,TopKids,117,6,111
2025-08-04,9,Primaria 2°,EduMax,81,7,74
2025-08-04,9,Primaria 2°,SuperSchool,287,4,283
2025-08-04,9,Primaria 2°,SuperSchool,146,4,142
2025-08-04,9,Primaria 2°,TopKids,122,8,114
2025-08-04,9,Primaria 2°,SuperSchool,172,6,166
2025-08-04,9,Primaria 2°,SuperSchool,280,4,276
2025-08-04,9,Primaria 3°,SuperSchool,109,2,107
2025-08-04,9,Primaria 3°,SuperSchool,221,21,200
2025-08-04,9,Primaria 3°,EduMax,249,18,231
2025-08-04,9,Primaria 3°,TopKids,295,12,283
2025-08-04,9,Primaria 3°,SuperSchool,107,3,104
2025-08-04,9,Primaria 3°,EduMax,119,2,117
2025-08-04,9,Primaria 3°,TopKids,221,2,219
2025-08-04,9,Primaria 3°,EduMax,258,3,255
2025-08-04,9,Primaria 3°,EduMax,264,20,244
2025-08-04,9,Primaria 3°,EduMax,93,4,89
2025-08-04,9,Primaria 3°,SuperSchool,126,15,111
2025-08-04,9,Primaria 3°,SuperSchool,104,16,88
2025-08-04,9,Primaria 3°,EduMax,239,23,216
2025-08-04,9,Primaria 3°,SuperSchool,193,12,181
2025-08-04,9,Primaria 3°,TopKids,193,13,180
2025-08-04,9,Primaria 3°,TopKids,141,19,122
2025-08-04,9,Primaria 3°,EduMax,54,20,34
2025-08-04,9,Primaria 4°,SuperSchool,170,21,149
2025-08-04,9,Primaria 4°,EduMax,199,18,181
2025-08-04,9,Primaria 4°,TopKids,81,1,80
2025-08-04,9,Primaria 4°,SuperSchool,65,12,53
2025-08-04,9,Primaria 4°,EduMax,293,2,291
2025-08-04,9,Primaria 4°,SuperSchool,191,4,187
2025-08-04,9,Primaria 4°,SuperSchool,200,18,182
2025-08-04,9,Primaria 4°,SuperSchool,115,9,106
2025-08-04,9,Primaria 4°,SuperSchool,51,9,42
2025-08-04,9,Primaria 4°,SuperSchool,124,3,121
2025-08-04,9,Primaria 4°,EduMax,200,4,196
2025-08-04,9,Primaria 4°,EduMax,104,6,98
2025-08-04,9,Primaria 5°,EduMax,220,15,205
2025-08-04,9,Primaria 5°,EduMax,109,5,104
2025-08-04,9,Primaria 5°,EduMax,61,15,46
2025-08-04,9,Primaria 5°,SuperSchool,91,6,85
2025-08-04,9,Primaria 5°,EduMax,222,3,219
2025-08-04,9,Primaria 5°,EduMax,265,10,255
2025-08-04,9,Primaria 5°,EduMax,255,6,249
2025-08-04,9,Primaria 6°,TopKids,229,14,215
2025-08-04,9,Primaria 6°,SuperSchool,192,21,171
2025-08-04,9,Primaria 6°,TopKids,115,2,113
2025-08-04,9,Primaria 6°,TopKids,259,14,245
2025-08-04,9,Primaria 6°,EduMax,59,2,57
2025-08-04,9,Primaria 6°,SuperSchool,103,1,102
2025-08-04,9,Primaria 6°,TopKids,63,1,62
2025-08-04,10,Preescolar,EduMax,287,20,267
2025-08-04,10,Preescolar,TopKids,276,9,267
2025-08-04,10,Preescolar,EduMax,74,13,61
2025-08-04,10,Preescolar,SuperSchool,275,8,267
2025-08-04,10,Preescolar,SuperSchool,275,4,271
2025-08-04,10,Preescolar,SuperSchool,128,4,124
2025-08-04,10,Preescolar,SuperSchool,237,12,225
2025-08-04,10,Preescolar,SuperSchool,80,14,66
2025-08-04,10,Preescolar,EduMax,270,6,264
2025-08-04,10,Preescolar,SuperSchool,92,2,90
2025-08-04,10,Preescolar,TopKids,260,19,241
2025-08-04,10,Preescolar,SuperSchool,260,2,258
2025-08-04,10,Preescolar,EduMax,138,2,136
2025-08-04,10,Preescolar,EduMax,60,18,42
2025-08-04,10,Preescolar,SuperSchool,208,24,184
2025-08-04,10,Preescolar,TopKids,250,23,227
2025-08-04,10,Preescolar,TopKids,186,3,183
2025-08-04,10,Preescolar,SuperSchool,122,14,108
2025-08-04,10,Kínder,TopKids,129,16,113
2025-08-04,10,Kínder,SuperSchool,53,4,49
2025-08-04,10,Kínder,TopKids,89,17,72
2025-08-04,10,Kínder,SuperSchool,152,20,132
2025-08-04,10,Kínder,SuperSchool,101,4,97
2025-08-04,10,Kínder,EduMax,280,18,262
2025-08-04,10,Kínder,TopKids,278,20,258
2025-08-04,10,Primaria 1°,EduMax,276,7,269
2025-08-04,10,Primaria 1°,TopKids,141,22,119
2025-08-04,10,Primaria 1°,EduMax,248,5,243
2025-08-04,10,Primaria 1°,SuperSchool,135,5,130
2025-08-04,10,Primaria 1°,EduMax,232,2,230
2025-08-04,10,Primaria 1°,EduMax,268,21,247
2025-08-04,10,Primaria 1°,EduMax,279,15,264
2025-08-04,10,Primaria 1°,SuperSchool,187,23,164
2025-08-04,10,Primaria 1°,EduMax,169,7,162
2025-08-04,10,Primaria 1°,SuperSchool,114,13,101
2025-08-04,10,Primaria 1°,SuperSchool,267,18,249
2025-08-04,10,Primaria 1°,SuperSchool,262,21,241
2025-08-04,10,Primaria 1°,EduMax,278,13,265
2025-08-04,10,Primaria 1°,SuperSchool,276,17,259
2025-08-04,10,Primaria 1°,TopKids,240,21,219
2025-08-04,10,Primaria 1°,TopKids,166,4,162
2025-08-04,10,Primaria 1°,EduMax,101,16,85
2025-08-04,10,Primaria 1°,EduMax,281,3,278
2025-08-04,10,Primaria 1°,SuperSchool,270,20,250
2025-08-04,10,Primaria 2°,EduMax,91,21,70
2025-08-04,10,Primaria 2°,EduMax,190,17,173
2025-08-04,10,Primaria 2°,SuperSchool,241,17,224
2025-08-04,10,Primaria 2°,SuperSchool,218,1,217
2025-08-04,10,Primaria 2°,EduMax,109,16,93
2025-08-04,10,Primaria 2°,SuperSchool,146,10,136
2025-08-04,10,Primaria 2°,EduMax,107,8,99
2025-08-04,10,Primaria 2°,SuperSchool,77,11,66
2025-08-04,10,Primaria 2°,TopKids,83,8,75
2025-08-04,10,Primaria 2°,TopKids,263,8,255
2025-08-04,10,Primaria 2°,SuperSchool,128,17,111
2025-08-04,10,Primaria 2°,TopKids,137,13,124
2025-08-04,10,Primaria 2°,TopKids,118,12,106
2025-08-04,10,Primaria 2°,SuperSchool,136,5,131
2025-08-04,10,Primaria 2°,SuperSchool,249,23,226
2025-08-04,10,Primaria 2°,TopKids,178,13,165
2025-08-04,10,Primaria 2°,TopKids,201,3,198
2025-08-04,10,Primaria 3°,SuperSchool,182,20,162
2025-08-04,10,Primaria 3°,SuperSchool,281,14,267
2025-08-04,10,Primaria 3°,TopKids,229,15,214
2025-08-04,10,Primaria 3°,TopKids,184,19,165
2025-08-04,10,Primaria 3°,TopKids,284,5,279
2025-08-04,10,Primaria 3°,SuperSchool,143,22,121
2025-08-04,10,Primaria 3°,EduMax,87,15,72
2025-08-04,10,Primaria 3°,SuperSchool,272,8,264
2025-08-04,10,Primaria 3°,SuperSchool,122,2,120
2025-08-04,10,Primaria 3°,TopKids,227,3,224
2025-08-04,10,Primaria 3°,SuperSchool,85,4,81
2025-08-04,10,Primaria 3°,EduMax,154,9,145
2025-08-04,10,Primaria 4°,EduMax,168,18,150
2025-08-04,10,Primaria 4°,EduMax,198,4,194
2025-08-04,10,Primaria 4°,TopKids,281,2,279
2025-08-04,10,Primaria 4°,EduMax,62,21,41
2025-08-04,10,Primaria 4°,TopKids,193,2,191
2025-08-04,10,Primaria 4°,TopKids,59,15,44
2025-08-04,10,Primaria 4°,SuperSchool,217,18,199
2025-08-04,10,Primaria 4°,TopKids,250,8,242
2025-08-04,10,Primaria 4°,TopKids,127,18,109
2025-08-04,10,Primaria 4°,EduMax,293,20,273
2025-08-04,10,Primaria 4°,SuperSchool,221,19,202
2025-08-04,10,Primaria 4°,EduMax,162,24,138
2025-08-04,10,Primaria 4°,SuperSchool,276,23,253
2025-08-04,10,Primaria 5°,SuperSchool,61,9,52
2025-08-04,10,Primaria 5°,TopKids,67,21,46
2025-08-04,10,Primaria 5°,SuperSchool,198,8,190
2025-08-04,10,Primaria 5°,EduMax,153,14,139
2025-08-04,10,Primaria 5°,TopKids,200,12,188
2025-08-04,10,Primaria 5°,TopKids,135,22,113
2025-08-04,10,Primaria 5°,TopKids,138,22,116
2025-08-04,10,Primaria 5°,SuperSchool,62,18,44
2025-08-04,10,Primaria 5°,EduMax,78,21,57
2025-08-04,10,Primaria 5°,TopKids,229,18,211
2025-08-04,10,Primaria 5°,TopKids,256,19,237
2025-08-04,10,Primaria 6°,SuperSchool,71,11,60
2025-08-04,10,Primaria 6°,SuperSchool,238,1,237
2025-08-04,10,Primaria 6°,TopKids,240,22,218
2025-08-04,10,Primaria 6°,TopKids,72,7,65
2025-08-04,10,Primaria 6°,TopKids,74,5,69
2025-08-04,10,Primaria 6°,TopKids,185,10,175
2025-08-04,10,Primaria 6°,EduMax,193,8,185
2025-08-04,10,Primaria 6°,SuperSchool,157,5,152
2025-08-04,10,Primaria 6°,TopKids,242,4,238
2025-08-04,10,Primaria 6°,TopKids,273,10,263
2025-08-04,10,Primaria 6°,EduMax,284,10,274
2025-08-04,11,Preescolar,EduMax,280,2,278
2025-08-04,11,Preescolar,SuperSchool,161,13,148
2025-08-04,11,Preescolar,SuperSchool,293,4,289
2025-08-04,11,Preescolar,EduMax,283,22,261
2025-08-04,11,Preescolar,SuperSchool,255,14,241
2025-08-04,11,Preescolar,SuperSchool,211,21,190
2025-08-04,11,Preescolar,SuperSchool,69,11,58
2025-08-04,11,Preescolar,TopKids,272,23,249
2025-08-04,11,Preescolar,EduMax,105,19,86
2025-08-04,11,Kínder,EduMax,181,15,166
2025-08-04,11,Kínder,SuperSchool,181,20,161
2025-08-04,11,Kínder,EduMax,73,22,51
2025-08-04,11,Kínder,TopKids,203,5,198
2025-08-04,11,Kínder,EduMax,262,22,240
2025-08-04,11,Kínder,TopKids,198,10,188
2025-08-04,11,Kínder,EduMax,223,4,219
2025-08-04,11,Kínder,SuperSchool,222,20,202
2025-08-04,11,Kínder,SuperSchool,168,7,161
2025-08-04,11,Primaria 1°,SuperSchool,63,3,60
2025-08-04,11,Primaria 1°,SuperSchool,129,23,106
2025-08-04,11,Primaria 1°,EduMax,73,2,71
2025-08-04,11,Primaria 1°,EduMax,131,19,112
2025-08-04,11,Primaria 1°,TopKids,237,19,218
2025-08-04,11,Primaria 1°,SuperSchool,112,14,98
2025-08-04,11,Primaria 1°,TopKids,199,24,175
2025-08-04,11,Primaria 1°,SuperSchool,125,6,119
2025-08-04,11,Primaria 2°,TopKids,149,19,130
2025-08-04,11,Primaria 2°,SuperSchool,277,23,254
2025-08-04,11,Primaria 2°,SuperSchool,232,1,231
2025-08-04,11,Primaria 2°,EduMax,112,20,92
2025-08-04,11,Primaria 2°,SuperSchool,269,15,254
2025-08-04,11,Primaria 2°,TopKids,106,22,84
2025-08-04,11,Primaria 2°,SuperSchool,210,17,193
2025-08-04,11,Primaria 2°,EduMax,53,20,33
2025-08-04,11,Primaria 2°,TopKids,268,15,253
2025-08-04,11,Primaria 3°,TopKids,127,11,116
2025-08-04,11,Primaria 3°,TopKids,186,16,170
2025-08-04,11,Primaria 3°,SuperSchool,298,20,278
2025-08-04,11,Primaria 3°,SuperSchool,187,18,169
2025-08-04,11,Primaria 3°,TopKids,254,11,243
2025-08-04,11,Primaria 3°,SuperSchool,143,22,121
2025-08-04,11,Primaria 3°,SuperSchool,247,17,230
2025-08-04,11,Primaria 3°,TopKids,158,19,139
2025-08-04,11,Primaria 3°,SuperSchool,196,10,186
2025-08-04,11,Primaria 3°,TopKids,95,19,76
2025-08-04,11,Primaria 4°,SuperSchool,113,5,108
2025-08-04,11,Primaria 4°,SuperSchool,198,10,188
2025-08-04,11,Primaria 4°,SuperSchool,149,6,143
2025-08-04,11,Primaria 4°,EduMax,53,7,46
2025-08-04,11,Primaria 4°,TopKids,291,3,288
2025-08-04,11,Primaria 4°,SuperSchool,73,4,69
2025-08-04,11,Primaria 4°,EduMax,90,22,68
2025-08-04,11,Primaria 4°,EduMax,109,12,97
2025-08-04,11,Primaria 4°,SuperSchool,80,20,60
2025-08-04,11,Primaria 5°,SuperSchool,85,21,64
2025-08-04,11,Primaria 5°,EduMax,201,12,189
2025-08-04,11,Primaria 5°,EduMax,207,22,185
2025-08-04,11,Primaria 5°,TopKids,212,23,189
2025-08-04,11,Primaria 5°,EduMax,169,10,159
2025-08-04,11,Primaria 5°,EduMax,272,10,262
2025-08-04,11,Primaria 5°,SuperSchool,254,6,248
2025-08-04,11,Primaria 5°,SuperSchool,94,4,90
2025-08-04,11,Primaria 5°,TopKids,133,18,115
2025-08-04,11,Primaria 5°,EduMax,156,21,135
2025-08-04,11,Primaria 5°,EduMax,210,7,203
2025-08-04,11,Primaria 5°,EduMax,176,15,161
2025-08-04,11,Primaria 6°,TopKids,197,24,173
2025-08-04,11,Primaria 6°,TopKids,225,7,218
2025-08-04,11,Primaria 6°,SuperSchool,219,12,207
2025-08-04,11,Primaria 6°,EduMax,106,5,101
2025-08-04,11,Primaria 6°,EduMax,70,18,52
2025-08-04,11,Primaria 6°,SuperSchool,180,23,157
2025-08-04,12,Preescolar,SuperSchool,265,17,248
2025-08-04,12,Preescolar,TopKids,164,21,143
2025-08-04,12,Preescolar,SuperSchool,238,9,229
2025-08-04,12,Preescolar,SuperSchool,227,21,206
2025-08-04,12,Preescolar,TopKids,283,7,276
2025-08-04,12,Preescolar,EduMax,296,1,295
2025-08-04,12,Preescolar,SuperSchool,201,2,199
2025-08-04,12,Preescolar,EduMax,92,9,83
2025-08-04,12,Preescolar,TopKids,135,17,118
2025-08-04,12,Preescolar,SuperSchool,147,6,141
2025-08-04,12,Preescolar,EduMax,247,2,245
2025-08-04,12,Preescolar,SuperSchool,123,21,102
2025-08-04,12,Preescolar,SuperSchool,51,22,29
2025-08-04,12,Preescolar,SuperSchool,115,10,105
2025-08-04,12,Kínder,TopKids,174,7,167
2025-08-04,12,Kínder,EduMax,125,24,101
2025-08-04,12,Kínder,TopKids,217,6,211
2025-08-04,12,Kínder,TopKids,187,3,184
2025-08-04,12,Kínder,TopKids,112,17,95
2025-08-04,12,Kínder,TopKids,70,20,50
2025-08-04,12,Primaria 1°,TopKids,117,14,103
2025-08-04,12,Primaria 1°,EduMax,192,24,168
2025-08-04,12,Primaria 1°,SuperSchool,128,22,106
2025-08-04,12,Primaria 1°,EduMax,204,9,195
2025-08-04,12,Primaria 1°,EduMax,77,17,60
2025-08-04,12,Primaria 1°,TopKids,115,24,91
2025-08-04,12,Primaria 1°,EduMax,180,8,172
2025-08-04,12,Primaria 1°,SuperSchool,91,20,71
2025-08-04,12,Primaria 1°,TopKids,55,7,48
2025-08-04,12,Primaria 1°,TopKids,138,18,120
2025-08-04,12,Primaria 1°,TopKids,196,5,191
2025-08-04,12,Primaria 1°,TopKids,60,24,36
2025-08-04,12,Primaria 1°,EduMax,57,24,33
2025-08-04,12,Primaria 1°,SuperSchool,213,5,208
2025-08-04,12,Primaria 2°,TopKids,186,15,171
2025-08-04,12,Primaria 2°,TopKids,225,14,211
2025-08-04,12,Primaria 2°,EduMax,91,20,71
2025-08-04,12,Primaria 2°,EduMax,61,2,59
2025-08-04,12,Primaria 2°,TopKids,129,3,126
2025-08-04,12,Primaria 2°,SuperSchool,52,18,34
2025-08-04,12,Primaria 2°,TopKids,89,6,83
2025-08-04,12,Primaria 2°,SuperSchool,269,1,268
2025-08-04,12,Primaria 2°,TopKids,57,5,52
2025-08-04,12,Primaria 3°,TopKids,150,4,146
2025-08-04,12,Primaria 3°,EduMax,247,14,233
2025-08-04,12,Primaria 3°,EduMax,68,9,59
2025-08-04,12,Primaria 3°,TopKids,95,23,72
2025-08-04,12,Primaria 3°,SuperSchool,112,13,99
2025-08-04,12,Primaria 3°,TopKids,294,21,273
2025-08-04,12,Primaria 3°,EduMax,62,2,60
2025-08-04,12,Primaria 3°,EduMax,299,23,276
2025-08-04,12,Primaria 3°,TopKids,118,3,115
2025-08-04,12,Primaria 3°,SuperSchool,245,20,225
2025-08-04,12,Primaria 3°,EduMax,203,5,198
2025-08-04,12,Primaria 3°,TopKids,238,9,229
2025-08-04,12,Primaria 3°,EduMax,227,6,221
2025-08-04,12,Primaria 3°,TopKids,109,12,97
2025-08-04,12,Primaria 3°,SuperSchool,188,2,186
2025-08-04,12,Primaria 3°,TopKids,157,12,145
2025-08-04,12,Primaria 4°,SuperSchool,265,2,263
2025-08-04,12,Primaria 4°,EduMax,180,12,168
2025-08-04,12,Primaria 4°,EduMax,267,16,251
2025-08-04,12,Primaria 4°,SuperSchool,205,24,181
2025-08-04,12,Primaria 4°,EduMax,239,1,238
2025-08-04,12,Primaria 4°,SuperSchool,212,20,192
2025-08-04,12,Primaria 4°,EduMax,90,19,71
2025-08-04,12,Primaria 4°,TopKids,131,11,120
2025-08-04,12,Primaria 4°,SuperSchool,72,16,56
2025-08-04,12,Primaria 4°,EduMax,66,5,61
2025-08-04,12,Primaria 4°,TopKids,143,15,128
2025-08-04,12,Primaria 4°,TopKids,212,1,211
2025-08-04,12,Primaria 4°,SuperSchool,65,2,63
2025-08-04,12,Primaria 5°,TopKids,217,24,193
2025-08-04,12,Primaria 5°,TopKids,216,6,210
2025-08-04,12,Primaria 5°,SuperSchool,197,1,196
2025-08-04,12,Primaria 5°,TopKids,136,3,133
2025-08-04,12,Primaria 5°,EduMax,202,15,187
2025-08-04,12,Primaria 5°,EduMax,192,21,171
2025-08-04,12,Primaria 6°,SuperSchool,166,21,145
2025-08-04,12,Primaria 6°,EduMax,293,14,279
2025-08-04,12,Primaria 6°,SuperSchool,88,9,79
2025-08-04,12,Primaria 6°,TopKids,126,15,111
2025-08-04,12,Primaria 6°,EduMax,164,1,163
2025-08-04,12,Primaria 6°,EduMax,268,23,245
2025-08-04,12,Primaria 6°,TopKids,140,2,138
2025-08-04,13,Preescolar,EduMax,87,14,73
2025-08-04,13,Preescolar,SuperSchool,121,3,118
2025-08-04,13,Preescolar,TopKids,79,14,65
2025-08-04,13,Preescolar,TopKids,133,17,116
2025-08-04,13,Preescolar,SuperSchool,217,24,193
2025-08-04,13,Preescolar,EduMax,203,6,197
2025-08-04,13,Preescolar,TopKids,199,16,183
2025-08-04,13,Preescolar,SuperSchool,132,14,118
2025-08-04,13,Preescolar,TopKids,180,10,170
2025-08-04,13,Preescolar,TopKids,250,20,230
2025-08-04,13,Preescolar,SuperSchool,120,14,106
2025-08-04,13,Preescolar,TopKids,122,23,99
2025-08-04,13,Kínder,TopKids,224,20,204
2025-08-04,13,Kínder,EduMax,169,6,163
2025-08-04,13,Kínder,SuperSchool,110,4,106
2025-08-04,13,Kínder,SuperSchool,79,9,70
2025-08-04,13,Kínder,SuperSchool,169,20,149
2025-08-04,13,Kínder,SuperSchool,191,11,180
2025-08-04,13,Kínder,SuperSchool,276,9,267
2025-08-04,13,Kínder,TopKids,127,9,118
2025-08-04,13,Kínder,TopKids,117,8,109
2025-08-04,13,Kínder,EduMax,154,14,140
2025-08-04,13,Kínder,EduMax,218,24,194
2025-08-04,13,Kínder,TopKids,232,16,216
2025-08-04,13,Kínder,SuperSchool,111,17,94
2025-08-04,13,Primaria 1°,TopKids,60,14,46
2025-08-04,13,Primaria 1°,EduMax,262,21,241
2025-08-04,13,Primaria 1°,SuperSchool,97,20,77
2025-08-04,13,Primaria 1°,SuperSchool,244,12,232
2025-08-04,13,Primaria 1°,SuperSchool,294,9,285
2025-08-04,13,Primaria 1°,SuperSchool,186,4,182
2025-08-04,13,Primaria 1°,TopKids,258,2,256
2025-08-04,13,Primaria 1°,SuperSchool,57,13,44
2025-08-04,13,Primaria 1°,TopKids,224,8,216
2025-08-04,13,Primaria 1°,EduMax,125,14,111
2025-08-04,13,Primaria 1°,TopKids,64,9,55
2025-08-04,13,Primaria 1°,TopKids,75,20,55
2025-08-04,13,Primaria 1°,SuperSchool,199,8,191
2025-08-04,13,Primaria 1°,SuperSchool,100,6,94
2025-08-04,13,Primaria 1°,SuperSchool,206,19,187
2025-08-04,13,Primaria 1°,TopKids,248,4,244
2025-08-04,13,Primaria 1°,EduMax,125,13,112
2025-08-04,13,Primaria 1°,TopKids,135,12,123
2025-08-04,13,Primaria 2°,EduMax,140,23,117
2025-08-04,13,Primaria 2°,SuperSchool,50,8,42
2025-08-04,13,Primaria 2°,TopKids,215,6,209
2025-08-04,13,Primaria 2°,EduMax,202,18,184
2025-08-04,13,Primaria 2°,SuperSchool,110,12,98
2025-08-04,13,Primaria 2°,EduMax,267,8,259
2025-08-04,13,Primaria 3°,EduMax,242,13,229
2025-08-04,13,Primaria 3°,SuperSchool,148,8,140
2025-08-04,13,Primaria 3°,EduMax,84,16,68
2025-08-04,13,Primaria 3°,SuperSchool,133,24,109
2025-08-04,13,Primaria 3°,SuperSchool,190,6,184
2025-08-04,13,Primaria 3°,SuperSchool,95,17,78
2025-08-04,13,Primaria 3°,EduMax,185,11,174
2025-08-04,13,Primaria 4°,SuperSchool,139,7,132
2025-08-04,13,Primaria 4°,SuperSchool,294,17,277
2025-08-04,13,Primaria 4°,EduMax,155,11,144
2025-08-04,13,Primaria 4°,EduMax,175,9,166
2025-08-04,13,Primaria 4°,SuperSchool,137,5,132
2025-08-04,13,Primaria 4°,SuperSchool,90,17,73
2025-08-04,13,Primaria 4°,SuperSchool,100,7,93
2025-08-04,13,Primaria 4°,TopKids,90,7,83
2025-08-04,13,Primaria 5°,TopKids,287,19,268
2025-08-04,13,Primaria 5°,TopKids,126,14,112
2025-08-04,13,Primaria 5°,SuperSchool,50,8,42
2025-08-04,13,Primaria 5°,TopKids,125,8,117
2025-08-04,13,Primaria 5°,SuperSchool,294,13,281
2025-08-04,13,Primaria 5°,SuperSchool,289,1,288
2025-08-04,13,Primaria 5°,SuperSchool,139,7,132
2025-08-04,13,Primaria 5°,EduMax,246,8,238
2025-08-04,13,Primaria 5°,SuperSchool,140,14,126
2025-08-04,13,Primaria 5°,TopKids,207,13,194
2025-08-04,13,Primaria 5°,TopKids,264,17,247
2025-08-04,13,Primaria 5°,TopKids,133,18,115
2025-08-04,13,Primaria 5°,EduMax,243,4,239
2025-08-04,13,Primaria 5°,EduMax,210,4,206
2025-08-04,13,Primaria 5°,EduMax,278,19,259
2025-08-04,13,Primaria 5°,TopKids,205,8,197
2025-08-04,13,Primaria 5°,SuperSchool,274,12,262
2025-08-04,13,Primaria 6°,TopKids,192,9,183
2025-08-04,13,Primaria 6°,TopKids,51,9,42
2025-08-04,13,Primaria 6°,EduMax,243,19,224
2025-08-04,13,Primaria 6°,TopKids,254,10,244
2025-08-04,13,Primaria 6°,EduMax,259,19,240
2025-08-04,13,Primaria 6°,EduMax,250,7,243
2025-08-04,13,Primaria 6°,TopKids,133,6,127
2025-08-04,13,Primaria 6°,TopKids,166,2,164
2025-08-04,13,Primaria 6°,SuperSchool,215,3,212
2025-08-04,13,Primaria 6°,EduMax,89,2,87
2025-08-04,13,Primaria 6°,SuperSchool,218,12,206
2025-08-04,13,Primaria 6°,TopKids,284,1,283
2025-08-04,13,Primaria 6°,TopKids,94,15,79
2025-08-04,13,Primaria 6°,EduMax,150,21,129
2025-08-04,14,Preescolar,SuperSchool,176,23,153
2025-08-04,14,Preescolar,SuperSchool,87,21,66
2025-08-04,14,Preescolar,EduMax,156,18,138
2025-08-04,14,Preescolar,TopKids,222,23,199
2025-08-04,14,Preescolar,SuperSchool,230,6,224
2025-08-04,14,Preescolar,EduMax,79,12,67
2025-08-04,14,Preescolar,EduMax,81,3,78
2025-08-04,14,Preescolar,TopKids,205,12,193
2025-08-04,14,Preescolar,TopKids,90,23,67
2025-08-04,14,Preescolar,TopKids,97,22,75
2025-08-04,14,Preescolar,SuperSchool,201,7,194
2025-08-04,14,Preescolar,EduMax,233,5,228
2025-08-04,14,Preescolar,TopKids,245,5,240
2025-08-04,14,Preescolar,SuperSchool,242,15,227
2025-08-04,14,Preescolar,TopKids,206,10,196
2025-08-04,14,Preescolar,EduMax,269,3,266
2025-08-04,14,Preescolar,TopKids,288,11,277
2025-08-04,14,Preescolar,SuperSchool,162,6,156
2025-08-04,14,Kínder,EduMax,225,20,205
2025-08-04,14,Kínder,EduMax,114,4,110
2025-08-04,14,Kínder,SuperSchool,158,18,140
2025-08-04,14,Kínder,SuperSchool,207,24,183
2025-08-04,14,Kínder,TopKids,116,11,105
2025-08-04,14,Kínder,SuperSchool,53,14,39
2025-08-04,14,Kínder,EduMax,156,10,146
2025-08-04,14,Kínder,TopKids,99,6,93
2025-08-04,14,Kínder,TopKids,174,15,159
2025-08-04,14,Primaria 1°,EduMax,219,5,214
2025-08-04,14,Primaria 1°,EduMax,174,5,169
2025-08-04,14,Primaria 1°,EduMax,173,5,168
2025-08-04,14,Primaria 1°,TopKids,136,6,130
2025-08-04,14,Primaria 1°,EduMax,250,17,233
2025-08-04,14,Primaria 1°,SuperSchool,126,15,111
2025-08-04,14,Primaria 1°,EduMax,293,17,276
2025-08-04,14,Primaria 1°,SuperSchool,273,16,257
2025-08-04,14,Primaria 1°,EduMax,117,5,112
2025-08-04,14,Primaria 2°,SuperSchool,98,13,85
2025-08-04,14,Primaria 2°,EduMax,158,22,136
2025-08-04,14,Primaria 2°,SuperSchool,172,23,149
2025-08-04,14,Primaria 2°,TopKids,180,10,170
2025-08-04,14,Primaria 2°,EduMax,209,13,196
2025-08-04,14,Primaria 2°,TopKids,299,17,282
2025-08-04,14,Primaria 2°,SuperSchool,223,12,211
2025-08-04,14,Primaria 2°,SuperSchool,93,11,82
2025-08-04,14,Primaria 2°,TopKids,117,19,98
2025-08-04,14,Primaria 3°,TopKids,73,3,70
2025-08-04,14,Primaria 3°,SuperSchool,160,2,158
2025-08-04,14,Primaria 3°,TopKids,277,19,258
2025-08-04,14,Primaria 3°,SuperSchool,66,3,63
2025-08-04,14,Primaria 3°,EduMax,153,22,131
2025-08-04,14,Primaria 4°,EduMax,68,5,63
2025-08-04,14,Primaria 4°,TopKids,134,8,126
2025-08-04,14,Primaria 4°,SuperSchool,194,5,189
2025-08-04,14,Primaria 4°,EduMax,196,21,175
2025-08-04,14,Primaria 4°,EduMax,60,22,38
2025-08-04,14,Primaria 4°,SuperSchool,96,12,84
2025-08-04,14,Primaria 4°,EduMax,198,22,176
2025-08-04,14,Primaria 4°,TopKids,280,5,275
2025-08-04,14,Primaria 4°,SuperSchool,233,20,213
2025-08-04,14,Primaria 4°,SuperSchool,95,12,83
2025-08-04,14,Primaria 4°,EduMax,66,19,47
2025-08-04,14,Primaria 4°,TopKids,203,16,187
2025-08-04,14,Primaria 4°,EduMax,232,4,228
2025-08-04,14,Primaria 5°,TopKids,210,24,186
2025-08-04,14,Primaria 5°,TopKids,192,11,181
2025-08-04,14,Primaria 5°,SuperSchool,292,18,274
2025-08-04,14,Primaria 5°,SuperSchool,228,21,207
2025-08-04,14,Primaria 5°,EduMax,268,18,250
2025-08-04,14,Primaria 5°,TopKids,224,15,209
2025-08-04,14,Primaria 5°,TopKids,158,3,155
2025-08-04,14,Primaria 5°,TopKids,122,8,114
2025-08-04,14,Primaria 5°,SuperSchool,130,17,113
2025-08-04,14,Primaria 5°,SuperSchool,274,8,266
2025-08-04,14,Primaria 6°,TopKids,87,3,84
2025-08-04,14,Primaria 6°,TopKids,118,13,105
2025-08-04,14,Primaria 6°,TopKids,287,23,264
2025-08-04,14,Primaria 6°,EduMax,273,22,251
2025-08-04,14,Primaria 6°,SuperSchool,263,11,252
2025-08-04,14,Primaria 6°,TopKids,103,10,93
2025-08-04,14,Primaria 6°,EduMax,113,21,92
2025-08-04,15,Preescolar,EduMax,218,24,194
2025-08-04,15,Preescolar,TopKids,233,15,218
2025-08-04,15,Preescolar,TopKids,68,18,50
2025-08-04,15,Preescolar,EduMax,162,8,154
2025-08-04,15,Preescolar,TopKids,79,7,72
2025-08-04,15,Preescolar,TopKids,114,4,110
2025-08-04,15,Preescolar,SuperSchool,86,1,85
2025-08-04,15,Preescolar,TopKids,86,13,73
2025-08-04,15,Preescolar,SuperSchool,237,9,228
2025-08-04,15,Preescolar,TopKids,50,4,46
2025-08-04,15,Preescolar,TopKids,243,8,235
2025-08-04,15,Preescolar,TopKids,58,2,56
2025-08-04,15,Preescolar,EduMax,255,4,251
2025-08-04,15,Preescolar,EduMax,272,6,266
2025-08-04,15,Preescolar,TopKids,148,8,140
2025-08-04,15,Preescolar,TopKids,191,13,178
2025-08-04,15,Kínder,EduMax,94,19,75
2025-08-04,15,Kínder,TopKids,151,16,135
2025-08-04,15,Kínder,EduMax,217,17,200
2025-08-04,15,Kínder,TopKids,211,10,201
2025-08-04,15,Kínder,EduMax,237,2,235
2025-08-04,15,Kínder,EduMax,267,13,254
2025-08-04,15,Kínder,TopKids,208,2,206
2025-08-04,15,Kínder,TopKids,244,8,236
2025-08-04,15,Kínder,TopKids,255,24,231
2025-08-04,15,Kínder,EduMax,104,22,82
2025-08-04,15,Kínder,SuperSchool,280,21,259
2025-08-04,15,Kínder,TopKids,114,17,97
2025-08-04,15,Kínder,SuperSchool,207,21,186
2025-08-04,15,Kínder,SuperSchool,70,19,51
2025-08-04,15,Kínder,SuperSchool,68,22,46
2025-08-04,15,Kínder,TopKids,130,23,107
2025-08-04,15,Kínder,TopKids,81,10,71
2025-08-04,15,Primaria 1°,EduMax,101,20,81
2025-08-04,15,Primaria 1°,EduMax,63,18,45
2025-08-04,15,Primaria 1°,EduMax,293,21,272
2025-08-04,15,Primaria 1°,TopKids,71,4,67
2025-08-04,15,Primaria 1°,SuperSchool,108,23,85
2025-08-04,15,Primaria 1°,EduMax,61,23,38
2025-08-04,15,Primaria 1°,TopKids,255,2,253
2025-08-04,15,Primaria 1°,EduMax,297,2,295
2025-08-04,15,Primaria 1°,TopKids,124,9,115
2025-08-04,15,Primaria 1°,SuperSchool,128,17,111
2025-08-04,15,Primaria 1°,EduMax,142,18,124
2025-08-04,15,Primaria 1°,EduMax,87,17,70
2025-08-04,15,Primaria 1°,TopKids,137,18,119
2025-08-04,15,Primaria 1°,SuperSchool,183,5,178
2025-08-04,15,Primaria 2°,SuperSchool,113,11,102
2025-08-04,15,Primaria 2°,SuperSchool,114,11,103
2025-08-04,15,Primaria 2°,TopKids,186,2,184
2025-08-04,15,Primaria 2°,EduMax,192,19,173
2025-08-04,15,Primaria 2°,SuperSchool,132,17,115
2025-08-04,15,Primaria 2°,EduMax,161,24,137
2025-08-04,15,Primaria 2°,TopKids,214,17,197
2025-08-04,15,Primaria 2°,EduMax,264,1,263
2025-08-04,15,Primaria 2°,TopKids,266,24,242
2025-08-04,15,Primaria 2°,TopKids,187,15,172
2025-08-04,15,Primaria 2°,TopKids,262,21,241
2025-08-04,15,Primaria 2°,TopKids,62,5,57
2025-08-04,15,Primaria 2°,SuperSchool,73,12,61
2025-08-04,15,Primaria 2°,TopKids,66,4,62
2025-08-04,15,Primaria 2°,TopKids,74,9,65
2025-08-04,15,Primaria 2°,SuperSchool,133,19,114
2025-08-04,15,Primaria 3°,SuperSchool,91,17,74
2025-08-04,15,Primaria 3°,SuperSchool,295,16,279
2025-08-04,15,Primaria 3°,TopKids,77,9,68
2025-08-04,15,Primaria 3°,TopKids,96,16,80
2025-08-04,15,Primaria 3°,EduMax,255,3,252
2025-08-04,15,Primaria 3°,SuperSchool,173,7,166
2025-08-04,15,Primaria 3°,SuperSchool,62,18,44
2025-08-04,15,Primaria 4°,SuperSchool,149,2,147
2025-08-04,15,Primaria 4°,SuperSchool,122,6,116
2025-08-04,15,Primaria 4°,TopKids,103,24,79
2025-08-04,15,Primaria 4°,EduMax,274,4,270
2025-08-04,15,Primaria 4°,SuperSchool,136,13,123
2025-08-04,15,Primaria 4°,SuperSchool,211,9,202
2025-08-04,15,Primaria 4°,TopKids,85,18,67
2025-08-04,15,Primaria 4°,TopKids,77,6,71
2025-08-04,15,Primaria 4°,SuperSchool,77,8,69
2025-08-04,15,Primaria 5°,EduMax,114,4,110
2025-08-04,15,Primaria 5°,SuperSchool,284,3,281
2025-08-04,15,Primaria 5°,SuperSchool,106,17,89
2025-08-04,15,Primaria 5°,EduMax,103,10,93
2025-08-04,15,Primaria 5°,SuperSchool,93,15,78
2025-08-04,15,Primaria 5°,SuperSchool,123,14,109
2025-08-04,15,Primaria 5°,SuperSchool,214,6,208
2025-08-04,15,Primaria 5°,EduMax,263,17,246
2025-08-04,15,Primaria 5°,EduMax,187,3,184
2025-08-04,15,Primaria 5°,SuperSchool,180,15,165
2025-08-04,15,Primaria 6°,SuperSchool,61,22,39
2025-08-04,15,Primaria 6°,SuperSchool,220,4,216
2025-08-04,15,Primaria 6°,EduMax,237,6,231
2025-08-04,15,Primaria 6°,SuperSchool,133,23,110
2025-08-04,15,Primaria 6°,TopKids,258,8,250
2025-08-04,15,Primaria 6°,EduMax,253,22,231
2025-08-04,15,Primaria 6°,SuperSchool,219,15,204
2025-08-04,15,Primaria 6°,EduMax,282,2,280
2025-08-04,15,Primaria 6°,SuperSchool,183,7,176
2025-08-04,15,Primaria 6°,SuperSchool,202,1,201
2025-08-04,16,Preescolar,EduMax,56,20,36
2025-08-04,16,Preescolar,SuperSchool,175,12,163
2025-08-04,16,Preescolar,TopKids,166,4,162
2025-08-04,16,Preescolar,SuperSchool,184,4,180
2025-08-04,16,Preescolar,TopKids,100,9,91
2025-08-04,16,Preescolar,TopKids,57,1,56
2025-08-04,16,Preescolar,TopKids,266,24,242
2025-08-04,16,Preescolar,SuperSchool,263,4,259
2025-08-04,16,Preescolar,TopKids,206,9,197
2025-08-04,16,Preescolar,SuperSchool,147,2,145
2025-08-04,16,Preescolar,SuperSchool,128,23,105
2025-08-04,16,Kínder,EduMax,53,8,45
2025-08-04,16,Kínder,SuperSchool,168,5,163
2025-08-04,16,Kínder,EduMax,124,15,109
2025-08-04,16,Kínder,EduMax,282,17,265
2025-08-04,16,Kínder,TopKids,139,12,127
2025-08-04,16,Kínder,TopKids,155,10,145
2025-08-04,16,Kínder,TopKids,94,19,75
2025-08-04,16,Kínder,TopKids,254,21,233
2025-08-04,16,Kínder,TopKids,144,11,133
2025-08-04,16,Kínder,TopKids,114,17,97
2025-08-04,16,Kínder,TopKids,101,6,95
2025-08-04,16,Kínder,EduMax,237,15,222
2025-08-04,16,Kínder,TopKids,282,14,268
2025-08-04,16,Kínder,EduMax,75,17,58
2025-08-04,16,Kínder,EduMax,54,20,34
2025-08-04,16,Kínder,SuperSchool,252,24,228
2025-08-04,16,Primaria 1°,SuperSchool,227,6,221
2025-08-04,16,Primaria 1°,TopKids,275,15,260
2025-08-04,16,Primaria 1°,SuperSchool,171,21,150
2025-08-04,16,Primaria 1°,EduMax,246,6,240
2025-08-04,16,Primaria 1°,EduMax,111,22,89
2025-08-04,16,Primaria 1°,EduMax,259,14,245
2025-08-04,16,Primaria 1°,EduMax,95,13,82
2025-08-04,16,Primaria 1°,TopKids,271,3,268
2025-08-04,16,Primaria 1°,EduMax,55,8,47
2025-08-04,16,Primaria 1°,SuperSchool,284,12,272
2025-08-04,16,Primaria 2°,SuperSchool,289,11,278
2025-08-04,16,Primaria 2°,SuperSchool,99,11,88
2025-08-04,16,Primaria 2°,TopKids,205,12,193
2025-08-04,16,Primaria 2°,EduMax,218,16,202
2025-08-04,16,Primaria 2°,TopKids,97,24,73
2025-08-04,16,Primaria 3°,EduMax,239,12,227
2025-08-04,16,Primaria 3°,TopKids,150,18,132
2025-08-04,16,Primaria 3°,TopKids,264,23,241
2025-08-04,16,Primaria 3°,EduMax,167,18,149
2025-08-04,16,Primaria 3°,EduMax,183,4,179
2025-08-04,16,Primaria 3°,TopKids,78,2,76
2025-08-04,16,Primaria 3°,SuperSchool,156,11,145
2025-08-04,16,Primaria 3°,SuperSchool,129,2,127
2025-08-04,16,Primaria 3°,EduMax,296,8,288
2025-08-04,16,Primaria 3°,SuperSchool,155,8,147
2025-08-04,16,Primaria 3°,EduMax,145,4,141
2025-08-04,16,Primaria 3°,TopKids,143,1,142
2025-08-04,16,Primaria 3°,TopKids,88,17,71
2025-08-04,16,Primaria 3°,TopKids,133,24,109
2025-08-04,16,Primaria 3°,EduMax,135,22,113
2025-08-04,16,Primaria 4°,SuperSchool,214,10,204
2025-08-04,16,Primaria 4°,SuperSchool,269,10,259
2025-08-04,16,Primaria 4°,TopKids,220,21,199
2025-08-04,16,Primaria 4°,EduMax,153,2,151
2025-08-04,16,Primaria 4°,TopKids,249,16,233
2025-08-04,16,Primaria 4°,TopKids,71,5,66
2025-08-04,16,Primaria 4°,TopKids,170,3,167
2025-08-04,16,Primaria 4°,SuperSchool,222,10,212
2025-08-04,16,Primaria 4°,SuperSchool,231,24,207
2025-08-04,16,Primaria 4°,TopKids,204,2,202
2025-08-04,16,Primaria 4°,TopKids,178,7,171
2025-08-04,16,Primaria 4°,SuperSchool,116,20,96
2025-08-04,16,Primaria 4°,SuperSchool,143,3,140
2025-08-04,16,Primaria 4°,TopKids,162,7,155
2025-08-04,16,Primaria 4°,TopKids,139,14,125
2025-08-04,16,Primaria 4°,SuperSchool,67,13,54
2025-08-04,16,Primaria 5°,SuperSchool,261,21,240
2025-08-04,16,Primaria 5°,TopKids,131,4,127
2025-08-04,16,Primaria 5°,SuperSchool,163,1,162
2025-08-04,16,Primaria 5°,EduMax,203,13,190
2025-08-04,16,Primaria 5°,TopKids,59,11,48
2025-08-04,16,Primaria 5°,SuperSchool,154,5,149
2025-08-04,16,Primaria 5°,EduMax,242,17,225
2025-08-04,16,Primaria 5°,EduMax,147,24,123
2025-08-04,16,Primaria 6°,SuperSchool,270,4,266
2025-08-04,16,Primaria 6°,SuperSchool,188,24,164
2025-08-04,16,Primaria 6°,TopKids,198,3,195
2025-08-04,16,Primaria 6°,EduMax,164,19,145
2025-08-04,16,Primaria 6°,SuperSchool,237,7,230
2025-08-04,16,Primaria 6°,TopKids,296,7,289
2025-08-04,16,Primaria 6°,EduMax,89,5,84
2025-08-04,16,Primaria 6°,SuperSchool,255,4,251
2025-08-04,16,Primaria 6°,TopKids,155,20,135
2025-08-04,16,Primaria 6°,TopKids,291,20,271
2025-08-04,16,Primaria 6°,SuperSchool,270,8,262
2025-08-04,16,Primaria 6°,SuperSchool,161,19,142
2025-08-04,16,Primaria 6°,TopKids,95,14,81
2025-08-04,16,Primaria 6°,SuperSchool,268,4,264
2025-08-04,16,Primaria 6°,EduMax,64,3,61
2025-08-04,16,Primaria 6°,SuperSchool,178,3,175
2025-08-04,16,Primaria 6°,TopKids,73,8,65
2025-08-05,9,Preescolar,SuperSchool,213,2,211
2025-08-05,9,Preescolar,SuperSchool,73,24,49
2025-08-05,9,Preescolar,EduMax,53,3,50
2025-08-05,9,Preescolar,EduMax,234,17,217
2025-08-05,9,Preescolar,TopKids,230,24,206
2025-08-05,9,Preescolar,TopKids,158,5,153
2025-08-05,9,Preescolar,TopKids,230,9,221
2025-08-05,9,Preescolar,SuperSchool,298,22,276
2025-08-05,9,Preescolar,EduMax,150,10,140
2025-08-05,9,Preescolar,TopKids,152,6,146
2025-08-05,9,Preescolar,SuperSchool,110,20,90
2025-08-05,9,Preescolar,TopKids,177,19,158
2025-08-05,9,Preescolar,EduMax,96,4,92
2025-08-05,9,Preescolar,EduMax,292,4,288
2025-08-05,9,Preescolar,TopKids,218,5,213
2025-08-05,9,Preescolar,SuperSchool,136,18,118
2025-08-05,9,Preescolar,EduMax,239,5,234
2025-08-05,9,Preescolar,SuperSchool,161,19,142
2025-08-05,9,Preescolar,EduMax,234,16,218
2025-08-05,9,Kínder,TopKids,167,4,163
2025-08-05,9,Kínder,TopKids,65,24,41
2025-08-05,9,Kínder,EduMax,262,22,240
2025-08-05,9,Kínder,SuperSchool,249,17,232
2025-08-05,9,Kínder,TopKids,296,10,286
2025-08-05,9,Kínder,EduMax,81,2,79
2025-08-05,9,Kínder,TopKids,58,17,41
2025-08-05,9,Kínder,TopKids,273,10,263
2025-08-05,9,Kínder,EduMax,298,17,281
2025-08-05,9,Kínder,TopKids,202,21,181
2025-08-05,9,Kínder,SuperSchool,151,17,134
2025-08-05,9,Kínder,SuperSchool,240,19,221
2025-08-05,9,Kínder,SuperSchool,282,24,258
2025-08-05,9,Kínder,EduMax,153,15,138
2025-08-05,9,Kínder,TopKids,172,6,166
2025-08-05,9,Primaria 1°,TopKids,200,7,193
2025-08-05,9,Primaria 1°,SuperSchool,175,17,158
2025-08-05,9,Primaria 1°,EduMax,218,9,209
2025-08-05,9,Primaria 1°,SuperSchool,119,6,113
2025-08-05,9,Primaria 1°,SuperSchool,52,17,35
2025-08-05,9,Primaria 2°,SuperSchool,125,16,109
2025-08-05,9,Primaria 2°,TopKids,158,23,135
2025-08-05,9,Primaria 2°,SuperSchool,130,3,127
2025-08-05,9,Primaria 2°,EduMax,64,4,60
2025-08-05,9,Primaria 2°,EduMax,162,19,143
2025-08-05,9,Primaria 2°,TopKids,165,3,162
2025-08-05,9,Primaria 2°,EduMax,107,1,106
2025-08-05,9,Primaria 2°,EduMax,211,23,188
2025-08-05,9,Primaria 2°,TopKids,206,19,187
2025-08-05,9,Primaria 2°,EduMax,170,1,169
2025-08-05,9,Primaria 2°,SuperSchool,217,19,198
2025-08-05,9,Primaria 2°,SuperSchool,242,5,237
2025-08-05,9,Primaria 2°,TopKids,129,6,123
2025-08-05,9,Primaria 2°,SuperSchool,289,3,286
2025-08-05,9,Primaria 2°,TopKids,253,16,237
2025-08-05,9,Primaria 2°,TopKids,92,10,82
2025-08-05,9,Primaria 2°,SuperSchool,197,4,193
2025-08-05,9,Primaria 2°,TopKids,51,24,27
2025-08-05,9,Primaria 2°,EduMax,164,5,159
2025-08-05,9,Primaria 3°,TopKids,255,24,231
2025-08-05,9,Primaria 3°,TopKids,244,18,226
2025-08-05,9,Primaria 3°,TopKids,132,19,113
2025-08-05,9,Primaria 3°,EduMax,293,16,277
2025-08-05,9,Primaria 3°,SuperSchool,162,12,150
2025-08-05,9,Primaria 3°,EduMax,102,11,91
2025-08-05,9,Primaria 3°,SuperSchool,76,12,64
2025-08-05,9,Primaria 3°,SuperSchool,183,1,182
2025-08-05,9,Primaria 3°,SuperSchool,106,14,92
2025-08-05,9,Primaria 3°,SuperSchool,167,24,143
2025-08-05,9,Primaria 3°,TopKids,82,18,64
2025-08-05,9,Primaria 3°,SuperSchool,68,22,46
2025-08-05,9,Primaria 4°,TopKids,243,15,228
2025-08-05,9,Primaria 4°,TopKids,245,1,244
2025-08-05,9,Primaria 4°,SuperSchool,133,22,111
2025-08-05,9,Primaria 4°,TopKids,128,23,105
2025-08-05,9,Primaria 4°,EduMax,264,19,245
2025-08-05,9,Primaria 4°,EduMax,270,24,246
2025-08-05,9,Primaria 4°,SuperSchool,73,18,55
2025-08-05,9,Primaria 4°,TopKids,251,9,242
2025-08-05,9,Primaria 4°,SuperSchool,185,10,175
2025-08-05,9,Primaria 5°,EduMax,55,5,50
2025-08-05,9,Primaria 5°,EduMax,218,5,213
2025-08-05,9,Primaria 5°,EduMax,267,20,247
2025-08-05,9,Primaria 5°,SuperSchool,226,17,209
2025-08-05,9,Primaria 5°,TopKids,180,10,170
2025-08-05,9,Primaria 6°,SuperSchool,84,16,68
2025-08-05,9,Primaria 6°,EduMax,173,24,149
2025-08-05,9,Primaria 6°,EduMax,215,22,193
2025-08-05,9,Primaria 6°,EduMax,220,23,197
2025-08-05,9,Primaria 6°,TopKids,268,15,253
2025-08-05,9,Primaria 6°,EduMax,69,9,60
2025-08-05,10,Preescolar,TopKids,133,3,130
2025-08-05,10,Preescolar,TopKids,115,21,94
2025-08-05,10,Preescolar,EduMax,199,3,196
2025-08-05,10,Preescolar,EduMax,256,10,246
2025-08-05,10,Preescolar,SuperSchool,274,16,258
2025-08-05,10,Preescolar,EduMax,282,4,278
2025-08-05,10,Preescolar,TopKids,51,4,47
2025-08-05,10,Preescolar,SuperSchool,132,10,122
2025-08-05,10,Preescolar,SuperSchool,128,22,106
2025-08-05,10,Preescolar,TopKids,97,21,76
2025-08-05,10,Kínder,EduMax,149,2,147
2025-08-05,10,Kínder,EduMax,74,13,61
2025-08-05,10,Kínder,SuperSchool,162,13,149
2025-08-05,10,Kínder,TopKids,98,9,89
2025-08-05,10,Kínder,TopKids,178,10,168
2025-08-05,10,Kínder,SuperSchool,286,14,272
2025-08-05,10,Kínder,EduMax,209,6,203
2025-08-05,10,Kínder,EduMax,194,10,184
2025-08-05,10,Kínder,EduMax,76,22,54
2025-08-05,10,Kínder,EduMax,212,20,192
2025-08-05,10,Kínder,TopKids,134,15,119
2025-08-05,10,Kínder,TopKids,181,9,172
2025-08-05,10,Kínder,TopKids,203,19,184
2025-08-05,10,Kínder,SuperSchool,92,9,83
2025-08-05,10,Kínder,EduMax,227,20,207
2025-08-05,10,Primaria 1°,TopKids,162,21,141
2025-08-05,10,Primaria 1°,TopKids,160,20,140
2025-08-05,10,Primaria 1°,TopKids,112,1,111
2025-08-05,10,Primaria 1°,SuperSchool,159,5,154
2025-08-05,10,Primaria 1°,TopKids,225,2,223
2025-08-05,10,Primaria 1°,TopKids,110,18,92
2025-08-05,10,Primaria 1°,TopKids,111,1,110
2025-08-05,10,Primaria 1°,TopKids,65,18,47
2025-08-05,10,Primaria 1°,EduMax,97,23,74
2025-08-05,10,Primaria 1°,EduMax,131,6,125
2025-08-05,10,Primaria 1°,TopKids,68,4,64
2025-08-05,10,Primaria 1°,TopKids,112,13,99
2025-08-05,10,Primaria 1°,EduMax,180,10,170
2025-08-05,10,Primaria 1°,EduMax,114,23,91
2025-08-05,10,Primaria 1°,TopKids,287,8,279
2025-08-05,10,Primaria 1°,TopKids,287,10,277
2025-08-05,10,Primaria 1°,SuperSchool,122,6,116
2025-08-05,10,Primaria 2°,SuperSchool,88,17,71
2025-08-05,10,Primaria 2°,SuperSchool,231,5,226
2025-08-05,10,Primaria 2°,SuperSchool,131,24,107
2025-08-05,10,Primaria 2°,TopKids,134,2,132
2025-08-05,10,Primaria 2°,SuperSchool,107,11,96
2025-08-05,10,Primaria 2°,TopKids,237,6,231
2025-08-05,10,Primaria 2°,EduMax,217,4,213
2025-08-05,10,Primaria 2°,EduMax,156,5,151
2025-08-05,10,Primaria 2°,TopKids,141,18,123
2025-08-05,10,Primaria 2°,EduMax,112,22,90
2025-08-05,10,Primaria 2°,TopKids,235,13,222
2025-08-05,10,Primaria 2°,EduMax,184,11,173
2025-08-05,10,Primaria 2°,EduMax,137,4,133
2025-08-05,10,Primaria 2°,TopKids,178,23,155
2025-08-05,10,Primaria 2°,TopKids,255,6,249
2025-08-05,10,Primaria 3°,SuperSchool,178,6,172
2025-08-05,10,Primaria 3°,EduMax,134,16,118
2025-08-05,10,Primaria 3°,SuperSchool,182,17,165
2025-08-05,10,Primaria 3°,EduMax,141,21,120
2025-08-05,10,Primaria 3°,EduMax,248,3,245
2025-08-05,10,Primaria 3°,SuperSchool,96,20,76
2025-08-05,10,Primaria 4°,TopKids,245,5,240
2025-08-05,10,Primaria 4°,SuperSchool,245,12,233
2025-08-05,10,Primaria 4°,TopKids,105,10,95
2025-08-05,10,Primaria 4°,TopKids,202,21,181
2025-08-05,10,Primaria 4°,SuperSchool,112,20,92
2025-08-05,10,Primaria 4°,SuperSchool,286,23,263
2025-08-05,10,Primaria 4°,EduMax,81,23,58
2025-08-05,10,Primaria 5°,EduMax,283,17,266
2025-08-05,10,Primaria 5°,EduMax,107,7,100
2025-08-05,10,Primaria 5°,SuperSchool,162,21,141
2025-08-05,10,Primaria 5°,SuperSchool,186,6,180
2025-08-05,10,Primaria 5°,TopKids,158,3,155
2025-08-05,10,Primaria 5°,TopKids,199,9,190
2025-08-05,10,Primaria 5°,EduMax,54,10,44
2025-08-05,10,Primaria 5°,TopKids,258,12,246
2025-08-05,10,Primaria 5°,TopKids,257,3,254
2025-08-05,10,Primaria 6°,SuperSchool,176,22,154
2025-08-05,10,Primaria 6°,SuperSchool,78,15,63
2025-08-05,10,Primaria 6°,SuperSchool,136,13,123
2025-08-05,10,Primaria 6°,EduMax,165,15,150
2025-08-05,10,Primaria 6°,TopKids,94,17,77
2025-08-05,10,Primaria 6°,TopKids,153,21,132
2025-08-05,10,Primaria 6°,EduMax,278,6,272
2025-08-05,10,Primaria 6°,EduMax,143,22,121
2025-08-05,10,Primaria 6°,EduMax,82,17,65
2025-08-05,10,Primaria 6°,EduMax,284,10,274
2025-08-05,10,Primaria 6°,TopKids,255,10,245
2025-08-05,10,Primaria 6°,TopKids,164,4,160
2025-08-05,10,Primaria 6°,EduMax,250,10,240
2025-08-05,10,Primaria 6°,TopKids,255,7,248
2025-08-05,10,Primaria 6°,TopKids,96,22,74
2025-08-05,10,Primaria 6°,TopKids,196,22,174
2025-08-05,10,Primaria 6°,TopKids,175,24,151
2025-08-05,10,Primaria 6°,TopKids,186,15,171
2025-08-05,11,Preescolar,EduMax,274,19,255
2025-08-05,11,Preescolar,TopKids,123,8,115
2025-08-05,11,Preescolar,TopKids,283,1,282
2025-08-05,11,Preescolar,SuperSchool,227,2,225
2025-08-05,11,Preescolar,TopKids,190,22,168
2025-08-05,11,Kínder,EduMax,142,16,126
2025-08-05,11,Kínder,TopKids,254,16,238
2025-08-05,11,Kínder,SuperSchool,294,7,287
2025-08-05,11,Kínder,EduMax,66,7,59
2025-08-05,11,Kínder,SuperSchool,118,17,101
2025-08-05,11,Primaria 1°,TopKids,107,17,90
2025-08-05,11,Primaria 1°,TopKids,102,1,101
2025-08-05,11,Primaria 1°,SuperSchool,111,17,94
2025-08-05,11,Primaria 1°,TopKids,74,3,71
2025-08-05,11,Primaria 1°,TopKids,78,21,57
2025-08-05,11,Primaria 1°,TopKids,209,16,193
2025-08-05,11,Primaria 1°,SuperSchool,103,9,94
2025-08-05,11,Primaria 2°,SuperSchool,142,22,120
2025-08-05,11,Primaria 2°,SuperSchool,292,12,280
2025-08-05,11,Primaria 2°,TopKids,167,9,158
2025-08-05,11,Primaria 2°,TopKids,255,19,236
2025-08-05,11,Primaria 2°,TopKids,243,9,234
2025-08-05,11,Primaria 2°,SuperSchool,64,3,61
2025-08-05,11,Primaria 2°,TopKids,230,14,216
2025-08-05,11,Primaria 2°,EduMax,106,8,98
2025-08-05,11,Primaria 2°,EduMax,228,16,212
2025-08-05,11,Primaria 2°,EduMax,273,8,265
2025-08-05,11,Primaria 2°,EduMax,55,12,43
2025-08-05,11,Primaria 2°,TopKids,234,8,226
2025-08-05,11,Primaria 3°,TopKids,269,20,249
2025-08-05,11,Primaria 3°,SuperSchool,98,13,85
2025-08-05,11,Primaria 3°,EduMax,115,13,102
2025-08-05,11,Primaria 3°,SuperSchool,295,15,280
2025-08-05,11,Primaria 3°,SuperSchool,172,10,162
2025-08-05,11,Primaria 3°,SuperSchool,116,19,97
2025-08-05,11,Primaria 3°,TopKids,231,14,217
2025-08-05,11,Primaria 3°,TopKids,232,4,228
2025-08-05,11,Primaria 4°,TopKids,171,11,160
2025-08-05,11,Primaria 4°,TopKids,207,11,196
2025-08-05,11,Primaria 4°,EduMax,111,17,94
2025-08-05,11,Primaria 4°,SuperSchool,141,2,139
2025-08-05,11,Primaria 4°,SuperSchool,297,15,282
2025-08-05,11,Primaria 4°,SuperSchool,213,8,205
2025-08-05,11,Primaria 4°,SuperSchool,299,5,294
2025-08-05,11,Primaria 4°,SuperSchool,111,7,104
2025-08-05,11,Primaria 4°,EduMax,293,17,276
2025-08-05,11,Primaria 4°,TopKids,278,19,259
2025-08-05,11,Primaria 4°,SuperSchool,108,7,101
2025-08-05,11,Primaria 4°,SuperSchool,176,6,170
2025-08-05,11,Primaria 4°,SuperSchool,235,17,218
2025-08-05,11,Primaria 4°,TopKids,272,3,269
2025-08-05,11,Primaria 4°,SuperSchool,113,4,109
2025-08-05,11,Primaria 5°,SuperSchool,294,22,272
2025-08-05,11,Primaria 5°,EduMax,219,12,207
2025-08-05,11,Primaria 5°,EduMax,238,13,225
2025-08-05,11,Primaria 5°,TopKids,103,16,87
2025-08-05,11,Primaria 5°,TopKids,106,8,98
2025-08-05,11,Primaria 5°,SuperSchool,236,2,234
2025-08-05,11,Primaria 5°,EduMax,271,12,259
2025-08-05,11,Primaria 5°,EduMax,93,11,82
2025-08-05,11,Primaria 5°,TopKids,129,17,112
2025-08-05,11,Primaria 5°,EduMax,51,18,33
2025-08-05,11,Primaria 5°,TopKids,139,23,116
2025-08-05,11,Primaria 5°,EduMax,111,17,94
2025-08-05,11,Primaria 5°,EduMax,87,15,72
2025-08-05,11,Primaria 5°,TopKids,215,3,212
2025-08-05,11,Primaria 6°,SuperSchool,178,13,165
2025-08-05,11,Primaria 6°,SuperSchool,171,14,157
2025-08-05,11,Primaria 6°,SuperSchool,204,4,200
2025-08-05,11,Primaria 6°,TopKids,71,10,61
2025-08-05,11,Primaria 6°,TopKids,230,15,215
2025-08-05,11,Primaria 6°,TopKids,181,23,158
2025-08-05,11,Primaria 6°,TopKids,119,24,95
2025-08-05,11,Primaria 6°,EduMax,150,20,130
2025-08-05,11,Primaria 6°,SuperSchool,77,8,69
2025-08-05,11,Primaria 6°,SuperSchool,214,22,192
2025-08-05,11,Primaria 6°,EduMax,174,21,153
2025-08-05,11,Primaria 6°,TopKids,128,5,123
2025-08-05,11,Primaria 6°,EduMax,227,16,211
2025-08-05,11,Primaria 6°,EduMax,266,24,242
2025-08-05,11,Primaria 6°,EduMax,236,24,212
2025-08-05,11,Primaria 6°,TopKids,206,7,199
2025-08-05,11,Primaria 6°,SuperSchool,279,18,261
2025-08-05,11,Primaria 6°,EduMax,57,11,46
2025-08-05,12,Preescolar,EduMax,174,6,168
2025-08-05,12,Preescolar,TopKids,69,12,57
2025-08-05,12,Preescolar,TopKids,238,10,228
2025-08-05,12,Preescolar,TopKids,158,3,155
2025-08-05,12,Preescolar,TopKids,192,16,176
2025-08-05,12,Kínder,SuperSchool,162,3,159
2025-08-05,12,Kínder,TopKids,236,21,215
2025-08-05,12,Kínder,TopKids,231,11,220
2025-08-05,12,Kínder,EduMax,97,21,76
2025-08-05,12,Kínder,TopKids,135,6,129
2025-08-05,12,Kínder,TopKids,255,24,231
2025-08-05,12,Kínder,EduMax,226,4,222
2025-08-05,12,Kínder,TopKids,256,11,245
2025-08-05,12,Kínder,EduMax,148,3,145
2025-08-05,12,Kínder,SuperSchool,134,10,124
2025-08-05,12,Kínder,TopKids,74,4,70
2025-08-05,12,Kínder,SuperSchool,78,19,59
2025-08-05,12,Kínder,TopKids,243,10,233
2025-08-05,12,Kínder,SuperSchool,220,20,200
2025-08-05,12,Kínder,TopKids,136,24,112
2025-08-05,12,Kínder,TopKids,159,2,157
2025-08-05,12,Kínder,TopKids,77,5,72
2025-08-05,12,Primaria 1°,TopKids,182,19,163
2025-08-05,12,Primaria 1°,SuperSchool,61,18,43
2025-08-05,12,Primaria 1°,EduMax,162,10,152
2025-08-05,12,Primaria 1°,EduMax,202,14,188
2025-08-05,12,Primaria 1°,TopKids,81,11,70
2025-08-05,12,Primaria 1°,SuperSchool,195,23,172
2025-08-05,12,Primaria 1°,EduMax,259,24,235
2025-08-05,12,Primaria 1°,TopKids,124,21,103
2025-08-05,12,Primaria 1°,SuperSchool,136,9,127
2025-08-05,12,Primaria 1°,TopKids,138,9,129
2025-08-05,12,Primaria 1°,EduMax,251,22,229
2025-08-05,12,Primaria 1°,TopKids,114,7,107
2025-08-05,12,Primaria 1°,SuperSchool,192,8,184
2025-08-05,12,Primaria 1°,EduMax,263,18,245
2025-08-05,12,Primaria 1°,TopKids,258,14,244
2025-08-05,12,Primaria 1°,EduMax,227,20,207
2025-08-05,12,Primaria 1°,EduMax,161,1,160
2025-08-05,12,Primaria 1°,TopKids,108,11,97
2025-08-05,12,Primaria 1°,TopKids,61,8,53
2025-08-05,12,Primaria 2°,EduMax,215,3,212
2025-08-05,12,Primaria 2°,EduMax,143,13,130
2025-08-05,12,Primaria 2°,SuperSchool,115,5,110
2025-08-05,12,Primaria 2°,SuperSchool,279,2,277
2025-08-05,12,Primaria 2°,EduMax,75,11,64
2025-08-05,12,Primaria 2°,TopKids,199,20,179
2025-08-05,12,Primaria 2°,SuperSchool,89,17,72
2025-08-05,12,Primaria 2°,TopKids,193,14,179
2025-08-05,12,Primaria 2°,EduMax,284,7,277
2025-08-05,12,Primaria 2°,SuperSchool,236,15,221
2025-08-05,12,Primaria 3°,TopKids,230,23,207
2025-08-05,12,Primaria 3°,TopKids,122,3,119
2025-08-05,12,Primaria 3°,TopKids,261,5,256
2025-08-05,12,Primaria 3°,EduMax,258,15,243
2025-08-05,12,Primaria 3°,TopKids,168,8,160
2025-08-05,12,Primaria 3°,TopKids,144,21,123
2025-08-05,12,Primaria 3°,EduMax,159,20,139
2025-08-05,12,Primaria 3°,TopKids,102,23,79
2025-08-05,12,Primaria 3°,SuperSchool,66,10,56
2025-08-05,12,Primaria 3°,EduMax,206,19,187
2025-08-05,12,Primaria 3°,EduMax,60,2,58
2025-08-05,12,Primaria 3°,EduMax,120,12,108
2025-08-05,12,Primaria 4°,EduMax,69,18,51
2025-08-05,12,Primaria 4°,EduMax,265,10,255
2025-08-05,12,Primaria 4°,TopKids,278,20,258
2025-08-05,12,Primaria 4°,TopKids,86,8,78
2025-08-05,12,Primaria 4°,TopKids,153,11,142
2025-08-05,12,Primaria 4°,EduMax,241,8,233
2025-08-05,12,Primaria 4°,SuperSchool,143,24,119
2025-08-05,12,Primaria 4°,EduMax,88,17,71
2025-08-05,12,Primaria 4°,SuperSchool,62,4,58
2025-08-05,12,Primaria 4°,SuperSchool,75,22,53
2025-08-05,12,Primaria 4°,TopKids,131,6,125
2025-08-05,12,Primaria 4°,TopKids,137,24,113
2025-08-05,12,Primaria 4°,TopKids,71,2,69
2025-08-05,12,Primaria 4°,TopKids,168,11,157
2025-08-05,12,Primaria 5°,EduMax,145,5,140
2025-08-05,12,Primaria 5°,EduMax,59,8,51
2025-08-05,12,Primaria 5°,EduMax,201,3,198
2025-08-05,12,Primaria 5°,EduMax,136,17,119
2025-08-05,12,Primaria 5°,SuperSchool,296,10,286
2025-08-05,12,Primaria 5°,SuperSchool,232,10,222
2025-08-05,12,Primaria 5°,SuperSchool,233,2,231
2025-08-05,12,Primaria 5°,SuperSchool,71,13,58
2025-08-05,12,Primaria 5°,SuperSchool,225,18,207
2025-08-05,12,Primaria 5°,TopKids,253,8,245
2025-08-05,12,Primaria 5°,SuperSchool,192,10,182
2025-08-05,12,Primaria 5°,TopKids,256,23,233
2025-08-05,12,Primaria 5°,TopKids,62,17,45
2025-08-05,12,Primaria 5°,SuperSchool,89,20,69
2025-08-05,12,Primaria 5°,EduMax,268,21,247
2025-08-05,12,Primaria 5°,EduMax,126,16,110
2025-08-05,12,Primaria 6°,TopKids,125,12,113
2025-08-05,12,Primaria 6°,EduMax,260,7,253
2025-08-05,12,Primaria 6°,SuperSchool,276,16,260
2025-08-05,12,Primaria 6°,EduMax,193,23,170
2025-08-05,12,Primaria 6°,TopKids,245,8,237
2025-08-05,12,Primaria 6°,SuperSchool,158,17,141
2025-08-05,12,Primaria 6°,SuperSchool,278,6,272
2025-08-05,12,Primaria 6°,TopKids,126,14,112
2025-08-05,12,Primaria 6°,TopKids,103,4,99
2025-08-05,12,Primaria 6°,TopKids,121,13,108
2025-08-05,12,Primaria 6°,TopKids,279,6,273
2025-08-05,12,Primaria 6°,SuperSchool,271,3,268
2025-08-05,12,Primaria 6°,TopKids,286,22,264
2025-08-05,13,Preescolar,EduMax,145,6,139
2025-08-05,13,Preescolar,TopKids,121,6,115
2025-08-05,13,Preescolar,EduMax,81,3,78
2025-08-05,13,Preescolar,EduMax,180,12,168
2025-08-05,13,Preescolar,SuperSchool,108,5,103
2025-08-05,13,Preescolar,EduMax,101,9,92
2025-08-05,13,Kínder,EduMax,262,20,242
2025-08-05,13,Kínder,TopKids,176,22,154
2025-08-05,13,Kínder,SuperSchool,94,10,84
2025-08-05,13,Kínder,EduMax,226,20,206
2025-08-05,13,Kínder,SuperSchool,130,22,108
2025-08-05,13,Kínder,SuperSchool,178,15,163
2025-08-05,13,Kínder,SuperSchool,66,24,42
2025-08-05,13,Kínder,EduMax,121,18,103
2025-08-05,13,Kínder,TopKids,158,23,135
2025-08-05,13,Kínder,EduMax,121,8,113
2025-08-05,13,Kínder,TopKids,267,15,252
2025-08-05,13,Kínder,TopKids,62,7,55
2025-08-05,13,Kínder,SuperSchool,290,16,274
2025-08-05,13,Kínder,TopKids,51,22,29
2025-08-05,13,Kínder,EduMax,194,7,187
2025-08-05,13,Kínder,SuperSchool,145,18,127
2025-08-05,13,Kínder,SuperSchool,287,18,269
2025-08-05,13,Kínder,SuperSchool,220,21,199
2025-08-05,13,Kínder,EduMax,198,16,182
2025-08-05,13,Primaria 1°,SuperSchool,217,19,198
2025-08-05,13,Primaria 1°,TopKids,250,20,230
2025-08-05,13,Primaria 1°,EduMax,157,21,136
2025-08-05,13,Primaria 1°,TopKids,177,20,157
2025-08-05,13,Primaria 1°,EduMax,210,20,190
2025-08-05,13,Primaria 1°,SuperSchool,231,15,216
2025-08-05,13,Primaria 1°,SuperSchool,93,3,90
2025-08-05,13,Primaria 1°,TopKids,147,16,131
2025-08-05,13,Primaria 1°,SuperSchool,81,15,66
2025-08-05,13,Primaria 1°,SuperSchool,286,14,272
2025-08-05,13,Primaria 1°,SuperSchool,234,8,226
2025-08-05,13,Primaria 2°,TopKids,239,12,227
2025-08-05,13,Primaria 2°,SuperSchool,156,8,148
2025-08-05,13,Primaria 2°,EduMax,239,19,220
2025-08-05,13,Primaria 2°,TopKids,152,11,141
2025-08-05,13,Primaria 2°,TopKids,66,1,65
2025-08-05,13,Primaria 2°,EduMax,270,21,249
2025-08-05,13,Primaria 2°,SuperSchool,217,23,194
2025-08-05,13,Primaria 2°,EduMax,135,18,117
2025-08-05,13,Primaria 2°,EduMax,214,13,201
2025-08-05,13,Primaria 2°,TopKids,103,8,95
2025-08-05,13,Primaria 2°,SuperSchool,226,3,223
2025-08-05,13,Primaria 2°,TopKids,188,24,164
2025-08-05,13,Primaria 3°,SuperSchool,164,2,162
2025-08-05,13,Primaria 3°,TopKids,153,19,134
2025-08-05,13,Primaria 3°,TopKids,205,17,188
2025-08-05,13,Primaria 3°,EduMax,196,24,172
2025-08-05,13,Primaria 3°,EduMax,77,2,75
2025-08-05,13,Primaria 4°,TopKids,86,19,67
2025-08-05,13,Primaria 4°,EduMax,267,17,250
2025-08-05,13,Primaria 4°,TopKids,213,13,200
2025-08-05,13,Primaria 4°,EduMax,81,17,64
2025-08-05,13,Primaria 4°,SuperSchool,277,23,254
2025-08-05,13,Primaria 4°,EduMax,132,3,129
2025-08-05,13,Primaria 4°,EduMax,153,24,129
2025-08-05,13,Primaria 4°,TopKids,77,1,76
2025-08-05,13,Primaria 4°,EduMax,259,16,243
2025-08-05,13,Primaria 4°,SuperSchool,240,12,228
2025-08-05,13,Primaria 5°,EduMax,181,6,175
2025-08-05,13,Primaria 5°,TopKids,186,15,171
2025-08-05,13,Primaria 5°,TopKids,265,23,242
2025-08-05,13,Primaria 5°,EduMax,286,2,284
2025-08-05,13,Primaria 5°,TopKids,299,24,275
2025-08-05,13,Primaria 5°,EduMax,167,10,157
2025-08-05,13,Primaria 5°,SuperSchool,75,20,55
2025-08-05,13,Primaria 5°,EduMax,260,3,257
2025-08-05,13,Primaria 5°,SuperSchool,244,16,228
2025-08-05,13,Primaria 5°,SuperSchool,64,3,61
2025-08-05,13,Primaria 5°,SuperSchool,230,12,218
2025-08-05,13,Primaria 5°,EduMax,224,2,222
2025-08-05,13,Primaria 6°,TopKids,227,20,207
2025-08-05,13,Primaria 6°,TopKids,181,23,158
2025-08-05,13,Primaria 6°,TopKids,161,1,160
2025-08-05,13,Primaria 6°,EduMax,138,2,136
2025-08-05,13,Primaria 6°,EduMax,180,21,159
2025-08-05,13,Primaria 6°,SuperSchool,133,17,116
2025-08-05,13,Primaria 6°,EduMax,262,1,261
2025-08-05,13,Primaria 6°,EduMax,192,14,178
2025-08-05,13,Primaria 6°,TopKids,95,21,74
2025-08-05,13,Primaria 6°,SuperSchool,171,5,166
2025-08-05,13,Primaria 6°,EduMax,162,11,151
2025-08-05,14,Preescolar,TopKids,264,4,260
2025-08-05,14,Preescolar,TopKids,67,21,46
2025-08-05,14,Preescolar,TopKids,263,8,255
2025-08-05,14,Preescolar,TopKids,241,3,238
2025-08-05,14,Preescolar,EduMax,187,20,167
2025-08-05,14,Preescolar,SuperSchool,249,23,226
2025-08-05,14,Preescolar,TopKids,110,5,105
2025-08-05,14,Preescolar,EduMax,286,21,265
2025-08-05,14,Preescolar,TopKids,86,24,62
2025-08-05,14,Preescolar,TopKids,286,6,280
2025-08-05,14,Preescolar,SuperSchool,246,9,237
2025-08-05,14,Preescolar,TopKids,289,2,287
2025-08-05,14,Preescolar,SuperSchool,153,19,134
2025-08-05,14,Preescolar,EduMax,60,12,48
2025-08-05,14,Preescolar,TopKids,139,13,126
2025-08-05,14,Preescolar,TopKids,249,22,227
2025-08-05,14,Kínder,EduMax,143,9,134
2025-08-05,14,Kínder,TopKids,272,21,251
2025-08-05,14,Kínder,TopKids,211,23,188
2025-08-05,14,Kínder,TopKids,101,12,89
2025-08-05,14,Kínder,SuperSchool,232,22,210
2025-08-05,14,Kínder,SuperSchool,160,1,159
2025-08-05,14,Kínder,SuperSchool,298,10,288
2025-08-05,14,Kínder,EduMax,219,21,198
2025-08-05,14,Kínder,TopKids,258,22,236
2025-08-05,14,Kínder,EduMax,148,13,135
2025-08-05,14,Kínder,EduMax,224,17,207
2025-08-05,14,Kínder,SuperSchool,295,13,282
2025-08-05,14,Kínder,SuperSchool,215,17,198
2025-08-05,14,Kínder,EduMax,222,6,216
2025-08-05,14,Kínder,TopKids,159,14,145
2025-08-05,14,Kínder,TopKids,121,15,106
2025-08-05,14,Primaria 1°,SuperSchool,76,13,63
2025-08-05,14,Primaria 1°,SuperSchool,208,21,187
2025-08-05,14,Primaria 1°,TopKids,109,6,103
2025-08-05,14,Primaria 1°,SuperSchool,263,17,246
2025-08-05,14,Primaria 1°,TopKids,266,2,264
2025-08-05,14,Primaria 1°,EduMax,96,5,91
2025-08-05,14,Primaria 1°,EduMax,69,6,63
2025-08-05,14,Primaria 1°,EduMax,108,18,90
2025-08-05,14,Primaria 1°,EduMax,181,17,164
2025-08-05,14,Primaria 1°,SuperSchool,63,14,49
2025-08-05,14,Primaria 2°,TopKids,177,12,165
2025-08-05,14,Primaria 2°,TopKids,192,19,173
2025-08-05,14,Primaria 2°,TopKids,284,15,269
2025-08-05,14,Primaria 2°,TopKids,130,3,127
2025-08-05,14,Primaria 2°,TopKids,197,4,193
2025-08-05,14,Primaria 2°,TopKids,209,16,193
2025-08-05,14,Primaria 2°,SuperSchool,174,17,157
2025-08-05,14,Primaria 2°,TopKids,156,18,138
2025-08-05,14,Primaria 2°,SuperSchool,148,4,144
2025-08-05,14,Primaria 2°,SuperSchool,247,14,233
2025-08-05,14,Primaria 2°,SuperSchool,161,15,146
2025-08-05,14,Primaria 2°,TopKids,117,8,109
2025-08-05,14,Primaria 2°,TopKids,257,16,241
2025-08-05,14,Primaria 2°,EduMax,181,13,168
2025-08-05,14,Primaria 2°,EduMax,77,13,64
2025-08-05,14,Primaria 2°,EduMax,80,3,77
2025-08-05,14,Primaria 2°,EduMax,185,24,161
2025-08-05,14,Primaria 3°,TopKids,208,9,199
2025-08-05,14,Primaria 3°,TopKids,94,2,92
2025-08-05,14,Primaria 3°,TopKids,297,12,285
2025-08-05,14,Primaria 3°,TopKids,152,10,142
2025-08-05,14,Primaria 3°,SuperSchool,106,16,90
2025-08-05,14,Primaria 3°,TopKids,79,10,69
2025-08-05,14,Primaria 3°,EduMax,195,18,177
2025-08-05,14,Primaria 3°,SuperSchool,166,7,159
2025-08-05,14,Primaria 3°,EduMax,220,13,207
2025-08-05,14,Primaria 3°,TopKids,246,6,240
2025-08-05,14,Primaria 3°,EduMax,287,12,275
2025-08-05,14,Primaria 3°,SuperSchool,200,6,194
2025-08-05,14,Primaria 3°,EduMax,195,15,180
2025-08-05,14,Primaria 3°,EduMax,145,9,136
2025-08-05,14,Primaria 3°,SuperSchool,251,20,231
2025-08-05,14,Primaria 3°,EduMax,161,24,137
2025-08-05,14,Primaria 3°,TopKids,240,3,237
2025-08-05,14,Primaria 3°,EduMax,188,11,177
2025-08-05,14,Primaria 3°,SuperSchool,145,4,141
2025-08-05,14,Primaria 4°,SuperSchool,90,19,71
2025-08-05,14,Primaria 4°,SuperSchool,209,22,187
2025-08-05,14,Primaria 4°,EduMax,84,22,62
2025-08-05,14,Primaria 4°,SuperSchool,261,22,239
2025-08-05,14,Primaria 4°,TopKids,60,13,47
2025-08-05,14,Primaria 4°,TopKids,283,3,280
2025-08-05,14,Primaria 4°,SuperSchool,109,12,97
2025-08-05,14,Primaria 4°,TopKids,63,1,62
2025-08-05,14,Primaria 4°,EduMax,162,9,153
2025-08-05,14,Primaria 4°,SuperSchool,72,10,62
2025-08-05,14,Primaria 4°,TopKids,174,15,159
2025-08-05,14,Primaria 4°,SuperSchool,96,20,76
2025-08-05,14,Primaria 4°,TopKids,79,2,77
2025-08-05,14,Primaria 4°,SuperSchool,297,16,281
2025-08-05,14,Primaria 4°,TopKids,74,10,64
2025-08-05,14,Primaria 4°,EduMax,283,14,269
2025-08-05,14,Primaria 4°,EduMax,143,23,120
2025-08-05,14,Primaria 4°,TopKids,218,14,204
2025-08-05,14,Primaria 4°,TopKids,165,16,149
2025-08-05,14,Primaria 5°,EduMax,148,11,137
2025-08-05,14,Primaria 5°,TopKids,134,21,113
2025-08-05,14,Primaria 5°,EduMax,222,7,215
2025-08-05,14,Primaria 5°,TopKids,258,2,256
2025-08-05,14,Primaria 5°,SuperSchool,91,18,73
2025-08-05,14,Primaria 5°,EduMax,124,16,108
2025-08-05,14,Primaria 6°,TopKids,67,3,64
2025-08-05,14,Primaria 6°,SuperSchool,236,16,220
2025-08-05,14,Primaria 6°,EduMax,234,12,222
2025-08-05,14,Primaria 6°,TopKids,224,15,209
2025-08-05,14,Primaria 6°,EduMax,125,13,112
2025-08-05,15,Preescolar,TopKids,295,2,293
2025-08-05,15,Preescolar,EduMax,108,15,93
2025-08-05,15,Preescolar,TopKids,121,7,114
2025-08-05,15,Preescolar,TopKids,160,23,137
2025-08-05,15,Preescolar,EduMax,112,8,104
2025-08-05,15,Preescolar,SuperSchool,92,17,75
2025-08-05,15,Preescolar,TopKids,258,24,234
2025-08-05,15,Preescolar,SuperSchool,57,5,52
2025-08-05,15,Kínder,EduMax,142,15,127
2025-08-05,15,Kínder,SuperSchool,207,23,184
2025-08-05,15,Kínder,EduMax,251,7,244
2025-08-05,15,Kínder,SuperSchool,229,5,224
2025-08-05,15,Kínder,SuperSchool,244,15,229
2025-08-05,15,Kínder,TopKids,223,20,203
2025-08-05,15,Kínder,TopKids,254,10,244
2025-08-05,15,Kínder,SuperSchool,113,5,108
2025-08-05,15,Kínder,TopKids,104,20,84
2025-08-05,15,Kínder,SuperSchool,197,6,191
2025-08-05,15,Kínder,TopKids,213,2,211
2025-08-05,15,Kínder,EduMax,273,16,257
2025-08-05,15,Kínder,EduMax,246,22,224
2025-08-05,15,Kínder,EduMax,94,19,75
2025-08-05,15,Primaria 1°,EduMax,190,11,179
2025-08-05,15,Primaria 1°,EduMax,167,4,163
2025-08-05,15,Primaria 1°,EduMax,229,20,209
2025-08-05,15,Primaria 1°,TopKids,213,9,204
2025-08-05,15,Primaria 1°,TopKids,292,19,273
2025-08-05,15,Primaria 1°,EduMax,119,20,99
2025-08-05,15,Primaria 1°,TopKids,128,20,108
2025-08-05,15,Primaria 1°,SuperSchool,81,4,77
2025-08-05,15,Primaria 1°,EduMax,131,5,126
2025-08-05,15,Primaria 1°,TopKids,175,11,164
2025-08-05,15,Primaria 1°,SuperSchool,71,4,67
2025-08-05,15,Primaria 2°,EduMax,126,10,116
2025-08-05,15,Primaria 2°,SuperSchool,155,7,148
2025-08-05,15,Primaria 2°,TopKids,283,3,280
2025-08-05,15,Primaria 2°,SuperSchool,134,19,115
2025-08-05,15,Primaria 2°,TopKids,230,2,228
2025-08-05,15,Primaria 2°,TopKids,165,10,155
2025-08-05,15,Primaria 2°,EduMax,243,24,219
2025-08-05,15,Primaria 2°,SuperSchool,145,16,129
2025-08-05,15,Primaria 2°,EduMax,216,21,195
2025-08-05,15,Primaria 2°,TopKids,156,24,132
2025-08-05,15,Primaria 2°,SuperSchool,188,23,165
2025-08-05,15,Primaria 2°,SuperSchool,53,7,46
2025-08-05,15,Primaria 2°,EduMax,160,18,142
2025-08-05,15,Primaria 2°,TopKids,258,1,257
2025-08-05,15,Primaria 2°,TopKids,141,1,140
2025-08-05,15,Primaria 2°,TopKids,269,21,248
2025-08-05,15,Primaria 2°,EduMax,248,2,246
2025-08-05,15,Primaria 3°,TopKids,203,11,192
2025-08-05,15,Primaria 3°,EduMax,220,11,209
2025-08-05,15,Primaria 3°,SuperSchool,244,12,232
2025-08-05,15,Primaria 3°,TopKids,283,17,266
2025-08-05,15,Primaria 3°,EduMax,243,17,226
2025-08-05,15,Primaria 3°,EduMax,109,22,87
2025-08-05,15,Primaria 3°,EduMax,133,6,127
2025-08-05,15,Primaria 3°,SuperSchool,145,10,135
2025-08-05,15,Primaria 3°,EduMax,89,1,88
2025-08-05,15,Primaria 3°,SuperSchool,297,9,288
2025-08-05,15,Primaria 3°,EduMax,91,15,76
2025-08-05,15,Primaria 3°,SuperSchool,295,16,279
2025-08-05,15,Primaria 3°,SuperSchool,71,20,51
2025-08-05,15,Primaria 3°,EduMax,156,9,147
2025-08-05,15,Primaria 4°,EduMax,138,2,136
2025-08-05,15,Primaria 4°,SuperSchool,125,9,116
2025-08-05,15,Primaria 4°,EduMax,145,2,143
2025-08-05,15,Primaria 4°,TopKids,109,2,107
2025-08-05,15,Primaria 4°,SuperSchool,228,4,224
2025-08-05,15,Primaria 4°,EduMax,204,2,202
2025-08-05,15,Primaria 5°,SuperSchool,127,2,125
2025-08-05,15,Primaria 5°,SuperSchool,64,12,52
2025-08-05,15,Primaria 5°,SuperSchool,205,20,185
2025-08-05,15,Primaria 5°,SuperSchool,152,24,128
2025-08-05,15,Primaria 5°,SuperSchool,187,14,173
2025-08-05,15,Primaria 5°,EduMax,150,18,132
2025-08-05,15,Primaria 5°,EduMax,211,12,199
2025-08-05,15,Primaria 5°,EduMax,297,6,291
2025-08-05,15,Primaria 5°,SuperSchool,213,22,191
2025-08-05,15,Primaria 5°,EduMax,176,16,160
2025-08-05,15,Primaria 5°,SuperSchool,149,24,125
2025-08-05,15,Primaria 5°,SuperSchool,145,1,144
2025-08-05,15,Primaria 5°,SuperSchool,213,20,193
2025-08-05,15,Primaria 5°,EduMax,87,3,84
2025-08-05,15,Primaria 5°,TopKids,273,13,260
2025-08-05,15,Primaria 5°,TopKids,193,5,188
2025-08-05,15,Primaria 5°,SuperSchool,153,19,134
2025-08-05,15,Primaria 5°,EduMax,280,14,266
2025-08-05,15,Primaria 5°,EduMax,189,16,173
2025-08-05,15,Primaria 6°,SuperSchool,136,14,122
2025-08-05,15,Primaria 6°,SuperSchool,248,14,234
2025-08-05,15,Primaria 6°,TopKids,93,17,76
2025-08-05,15,Primaria 6°,SuperSchool,103,15,88
2025-08-05,15,Primaria 6°,EduMax,54,13,41
2025-08-05,16,Preescolar,TopKids,153,14,139
2025-08-05,16,Preescolar,TopKids,92,1,91
2025-08-05,16,Preescolar,SuperSchool,80,3,77
2025-08-05,16,Preescolar,SuperSchool,269,19,250
2025-08-05,16,Preescolar,EduMax,231,23,208
2025-08-05,16,Preescolar,SuperSchool,261,3,258
2025-08-05,16,Preescolar,SuperSchool,250,6,244
2025-08-05,16,Preescolar,TopKids,202,22,180
2025-08-05,16,Preescolar,EduMax,222,5,217
2025-08-05,16,Preescolar,TopKids,138,8,130
2025-08-05,16,Preescolar,TopKids,178,20,158
2025-08-05,16,Preescolar,TopKids,145,11,134
2025-08-05,16,Preescolar,TopKids,288,22,266
2025-08-05,16,Preescolar,TopKids,206,22,184
2025-08-05,16,Preescolar,EduMax,65,3,62
2025-08-05,16,Kínder,EduMax,244,1,243
2025-08-05,16,Kínder,TopKids,107,21,86
2025-08-05,16,Kínder,TopKids,178,17,161
2025-08-05,16,Kínder,EduMax,206,20,186
2025-08-05,16,Kínder,EduMax,57,16,41
2025-08-05,16,Kínder,TopKids,210,3,207
2025-08-05,16,Kínder,TopKids,246,12,234
2025-08-05,16,Kínder,SuperSchool,69,9,60
2025-08-05,16,Primaria 1°,TopKids,295,19,276
2025-08-05,16,Primaria 1°,EduMax,268,13,255
2025-08-05,16,Primaria 1°,TopKids,190,13,177
2025-08-05,16,Primaria 1°,SuperSchool,135,20,115
2025-08-05,16,Primaria 1°,TopKids,230,13,217
2025-08-05,16,Primaria 1°,EduMax,92,19,73
2025-08-05,16,Primaria 1°,EduMax,139,16,123
2025-08-05,16,Primaria 1°,TopKids,75,23,52
2025-08-05,16,Primaria 1°,TopKids,126,9,117
2025-08-05,16,Primaria 1°,TopKids,289,7,282
2025-08-05,16,Primaria 1°,TopKids,61,15,46
2025-08-05,16,Primaria 2°,TopKids,255,11,244
2025-08-05,16,Primaria 2°,EduMax,91,11,80
2025-08-05,16,Primaria 2°,EduMax,147,11,136
2025-08-05,16,Primaria 2°,TopKids,241,6,235
2025-08-05,16,Primaria 2°,EduMax,165,6,159
2025-08-05,16,Primaria 2°,SuperSchool,219,1,218
2025-08-05,16,Primaria 2°,TopKids,281,8,273
2025-08-05,16,Primaria 2°,TopKids,101,22,79
2025-08-05,16,Primaria 2°,TopKids,169,7,162
2025-08-05,16,Primaria 2°,TopKids,152,4,148
2025-08-05,16,Primaria 2°,SuperSchool,189,6,183
2025-08-05,16,Primaria 2°,EduMax,189,11,178
2025-08-05,16,Primaria 2°,TopKids,166,5,161
2025-08-05,16,Primaria 2°,EduMax,102,24,78
2025-08-05,16,Primaria 2°,SuperSchool,62,22,40
2025-08-05,16,Primaria 2°,EduMax,234,20,214
2025-08-05,16,Primaria 2°,EduMax,53,11,42
2025-08-05,16,Primaria 2°,SuperSchool,56,14,42
2025-08-05,16,Primaria 2°,EduMax,60,22,38
2025-08-05,16,Primaria 3°,TopKids,222,23,199
2025-08-05,16,Primaria 3°,EduMax,77,11,66
2025-08-05,16,Primaria 3°,TopKids,106,22,84
2025-08-05,16,Primaria 3°,SuperSchool,260,1,259
2025-08-05,16,Primaria 3°,EduMax,127,3,124
2025-08-05,16,Primaria 3°,EduMax,141,17,124
2025-08-05,16,Primaria 3°,TopKids,257,14,243
2025-08-05,16,Primaria 3°,EduMax,293,13,280
2025-08-05,16,Primaria 3°,TopKids,159,24,135
2025-08-05,16,Primaria 3°,SuperSchool,228,6,222
2025-08-05,16,Primaria 3°,EduMax,96,21,75
2025-08-05,16,Primaria 3°,EduMax,293,6,287
2025-08-05,16,Primaria 3°,TopKids,266,10,256
2025-08-05,16,Primaria 4°,EduMax,130,18,112
2025-08-05,16,Primaria 4°,SuperSchool,218,10,208
2025-08-05,16,Primaria 4°,EduMax,234,7,227
2025-08-05,16,Primaria 4°,SuperSchool,99,6,93
2025-08-05,16,Primaria 4°,TopKids,101,1,100
2025-08-05,16,Primaria 4°,SuperSchool,285,21,264
2025-08-05,16,Primaria 4°,EduMax,53,17,36
2025-08-05,16,Primaria 4°,TopKids,295,4,291
2025-08-05,16,Primaria 4°,SuperSchool,120,18,102
2025-08-05,16,Primaria 4°,SuperSchool,238,3,235
2025-08-05,16,Primaria 4°,SuperSchool,201,19,182
2025-08-05,16,Primaria 5°,EduMax,293,11,282
2025-08-05,16,Primaria 5°,TopKids,81,14,67
2025-08-05,16,Primaria 5°,SuperSchool,195,16,179
2025-08-05,16,Primaria 5°,TopKids,96,4,92
2025-08-05,16,Primaria 5°,SuperSchool,66,7,59
2025-08-05,16,Primaria 5°,EduMax,267,16,251
2025-08-05,16,Primaria 5°,TopKids,282,4,278
2025-08-05,16,Primaria 5°,EduMax,207,22,185
2025-08-05,16,Primaria 6°,EduMax,157,12,145
2025-08-05,16,Primaria 6°,EduMax,85,18,67
2025-08-05,16,Primaria 6°,EduMax,230,7,223
2025-08-05,16,Primaria 6°,SuperSchool,50,23,27
2025-08-05,16,Primaria 6°,EduMax,286,6,280
2025-08-05,16,Primaria 6°,EduMax,93,8,85
2025-08-05,16,Primaria 6°,EduMax,68,5,63
2025-08-05,16,Primaria 6°,EduMax,144,5,139
2025-08-05,16,Primaria 6°,EduMax,298,10,288
2025-08-05,16,Primaria 6°,SuperSchool,251,5,246
2025-08-05,16,Primaria 6°,EduMax,143,7,136
2025-08-05,16,Primaria 6°,SuperSchool,295,21,274
2025-08-05,16,Primaria 6°,TopKids,78,1,77
2025-08-05,16,Primaria 6°,TopKids,239,21,218
2025-08-05,16,Primaria 6°,TopKids,51,20,31
2025-08-06,9,Preescolar,SuperSchool,221,22,199
2025-08-06,9,Preescolar,EduMax,52,7,45
2025-08-06,9,Preescolar,TopKids,259,12,247
2025-08-06,9,Preescolar,EduMax,214,1,213
2025-08-06,9,Preescolar,TopKids,144,11,133
2025-08-06,9,Preescolar,TopKids,259,4,255
2025-08-06,9,Preescolar,SuperSchool,147,24,123
2025-08-06,9,Preescolar,EduMax,243,12,231
2025-08-06,9,Preescolar,TopKids,183,10,173
2025-08-06,9,Preescolar,SuperSchool,296,21,275
2025-08-06,9,Preescolar,TopKids,193,14,179
2025-08-06,9,Kínder,TopKids,168,17,151
2025-08-06,9,Kínder,SuperSchool,235,13,222
2025-08-06,9,Kínder,EduMax,209,5,204
2025-08-06,9,Kínder,TopKids,246,10,236
2025-08-06,9,Kínder,SuperSchool,273,10,263
2025-08-06,9,Kínder,TopKids,88,15,73
2025-08-06,9,Kínder,TopKids,206,15,191
2025-08-06,9,Kínder,TopKids,132,10,122
2025-08-06,9,Kínder,SuperSchool,256,3,253
2025-08-06,9,Kínder,EduMax,189,15,174
2025-08-06,9,Kínder,EduMax,126,19,107
2025-08-06,9,Primaria 1°,TopKids,171,20,151
2025-08-06,9,Primaria 1°,TopKids,181,19,162
2025-08-06,9,Primaria 1°,SuperSchool,244,13,231
2025-08-06,9,Primaria 1°,TopKids,65,13,52
2025-08-06,9,Primaria 1°,TopKids,289,9,280
2025-08-06,9,Primaria 1°,EduMax,126,21,105
2025-08-06,9,Primaria 1°,SuperSchool,120,15,105
2025-08-06,9,Primaria 2°,EduMax,275,9,266
2025-08-06,9,Primaria 2°,EduMax,201,17,184
2025-08-06,9,Primaria 2°,SuperSchool,221,1,220
2025-08-06,9,Primaria 2°,EduMax,284,16,268
2025-08-06,9,Primaria 2°,EduMax,249,24,225
2025-08-06,9,Primaria 2°,SuperSchool,266,18,248
2025-08-06,9,Primaria 2°,SuperSchool,258,14,244
2025-08-06,9,Primaria 2°,EduMax,218,4,214
2025-08-06,9,Primaria 2°,SuperSchool,72,11,61
2025-08-06,9,Primaria 2°,EduMax,288,5,283
2025-08-06,9,Primaria 2°,TopKids,74,18,56
2025-08-06,9,Primaria 3°,SuperSchool,92,14,78
2025-08-06,9,Primaria 3°,EduMax,108,19,89
2025-08-06,9,Primaria 3°,TopKids,209,15,194
2025-08-06,9,Primaria 3°,SuperSchool,281,20,261
2025-08-06,9,Primaria 3°,SuperSchool,117,14,103
2025-08-06,9,Primaria 3°,SuperSchool,275,16,259
2025-08-06,9,Primaria 3°,TopKids,203,8,195
2025-08-06,9,Primaria 3°,EduMax,257,24,233
2025-08-06,9,Primaria 3°,TopKids,143,13,130
2025-08-06,9,Primaria 3°,SuperSchool,246,20,226
2025-08-06,9,Primaria 3°,EduMax,131,15,116
2025-08-06,9,Primaria 3°,EduMax,115,10,105
2025-08-06,9,Primaria 3°,TopKids,94,18,76
2025-08-06,9,Primaria 3°,TopKids,112,12,100
2025-08-06,9,Primaria 3°,TopKids,254,18,236
2025-08-06,9,Primaria 3°,TopKids,298,23,275
2025-08-06,9,Primaria 3°,TopKids,196,3,193
2025-08-06,9,Primaria 3°,TopKids,102,14,88
2025-08-06,9,Primaria 4°,EduMax,94,12,82
2025-08-06,9,Primaria 4°,SuperSchool,242,19,223
2025-08-06,9,Primaria 4°,TopKids,168,22,146
2025-08-06,9,Primaria 4°,TopKids,233,22,211
2025-08-06,9,Primaria 4°,TopKids,131,12,119
2025-08-06,9,Primaria 4°,TopKids,269,1,268
2025-08-06,9,Primaria 4°,TopKids,77,20,57
2025-08-06,9,Primaria 4°,SuperSchool,175,17,158
2025-08-06,9,Primaria 4°,SuperSchool,203,3,200
2025-08-06,9,Primaria 4°,EduMax,176,3,173
2025-08-06,9,Primaria 4°,EduMax,126,23,103
2025-08-06,9,Primaria 4°,EduMax,199,16,183
2025-08-06,9,Primaria 4°,TopKids,237,13,224
2025-08-06,9,Primaria 4°,EduMax,121,12,109
2025-08-06,9,Primaria 4°,TopKids,296,22,274
2025-08-06,9,Primaria 4°,SuperSchool,75,8,67
2025-08-06,9,Primaria 4°,SuperSchool,202,9,193
2025-08-06,9,Primaria 4°,SuperSchool,183,23,160
2025-08-06,9,Primaria 5°,TopKids,220,11,209
2025-08-06,9,Primaria 5°,TopKids,145,13,132
2025-08-06,9,Primaria 5°,TopKids,195,23,172
2025-08-06,9,Primaria 5°,TopKids,274,21,253
2025-08-06,9,Primaria 5°,SuperSchool,152,23,129
2025-08-06,9,Primaria 5°,TopKids,94,12,82
2025-08-06,9,Primaria 5°,EduMax,137,19,118
2025-08-06,9,Primaria 6°,TopKids,219,7,212
2025-08-06,9,Primaria 6°,EduMax,225,20,205
2025-08-06,9,Primaria 6°,TopKids,183,9,174
2025-08-06,9,Primaria 6°,SuperSchool,158,21,137
2025-08-06,9,Primaria 6°,EduMax,89,16,73
2025-08-06,9,Primaria 6°,SuperSchool,126,17,109
2025-08-06,9,Primaria 6°,TopKids,197,5,192
2025-08-06,9,Primaria 6°,EduMax,166,17,149
2025-08-06,9,Primaria 6°,SuperSchool,243,18,225
2025-08-06,9,Primaria 6°,SuperSchool,183,11,172
2025-08-06,9,Primaria 6°,SuperSchool,87,6,81
2025-08-06,9,Primaria 6°,SuperSchool,124,14,110
2025-08-06,9,Primaria 6°,EduMax,217,3,214
2025-08-06,9,Primaria 6°,TopKids,166,3,163
2025-08-06,9,Primaria 6°,SuperSchool,201,19,182
2025-08-06,9,Primaria 6°,EduMax,241,17,224
2025-08-06,9,Primaria 6°,SuperSchool,137,13,124
2025-08-06,9,Primaria 6°,TopKids,239,1,238
2025-08-06,9,Primaria 6°,SuperSchool,222,17,205
2025-08-06,10,Preescolar,EduMax,284,2,282
2025-08-06,10,Preescolar,SuperSchool,193,2,191
2025-08-06,10,Preescolar,SuperSchool,196,23,173
2025-08-06,10,Preescolar,TopKids,74,16,58
2025-08-06,10,Preescolar,EduMax,292,9,283
2025-08-06,10,Preescolar,SuperSchool,91,19,72
2025-08-06,10,Preescolar,SuperSchool,211,16,195
2025-08-06,10,Preescolar,TopKids,195,2,193
2025-08-06,10,Preescolar,SuperSchool,174,13,161
2025-08-06,10,Preescolar,EduMax,70,6,64
2025-08-06,10,Preescolar,SuperSchool,97,11,86
2025-08-06,10,Preescolar,TopKids,80,10,70
2025-08-06,10,Preescolar,EduMax,79,20,59
2025-08-06,10,Preescolar,EduMax,237,24,213
2025-08-06,10,Preescolar,SuperSchool,122,15,107
2025-08-06,10,Preescolar,TopKids,217,9,208
2025-08-06,10,Kínder,SuperSchool,203,4,199
2025-08-06,10,Kínder,SuperSchool,65,15,50
2025-08-06,10,Kínder,TopKids,170,20,150
2025-08-06,10,Kínder,SuperSchool,296,5,291
2025-08-06,10,Kínder,TopKids,195,15,180
2025-08-06,10,Kínder,EduMax,142,13,129
2025-08-06,10,Kínder,EduMax,158,10,148
2025-08-06,10,Kínder,SuperSchool,144,9,135
2025-08-06,10,Kínder,TopKids,289,14,275
2025-08-06,10,Kínder,SuperSchool,271,21,250
2025-08-06,10,Kínder,TopKids,148,5,143
2025-08-06,10,Kínder,SuperSchool,91,13,78
2025-08-06,10,Kínder,SuperSchool,61,5,56
2025-08-06,10,Kínder,EduMax,297,9,288
2025-08-06,10,Kínder,TopKids,179,22,157
2025-08-06,10,Kínder,TopKids,152,8,144
2025-08-06,10,Kínder,TopKids,134,23,111
2025-08-06,10,Primaria 1°,EduMax,267,19,248
2025-08-06,10,Primaria 1°,SuperSchool,296,18,278
2025-08-06,10,Primaria 1°,TopKids,258,13,245
2025-08-06,10,Primaria 1°,EduMax,202,13,189
2025-08-06,10,Primaria 1°,EduMax,152,10,142
2025-08-06,10,Primaria 1°,TopKids,119,3,116
2025-08-06,10,Primaria 1°,EduMax,148,18,130
2025-08-06,10,Primaria 1°,TopKids,167,20,147
2025-08-06,10,Primaria 1°,SuperSchool,260,22,238
2025-08-06,10,Primaria 1°,TopKids,237,19,218
2025-08-06,10,Primaria 1°,EduMax,160,16,144
2025-08-06,10,Primaria 1°,SuperSchool,117,15,102
2025-08-06,10,Primaria 1°,SuperSchool,285,23,262
2025-08-06,10,Primaria 1°,TopKids,232,14,218
2025-08-06,10,Primaria 1°,SuperSchool,260,6,254
2025-08-06,10,Primaria 1°,TopKids,79,19,60
2025-08-06,10,Primaria 1°,SuperSchool,266,16,250
2025-08-06,10,Primaria 2°,EduMax,281,19,262
2025-08-06,10,Primaria 2°,EduMax,269,16,253
2025-08-06,10,Primaria 2°,TopKids,91,17,74
2025-08-06,10,Primaria 2°,TopKids,222,13,209
2025-08-06,10,Primaria 2°,TopKids,204,10,194
2025-08-06,10,Primaria 2°,EduMax,85,6,79
2025-08-06,10,Primaria 2°,EduMax,264,6,258
2025-08-06,10,Primaria 2°,SuperSchool,175,23,152
2025-08-06,10,Primaria 2°,SuperSchool,223,24,199
2025-08-06,10,Primaria 2°,TopKids,75,19,56
2025-08-06,10,Primaria 2°,EduMax,275,3,272
2025-08-06,10,Primaria 2°,TopKids,215,14,201
2025-08-06,10,Primaria 2°,TopKids,139,16,123
2025-08-06,10,Primaria 2°,SuperSchool,103,24,79
2025-08-06,10,Primaria 2°,TopKids,271,8,263
2025-08-06,10,Primaria 2°,TopKids,69,16,53
2025-08-06,10,Primaria 2°,EduMax,108,7,101
2025-08-06,10,Primaria 2°,SuperSchool,158,1,157
2025-08-06,10,Primaria 2°,SuperSchool,240,8,232
2025-08-06,10,Primaria 3°,EduMax,245,3,242
2025-08-06,10,Primaria 3°,TopKids,180,22,158
2025-08-06,10,Primaria 3°,SuperSchool,153,7,146
2025-08-06,10,Primaria 3°,TopKids,50,16,34
2025-08-06,10,Primaria 3°,EduMax,248,12,236
2025-08-06,10,Primaria 3°,TopKids,90,11,79
2025-08-06,10,Primaria 3°,EduMax,166,1,165
2025-08-06,10,Primaria 3°,EduMax,112,4,108
2025-08-06,10,Primaria 3°,SuperSchool,282,17,265
2025-08-06,10,Primaria 3°,TopKids,225,5,220
2025-08-06,10,Primaria 3°,TopKids,165,15,150
2025-08-06,10,Primaria 3°,EduMax,148,20,128
2025-08-06,10,Primaria 4°,TopKids,161,17,144
2025-08-06,10,Primaria 4°,TopKids,131,18,113
2025-08-06,10,Primaria 4°,EduMax,255,18,237
2025-08-06,10,Primaria 4°,TopKids,128,6,122
2025-08-06,10,Primaria 4°,TopKids,64,18,46
2025-08-06,10,Primaria 4°,TopKids,57,15,42
2025-08-06,10,Primaria 4°,TopKids,239,15,224
2025-08-06,10,Primaria 4°,SuperSchool,154,2,152
2025-08-06,10,Primaria 4°,SuperSchool,209,20,189
2025-08-06,10,Primaria 4°,SuperSchool,62,1,61
2025-08-06,10,Primaria 4°,EduMax,239,15,224
2025-08-06,10,Primaria 4°,EduMax,170,2,168
2025-08-06,10,Primaria 4°,EduMax,295,7,288
2025-08-06,10,Primaria 4°,SuperSchool,296,6,290
2025-08-06,10,Primaria 4°,EduMax,185,22,163
2025-08-06,10,Primaria 4°,EduMax,258,5,253
2025-08-06,10,Primaria 4°,EduMax,138,24,114
2025-08-06,10,Primaria 4°,EduMax,142,20,122
2025-08-06,10,Primaria 5°,SuperSchool,294,22,272
2025-08-06,10,Primaria 5°,TopKids,278,16,262
2025-08-06,10,Primaria 5°,EduMax,171,17,154
2025-08-06,10,Primaria 5°,TopKids,66,16,50
2025-08-06,10,Primaria 5°,EduMax,296,2,294
2025-08-06,10,Primaria 5°,SuperSchool,216,2,214
2025-08-06,10,Primaria 5°,EduMax,183,17,166
2025-08-06,10,Primaria 5°,TopKids,266,5,261
2025-08-06,10,Primaria 5°,SuperSchool,197,16,181
2025-08-06,10,Primaria 6°,SuperSchool,214,8,206
2025-08-06,10,Primaria 6°,SuperSchool,246,10,236
2025-08-06,10,Primaria 6°,SuperSchool,115,9,106
2025-08-06,10,Primaria 6°,TopKids,149,22,127
2025-08-06,10,Primaria 6°,EduMax,71,2,69
2025-08-06,10,Primaria 6°,TopKids,206,6,200
2025-08-06,10,Primaria 6°,TopKids,159,1,158
2025-08-06,11,Preescolar,TopKids,242,1,241
2025-08-06,11,Preescolar,SuperSchool,265,4,261
2025-08-06,11,Preescolar,SuperSchool,131,11,120
2025-08-06,11,Preescolar,TopKids,81,1,80
2025-08-06,11,Preescolar,EduMax,154,23,131
2025-08-06,11,Preescolar,EduMax,111,16,95
2025-08-06,11,Kínder,TopKids,163,10,153
2025-08-06,11,Kínder,SuperSchool,62,24,38
2025-08-06,11,Kínder,EduMax,231,13,218
2025-08-06,11,Kínder,SuperSchool,278,11,267
2025-08-06,11,Kínder,TopKids,238,10,228
2025-08-06,11,Kínder,SuperSchool,128,18,110
2025-08-06,11,Primaria 1°,EduMax,292,2,290
2025-08-06,11,Primaria 1°,EduMax,245,3,242
2025-08-06,11,Primaria 1°,TopKids,297,18,279
2025-08-06,11,Primaria 1°,EduMax,56,8,48
2025-08-06,11,Primaria 1°,EduMax,263,1,262
2025-08-06,11,Primaria 1°,EduMax,98,20,78
2025-08-06,11,Primaria 1°,EduMax,156,21,135
2025-08-06,11,Primaria 1°,EduMax,127,9,118
2025-08-06,11,Primaria 1°,TopKids,224,12,212
2025-08-06,11,Primaria 1°,EduMax,228,24,204
2025-08-06,11,Primaria 1°,TopKids,247,20,227
2025-08-06,11,Primaria 2°,TopKids,215,8,207
2025-08-06,11,Primaria 2°,SuperSchool,231,17,214
2025-08-06,11,Primaria 2°,SuperSchool,73,15,58
2025-08-06,11,Primaria 2°,TopKids,132,22,110
2025-08-06,11,Primaria 2°,TopKids,234,23,211
2025-08-06,11,Primaria 2°,TopKids,111,22,89
2025-08-06,11,Primaria 2°,TopKids,261,19,242
2025-08-06,11,Primaria 2°,SuperSchool,91,2,89
2025-08-06,11,Primaria 2°,SuperSchool,80,16,64
2025-08-06,11,Primaria 2°,EduMax,296,17,279
2025-08-06,11,Primaria 2°,EduMax,191,23,168
2025-08-06,11,Primaria 2°,SuperSchool,256,14,242
2025-08-06,11,Primaria 3°,EduMax,244,24,220
2025-08-06,11,Primaria 3°,TopKids,196,12,184
2025-08-06,11,Primaria 3°,EduMax,84,18,66
2025-08-06,11,Primaria 3°,SuperSchool,178,20,158
2025-08-06,11,Primaria 3°,SuperSchool,270,6,264
2025-08-06,11,Primaria 3°,SuperSchool,114,19,95
2025-08-06,11,Primaria 3°,SuperSchool,268,21,247
2025-08-06,11,Primaria 3°,SuperSchool,65,12,53
2025-08-06,11,Primaria 3°,TopKids,110,22,88
2025-08-06,11,Primaria 3°,EduMax,129,1,128
2025-08-06,11,Primaria 3°,EduMax,241,11,230
2025-08-06,11,Primaria 3°,SuperSchool,170,23,147
2025-08-06,11,Primaria 4°,SuperSchool,120,12,108
2025-08-06,11,Primaria 4°,TopKids,211,14,197
2025-08-06,11,Primaria 4°,SuperSchool,245,14,231
2025-08-06,11,Primaria 4°,EduMax,65,7,58
2025-08-06,11,Primaria 4°,TopKids,51,10,41
2025-08-06,11,Primaria 4°,EduMax,174,17,157
2025-08-06,11,Primaria 4°,SuperSchool,189,6,183
2025-08-06,11,Primaria 4°,EduMax,81,9,72
2025-08-06,11,Primaria 4°,SuperSchool,231,15,216
2025-08-06,11,Primaria 4°,SuperSchool,107,6,101
2025-08-06,11,Primaria 4°,TopKids,195,6,189
2025-08-06,11,Primaria 5°,SuperSchool,72,23,49
2025-08-06,11,Primaria 5°,EduMax,254,7,247
2025-08-06,11,Primaria 5°,TopKids,93,1,92
2025-08-06,11,Primaria 5°,TopKids,85,13,72
2025-08-06,11,Primaria 5°,TopKids,241,5,236
2025-08-06,11,Primaria 5°,SuperSchool,179,23,156
2025-08-06,11,Primaria 5°,EduMax,146,16,130
2025-08-06,11,Primaria 5°,TopKids,87,23,64
2025-08-06,11,Primaria 5°,EduMax,206,3,203
2025-08-06,11,Primaria 5°,TopKids,116,23,93
2025-08-06,11,Primaria 5°,SuperSchool,83,1,82
2025-08-06,11,Primaria 5°,SuperSchool,218,23,195
2025-08-06,11,Primaria 5°,TopKids,52,18,34
2025-08-06,11,Primaria 5°,TopKids,184,9,175
2025-08-06,11,Primaria 5°,SuperSchool,110,14,96
2025-08-06,11,Primaria 5°,EduMax,152,10,142
2025-08-06,11,Primaria 5°,TopKids,139,2,137
2025-08-06,11,Primaria 6°,SuperSchool,175,17,158
2025-08-06,11,Primaria 6°,SuperSchool,123,19,104
2025-08-06,11,Primaria 6°,TopKids,288,10,278
2025-08-06,11,Primaria 6°,TopKids,241,12,229
2025-08-06,11,Primaria 6°,SuperSchool,81,15,66
2025-08-06,11,Primaria 6°,EduMax,204,17,187
2025-08-06,11,Primaria 6°,EduMax,236,18,218
2025-08-06,11,Primaria 6°,EduMax,179,4,175
2025-08-06,11,Primaria 6°,EduMax,248,13,235
2025-08-06,11,Primaria 6°,TopKids,138,23,115
2025-08-06,11,Primaria 6°,EduMax,240,1,239
2025-08-06,11,Primaria 6°,TopKids,123,5,118
2025-08-06,11,Primaria 6°,TopKids,166,6,160
2025-08-06,11,Primaria 6°,SuperSchool,222,24,198
2025-08-06,11,Primaria 6°,EduMax,169,1,168
2025-08-06,11,Primaria 6°,SuperSchool,265,5,260
2025-08-06,11,Primaria 6°,SuperSchool,179,24,155
2025-08-06,11,Primaria 6°,SuperSchool,117,17,100
2025-08-06,12,Preescolar,SuperSchool,99,16,83
2025-08-06,12,Preescolar,EduMax,217,11,206
2025-08-06,12,Preescolar,SuperSchool,198,18,180
2025-08-06,12,Preescolar,TopKids,206,24,182
2025-08-06,12,Preescolar,EduMax,158,17,141
2025-08-06,12,Kínder,EduMax,289,20,269
2025-08-06,12,Kínder,SuperSchool,94,18,76
2025-08-06,12,Kínder,SuperSchool,122,14,108
2025-08-06,12,Kínder,SuperSchool,206,4,202
2025-08-06,12,Kínder,EduMax,197,24,173
2025-08-06,12,Kínder,TopKids,156,12,144
2025-08-06,12,Primaria 1°,SuperSchool,128,15,113
2025-08-06,12,Primaria 1°,SuperSchool,296,19,277
2025-08-06,12,Primaria 1°,EduMax,229,14,215
2025-08-06,12,Primaria 1°,SuperSchool,131,21,110
2025-08-06,12,Primaria 1°,TopKids,243,1,242
2025-08-06,12,Primaria 1°,EduMax,68,17,51
2025-08-06,12,Primaria 1°,SuperSchool,125,17,108
2025-08-06,12,Primaria 1°,TopKids,180,11,169
2025-08-06,12,Primaria 1°,SuperSchool,104,3,101
2025-08-06,12,Primaria 1°,SuperSchool,167,7,160
2025-08-06,12,Primaria 1°,EduMax,95,4,91
2025-08-06,12,Primaria 1°,SuperSchool,103,1,102
2025-08-06,12,Primaria 1°,SuperSchool,74,10,64
2025-08-06,12,Primaria 2°,EduMax,249,7,242
2025-08-06,12,Primaria 2°,EduMax,193,20,173
2025-08-06,12,Primaria 2°,TopKids,282,14,268
2025-08-06,12,Primaria 2°,TopKids,203,14,189
2025-08-06,12,Primaria 2°,TopKids,210,13,197
2025-08-06,12,Primaria 2°,TopKids,244,20,224
2025-08-06,12,Primaria 2°,SuperSchool,203,11,192
2025-08-06,12,Primaria 2°,EduMax,191,12,179
2025-08-06,12,Primaria 2°,EduMax,98,12,86
2025-08-06,12,Primaria 2°,EduMax,93,1,92
2025-08-06,12,Primaria 3°,EduMax,265,2,263
2025-08-06,12,Primaria 3°,EduMax,198,16,182
2025-08-06,12,Primaria 3°,EduMax,283,9,274
2025-08-06,12,Primaria 3°,TopKids,128,13,115
2025-08-06,12,Primaria 3°,TopKids,130,16,114
2025-08-06,12,Primaria 3°,EduMax,133,20,113
2025-08-06,12,Primaria 3°,TopKids,95,3,92
2025-08-06,12,Primaria 3°,TopKids,61,8,53
2025-08-06,12,Primaria 3°,EduMax,149,14,135
2025-08-06,12,Primaria 3°,TopKids,211,12,199
2025-08-06,12,Primaria 3°,SuperSchool,287,6,281
2025-08-06,12,Primaria 3°,SuperSchool,241,4,237
2025-08-06,12,Primaria 3°,EduMax,67,12,55
2025-08-06,12,Primaria 3°,TopKids,295,21,274
2025-08-06,12,Primaria 3°,TopKids,281,7,274
2025-08-06,12,Primaria 3°,TopKids,55,20,35
2025-08-06,12,Primaria 3°,TopKids,102,11,91
2025-08-06,12,Primaria 4°,TopKids,236,5,231
2025-08-06,12,Primaria 4°,TopKids,192,3,189
2025-08-06,12,Primaria 4°,EduMax,118,23,95
2025-08-06,12,Primaria 4°,SuperSchool,86,9,77
2025-08-06,12,Primaria 4°,TopKids,180,6,174
2025-08-06,12,Primaria 4°,SuperSchool,203,21,182
2025-08-06,12,Primaria 4°,SuperSchool,170,11,159
2025-08-06,12,Primaria 4°,EduMax,121,10,111
2025-08-06,12,Primaria 4°,SuperSchool,84,23,61
2025-08-06,12,Primaria 5°,TopKids,63,10,53
2025-08-06,12,Primaria 5°,EduMax,157,23,134
2025-08-06,12,Primaria 5°,EduMax,83,9,74
2025-08-06,12,Primaria 5°,EduMax,171,17,154
2025-08-06,12,Primaria 5°,SuperSchool,244,19,225
2025-08-06,12,Primaria 5°,SuperSchool,61,7,54
2025-08-06,12,Primaria 5°,EduMax,190,2,188
2025-08-06,12,Primaria 5°,EduMax,134,22,112
2025-08-06,12,Primaria 5°,SuperSchool,181,18,163
2025-08-06,12,Primaria 5°,SuperSchool,68,2,66
2025-08-06,12,Primaria 5°,SuperSchool,123,2,121
2025-08-06,12,Primaria 5°,EduMax,185,19,166
2025-08-06,12,Primaria 5°,TopKids,240,12,228
2025-08-06,12,Primaria 5°,SuperSchool,51,8,43
2025-08-06,12,Primaria 5°,EduMax,188,21,167
2025-08-06,12,Primaria 5°,EduMax,262,20,242
2025-08-06,12,Primaria 5°,SuperSchool,155,12,143
2025-08-06,12,Primaria 5°,SuperSchool,63,16,47
2025-08-06,12,Primaria 6°,EduMax,262,22,240
2025-08-06,12,Primaria 6°,SuperSchool,285,18,267
2025-08-06,12,Primaria 6°,EduMax,216,20,196
2025-08-06,12,Primaria 6°,TopKids,184,9,175
2025-08-06,12,Primaria 6°,SuperSchool,203,6,197
2025-08-06,12,Primaria 6°,EduMax,295,12,283
2025-08-06,12,Primaria 6°,EduMax,93,10,83
2025-08-06,12,Primaria 6°,TopKids,239,6,233
2025-08-06,12,Primaria 6°,SuperSchool,100,18,82
2025-08-06,12,Primaria 6°,EduMax,201,19,182
2025-08-06,13,Preescolar,SuperSchool,297,6,291
2025-08-06,13,Preescolar,SuperSchool,106,7,99
2025-08-06,13,Preescolar,SuperSchool,236,18,218
2025-08-06,13,Preescolar,SuperSchool,293,12,281
2025-08-06,13,Preescolar,EduMax,76,10,66
2025-08-06,13,Preescolar,EduMax,298,20,278
2025-08-06,13,Preescolar,EduMax,81,10,71
2025-08-06,13,Preescolar,EduMax,74,11,63
2025-08-06,13,Preescolar,TopKids,275,20,255
2025-08-06,13,Preescolar,EduMax,136,7,129
2025-08-06,13,Preescolar,SuperSchool,262,2,260
2025-08-06,13,Preescolar,EduMax,224,1,223
2025-08-06,13,Preescolar,SuperSchool,275,20,255
2025-08-06,13,Preescolar,TopKids,228,18,210
2025-08-06,13,Kínder,EduMax,195,14,181
2025-08-06,13,Kínder,EduMax,137,8,129
2025-08-06,13,Kínder,SuperSchool,79,12,67
2025-08-06,13,Kínder,SuperSchool,187,23,164
2025-08-06,13,Kínder,SuperSchool,188,2,186
2025-08-06,13,Kínder,EduMax,267,4,263
2025-08-06,13,Kínder,SuperSchool,224,13,211
2025-08-06,13,Kínder,SuperSchool,117,10,107
2025-08-06,13,Kínder,TopKids,259,5,254
2025-08-06,13,Kínder,EduMax,68,23,45
2025-08-06,13,Kínder,TopKids,103,16,87
2025-08-06,13,Kínder,SuperSchool,189,24,165
2025-08-06,13,Kínder,EduMax,102,8,94
2025-08-06,13,Kínder,EduMax,106,16,90
2025-08-06,13,Kínder,SuperSchool,203,22,181
2025-08-06,13,Kínder,SuperSchool,132,3,129
2025-08-06,13,Kínder,EduMax,153,12,141
2025-08-06,13,Primaria 1°,TopKids,157,18,139
2025-08-06,13,Primaria 1°,SuperSchool,278,22,256
2025-08-06,13,Primaria 1°,EduMax,176,5,171
2025-08-06,13,Primaria 1°,TopKids,75,24,51
2025-08-06,13,Primaria 1°,TopKids,217,9,208
2025-08-06,13,Primaria 1°,TopKids,278,13,265
2025-08-06,13,Primaria 2°,TopKids,123,20,103
2025-08-06,13,Primaria 2°,SuperSchool,218,21,197
2025-08-06,13,Primaria 2°,EduMax,227,15,212
2025-08-06,13,Primaria 2°,EduMax,297,7,290
2025-08-06,13,Primaria 2°,TopKids,192,16,176
2025-08-06,13,Primaria 2°,SuperSchool,247,1,246
2025-08-06,13,Primaria 2°,TopKids,157,5,152
2025-08-06,13,Primaria 2°,TopKids,270,21,249
2025-08-06,13,Primaria 2°,SuperSchool,286,17,269
2025-08-06,13,Primaria 3°,TopKids,217,13,204
2025-08-06,13,Primaria 3°,TopKids,172,16,156
2025-08-06,13,Primaria 3°,EduMax,238,4,234
2025-08-06,13,Primaria 3°,TopKids,102,10,92
2025-08-06,13,Primaria 3°,SuperSchool,93,12,81
2025-08-06,13,Primaria 3°,EduMax,150,16,134
2025-08-06,13,Primaria 3°,SuperSchool,269,9,260
2025-08-06,13,Primaria 3°,SuperSchool,231,20,211
2025-08-06,13,Primaria 3°,EduMax,77,24,53
2025-08-06,13,Primaria 3°,TopKids,246,2,244
2025-08-06,13,Primaria 3°,EduMax,275,13,262
2025-08-06,13,Primaria 3°,TopKids,155,13,142
2025-08-06,13,Primaria 3°,EduMax,127,11,116
2025-08-06,13,Primaria 3°,EduMax,215,4,211
2025-08-06,13,Primaria 3°,SuperSchool,82,7,75
2025-08-06,13,Primaria 4°,SuperSchool,249,5,244
2025-08-06,13,Primaria 4°,TopKids,123,11,112
2025-08-06,13,Primaria 4°,SuperSchool,192,6,186
2025-08-06,13,Primaria 4°,TopKids,54,19,35
2025-08-06,13,Primaria 4°,EduMax,100,10,90
2025-08-06,13,Primaria 4°,EduMax,53,18,35
2025-08-06,13,Primaria 4°,SuperSchool,264,12,252
2025-08-06,13,Primaria 4°,EduMax,213,5,208
2025-08-06,13,Primaria 4°,TopKids,58,21,37
2025-08-06,13,Primaria 4°,EduMax,220,3,217
2025-08-06,13,Primaria 4°,EduMax,112,23,89
2025-08-06,13,Primaria 4°,EduMax,154,14,140
2025-08-06,13,Primaria 5°,SuperSchool,218,13,205
2025-08-06,13,Primaria 5°,EduMax,256,10,246
2025-08-06,13,Primaria 5°,SuperSchool,147,10,137
2025-08-06,13,Primaria 5°,SuperSchool,216,17,199
2025-08-06,13,Primaria 5°,TopKids,140,24,116
2025-08-06,13,Primaria 5°,TopKids,223,10,213
2025-08-06,13,Primaria 5°,EduMax,216,17,199
2025-08-06,13,Primaria 5°,EduMax,87,23,64
2025-08-06,13,Primaria 6°,SuperSchool,108,9,99
2025-08-06,13,Primaria 6°,TopKids,264,2,262
2025-08-06,13,Primaria 6°,SuperSchool,265,8,257
2025-08-06,13,Primaria 6°,TopKids,175,15,160
2025-08-06,13,Primaria 6°,TopKids,160,8,152
2025-08-06,13,Primaria 6°,TopKids,92,2,90
2025-08-06,13,Primaria 6°,TopKids,265,17,248
2025-08-06,13,Primaria 6°,EduMax,129,15,114
2025-08-06,13,Primaria 6°,SuperSchool,192,4,188
2025-08-06,13,Primaria 6°,EduMax,285,4,281
2025-08-06,14,Preescolar,EduMax,162,22,140
2025-08-06,14,Preescolar,EduMax,298,18,280
2025-08-06,14,Preescolar,TopKids,173,17,156
2025-08-06,14,Preescolar,TopKids,262,24,238
2025-08-06,14,Preescolar,TopKids,93,23,70
2025-08-06,14,Preescolar,EduMax,230,20,210
2025-08-06,14,Preescolar,TopKids,200,16,184
2025-08-06,14,Kínder,SuperSchool,256,17,239
2025-08-06,14,Kínder,EduMax,86,13,73
2025-08-06,14,Kínder,TopKids,207,13,194
2025-08-06,14,Kínder,EduMax,255,4,251
2025-08-06,14,Kínder,TopKids,158,12,146
2025-08-06,14,Kínder,TopKids,298,12,286
2025-08-06,14,Kínder,SuperSchool,117,2,115
2025-08-06,14,Kínder,EduMax,118,23,95
2025-08-06,14,Kínder,EduMax,273,10,263
2025-08-06,14,Primaria 1°,SuperSchool,280,5,275
2025-08-06,14,Primaria 1°,EduMax,187,10,177
2025-08-06,14,Primaria 1°,EduMax,268,19,249
2025-08-06,14,Primaria 1°,SuperSchool,185,1,184
2025-08-06,14,Primaria 1°,SuperSchool,280,14,266
2025-08-06,14,Primaria 1°,SuperSchool,79,21,58
2025-08-06,14,Primaria 1°,SuperSchool,58,17,41
2025-08-06,14,Primaria 1°,SuperSchool,107,20,87
2025-08-06,14,Primaria 1°,SuperSchool,89,6,83
2025-08-06,14,Primaria 1°,TopKids,112,19,93
2025-08-06,14,Primaria 1°,EduMax,210,13,197
2025-08-06,14,Primaria 1°,EduMax,297,1,296
2025-08-06,14,Primaria 1°,EduMax,270,11,259
2025-08-06,14,Primaria 2°,EduMax,157,10,147
2025-08-06,14,Primaria 2°,TopKids,55,1,54
2025-08-06,14,Primaria 2°,TopKids,235,21,214
2025-08-06,14,Primaria 2°,TopKids,129,24,105
2025-08-06,14,Primaria 2°,EduMax,264,20,244
2025-08-06,14,Primaria 3°,EduMax,231,5,226
2025-08-06,14,Primaria 3°,SuperSchool,67,15,52
2025-08-06,14,Primaria 3°,EduMax,106,19,87
2025-08-06,14,Primaria 3°,SuperSchool,242,13,229
2025-08-06,14,Primaria 3°,TopKids,219,21,198
2025-08-06,14,Primaria 3°,TopKids,282,8,274
2025-08-06,14,Primaria 3°,TopKids,202,13,189
2025-08-06,14,Primaria 3°,EduMax,286,23,263
2025-08-06,14,Primaria 4°,SuperSchool,147,21,126
2025-08-06,14,Primaria 4°,TopKids,161,23,138
2025-08-06,14,Primaria 4°,EduMax,164,21,143
2025-08-06,14,Primaria 4°,SuperSchool,290,23,267
2025-08-06,14,Primaria 4°,SuperSchool,130,2,128
2025-08-06,14,Primaria 4°,TopKids,260,24,236
2025-08-06,14,Primaria 4°,TopKids,167,10,157
2025-08-06,14,Primaria 4°,EduMax,108,20,88
2025-08-06,14,Primaria 5°,SuperSchool,76,15,61
2025-08-06,14,Primaria 5°,EduMax,112,4,108
2025-08-06,14,Primaria 5°,TopKids,66,5,61
2025-08-06,14,Primaria 5°,TopKids,259,21,238
2025-08-06,14,Primaria 5°,EduMax,248,17,231
2025-08-06,14,Primaria 5°,TopKids,85,8,77
2025-08-06,14,Primaria 5°,SuperSchool,181,6,175
2025-08-06,14,Primaria 5°,SuperSchool,246,12,234
2025-08-06,14,Primaria 5°,SuperSchool,250,4,246
2025-08-06,14,Primaria 5°,TopKids,201,14,187
2025-08-06,14,Primaria 5°,SuperSchool,195,10,185
2025-08-06,14,Primaria 5°,SuperSchool,260,12,248
2025-08-06,14,Primaria 5°,EduMax,66,24,42
2025-08-06,14,Primaria 6°,TopKids,72,17,55
2025-08-06,14,Primaria 6°,SuperSchool,128,9,119
2025-08-06,14,Primaria 6°,TopKids,205,24,181
2025-08-06,14,Primaria 6°,SuperSchool,212,22,190
2025-08-06,14,Primaria 6°,TopKids,260,13,247
2025-08-06,14,Primaria 6°,SuperSchool,262,17,245
2025-08-06,14,Primaria 6°,SuperSchool,178,10,168
2025-08-06,14,Primaria 6°,TopKids,172,7,165
2025-08-06,14,Primaria 6°,EduMax,195,16,179
2025-08-06,14,Primaria 6°,EduMax,209,18,191
2025-08-06,14,Primaria 6°,TopKids,216,17,199
2025-08-06,14,Primaria 6°,SuperSchool,131,12,119
2025-08-06,14,Primaria 6°,EduMax,272,2,270
2025-08-06,14,Primaria 6°,TopKids,213,18,195
2025-08-06,14,Primaria 6°,EduMax,236,9,227
2025-08-06,15,Preescolar,SuperSchool,287,8,279
2025-08-06,15,Preescolar,TopKids,228,3,225
2025-08-06,15,Preescolar,EduMax,182,14,168
2025-08-06,15,Preescolar,EduMax,53,7,46
2025-08-06,15,Preescolar,SuperSchool,205,12,193
2025-08-06,15,Preescolar,EduMax,284,14,270
2025-08-06,15,Preescolar,EduMax,208,23,185
2025-08-06,15,Preescolar,SuperSchool,215,23,192
2025-08-06,15,Preescolar,TopKids,137,1,136
2025-08-06,15,Preescolar,TopKids,234,12,222
2025-08-06,15,Preescolar,EduMax,182,12,170
2025-08-06,15,Preescolar,EduMax,91,6,85
2025-08-06,15,Preescolar,TopKids,195,2,193
2025-08-06,15,Preescolar,EduMax,256,12,244
2025-08-06,15,Preescolar,EduMax,66,4,62
2025-08-06,15,Kínder,EduMax,90,19,71
2025-08-06,15,Kínder,TopKids,296,7,289
2025-08-06,15,Kínder,TopKids,211,6,205
2025-08-06,15,Kínder,EduMax,279,13,266
2025-08-06,15,Kínder,EduMax,228,2,226
2025-08-06,15,Kínder,TopKids,127,6,121
2025-08-06,15,Kínder,EduMax,150,18,132
2025-08-06,15,Kínder,TopKids,52,22,30
2025-08-06,15,Kínder,EduMax,123,19,104
2025-08-06,15,Kínder,TopKids,125,16,109
2025-08-06,15,Kínder,SuperSchool,56,13,43
2025-08-06,15,Primaria 1°,EduMax,53,10,43
2025-08-06,15,Primaria 1°,TopKids,137,17,120
2025-08-06,15,Primaria 1°,EduMax,260,5,255
2025-08-06,15,Primaria 1°,EduMax,186,13,173
2025-08-06,15,Primaria 1°,TopKids,70,24,46
2025-08-06,15,Primaria 1°,EduMax,53,24,29
2025-08-06,15,Primaria 1°,TopKids,276,3,273
2025-08-06,15,Primaria 1°,SuperSchool,150,8,142
2025-08-06,15,Primaria 1°,EduMax,84,24,60
2025-08-06,15,Primaria 1°,SuperSchool,89,13,76
2025-08-06,15,Primaria 1°,EduMax,127,13,114
2025-08-06,15,Primaria 1°,TopKids,55,17,38
2025-08-06,15,Primaria 2°,SuperSchool,148,17,131
2025-08-06,15,Primaria 2°,SuperSchool,51,13,38
2025-08-06,15,Primaria 2°,EduMax,101,11,90
2025-08-06,15,Primaria 2°,TopKids,267,22,245
2025-08-06,15,Primaria 2°,TopKids,156,23,133
2025-08-06,15,Primaria 2°,TopKids,276,12,264
2025-08-06,15,Primaria 2°,SuperSchool,133,7,126
2025-08-06,15,Primaria 2°,TopKids,62,9,53
2025-08-06,15,Primaria 3°,SuperSchool,286,12,274
2025-08-06,15,Primaria 3°,SuperSchool,169,10,159
2025-08-06,15,Primaria 3°,SuperSchool,106,8,98
2025-08-06,15,Primaria 3°,EduMax,129,13,116
2025-08-06,15,Primaria 3°,TopKids,52,24,28
2025-08-06,15,Primaria 3°,SuperSchool,267,11,256
2025-08-06,15,Primaria 3°,EduMax,120,21,99
2025-08-06,15,Primaria 3°,EduMax,155,20,135
2025-08-06,15,Primaria 3°,EduMax,116,8,108
2025-08-06,15,Primaria 3°,TopKids,124,13,111
2025-08-06,15,Primaria 3°,TopKids,286,2,284
2025-08-06,15,Primaria 3°,EduMax,90,20,70
2025-08-06,15,Primaria 3°,SuperSchool,275,18,257
2025-08-06,15,Primaria 4°,TopKids,88,17,71
2025-08-06,15,Primaria 4°,SuperSchool,188,6,182
2025-08-06,15,Primaria 4°,SuperSchool,200,14,186
2025-08-06,15,Primaria 4°,EduMax,215,2,213
2025-08-06,15,Primaria 4°,EduMax,133,15,118
2025-08-06,15,Primaria 4°,SuperSchool,142,8,134
2025-08-06,15,Primaria 4°,SuperSchool,98,20,78
2025-08-06,15,Primaria 4°,SuperSchool,71,18,53
2025-08-06,15,Primaria 4°,TopKids,182,7,175
2025-08-06,15,Primaria 4°,EduMax,215,22,193
2025-08-06,15,Primaria 4°,SuperSchool,86,19,67
2025-08-06,15,Primaria 4°,TopKids,113,10,103
2025-08-06,15,Primaria 4°,TopKids,219,16,203
2025-08-06,15,Primaria 5°,EduMax,136,1,135
2025-08-06,15,Primaria 5°,EduMax,151,3,148
2025-08-06,15,Primaria 5°,EduMax,205,2,203
2025-08-06,15,Primaria 5°,EduMax,190,9,181
2025-08-06,15,Primaria 5°,TopKids,118,23,95
2025-08-06,15,Primaria 5°,SuperSchool,280,13,267
2025-08-06,15,Primaria 5°,SuperSchool,140,13,127
2025-08-06,15,Primaria 5°,TopKids,203,7,196
2025-08-06,15,Primaria 5°,EduMax,96,21,75
2025-08-06,15,Primaria 5°,TopKids,87,5,82
2025-08-06,15,Primaria 5°,TopKids,269,2,267
2025-08-06,15,Primaria 5°,SuperSchool,192,16,176
2025-08-06,15,Primaria 5°,TopKids,196,9,187
2025-08-06,15,Primaria 5°,SuperSchool,231,19,212
2025-08-06,15,Primaria 5°,TopKids,53,3,50
2025-08-06,15,Primaria 5°,SuperSchool,165,11,154
2025-08-06,15,Primaria 6°,EduMax,235,11,224
2025-08-06,15,Primaria 6°,TopKids,274,21,253
2025-08-06,15,Primaria 6°,TopKids,272,6,266
2025-08-06,15,Primaria 6°,EduMax,115,4,111
2025-08-06,15,Primaria 6°,TopKids,160,18,142
2025-08-06,16,Preescolar,SuperSchool,240,3,237
2025-08-06,16,Preescolar,TopKids,208,7,201
2025-08-06,16,Preescolar,SuperSchool,74,11,63
2025-08-06,16,Preescolar,EduMax,133,3,130
2025-08-06,16,Preescolar,TopKids,100,2,98
2025-08-06,16,Preescolar,EduMax,175,12,163
2025-08-06,16,Preescolar,SuperSchool,241,10,231
2025-08-06,16,Preescolar,SuperSchool,58,2,56
2025-08-06,16,Preescolar,EduMax,237,6,231
2025-08-06,16,Preescolar,SuperSchool,208,10,198
2025-08-06,16,Preescolar,EduMax,125,4,121
2025-08-06,16,Preescolar,EduMax,134,17,117
2025-08-06,16,Preescolar,TopKids,119,16,103
2025-08-06,16,Preescolar,SuperSchool,180,10,170
2025-08-06,16,Preescolar,SuperSchool,287,21,266
2025-08-06,16,Kínder,EduMax,279,12,267
2025-08-06,16,Kínder,EduMax,121,5,116
2025-08-06,16,Kínder,EduMax,64,16,48
2025-08-06,16,Kínder,SuperSchool,193,5,188
2025-08-06,16,Kínder,TopKids,229,15,214
2025-08-06,16,Kínder,TopKids,62,24,38
2025-08-06,16,Kínder,TopKids,284,21,263
2025-08-06,16,Kínder,EduMax,231,6,225
2025-08-06,16,Kínder,EduMax,235,6,229
2025-08-06,16,Kínder,EduMax,266,11,255
2025-08-06,16,Kínder,SuperSchool,166,7,159
2025-08-06,16,Kínder,EduMax,70,8,62
2025-08-06,16,Kínder,TopKids,295,21,274
2025-08-06,16,Kínder,EduMax,95,18,77
2025-08-06,16,Kínder,SuperSchool,142,16,126
2025-08-06,16,Kínder,SuperSchool,64,10,54
2025-08-06,16,Kínder,SuperSchool,295,16,279
2025-08-06,16,Primaria 1°,SuperSchool,167,5,162
2025-08-06,16,Primaria 1°,EduMax,120,23,97
2025-08-06,16,Primaria 1°,SuperSchool,281,16,265
2025-08-06,16,Primaria 1°,EduMax,205,16,189
2025-08-06,16,Primaria 1°,EduMax,208,14,194
2025-08-06,16,Primaria 1°,SuperSchool,274,9,265
2025-08-06,16,Primaria 1°,SuperSchool,140,24,116
2025-08-06,16,Primaria 1°,SuperSchool,139,19,120
2025-08-06,16,Primaria 2°,TopKids,269,8,261
2025-08-06,16,Primaria 2°,TopKids,270,5,265
2025-08-06,16,Primaria 2°,EduMax,184,10,174
2025-08-06,16,Primaria 2°,SuperSchool,76,14,62
2025-08-06,16,Primaria 2°,EduMax,74,9,65
2025-08-06,16,Primaria 3°,TopKids,178,23,155
2025-08-06,16,Primaria 3°,EduMax,219,20,199
2025-08-06,16,Primaria 3°,SuperSchool,231,3,228
2025-08-06,16,Primaria 3°,EduMax,174,6,168
2025-08-06,16,Primaria 3°,SuperSchool,115,18,97
2025-08-06,16,Primaria 3°,TopKids,51,12,39
2025-08-06,16,Primaria 3°,EduMax,86,20,66
2025-08-06,16,Primaria 3°,TopKids,73,16,57
2025-08-06,16,Primaria 3°,SuperSchool,242,17,225
2025-08-06,16,Primaria 4°,SuperSchool,166,20,146
2025-08-06,16,Primaria 4°,SuperSchool,271,9,262
2025-08-06,16,Primaria 4°,TopKids,52,14,38
2025-08-06,16,Primaria 4°,TopKids,124,24,100
2025-08-06,16,Primaria 4°,EduMax,241,12,229
2025-08-06,16,Primaria 4°,SuperSchool,203,13,190
2025-08-06,16,Primaria 4°,SuperSchool,73,10,63
2025-08-06,16,Primaria 4°,TopKids,73,4,69
2025-08-06,16,Primaria 4°,TopKids,258,19,239
2025-08-06,16,Primaria 4°,EduMax,256,16,240
2025-08-06,16,Primaria 4°,TopKids,298,2,296
2025-08-06,16,Primaria 4°,TopKids,242,15,227
2025-08-06,16,Primaria 4°,EduMax,164,4,160
2025-08-06,16,Primaria 4°,TopKids,118,3,115
2025-08-06,16,Primaria 4°,SuperSchool,187,11,176
2025-08-06,16,Primaria 5°,EduMax,152,9,143
2025-08-06,16,Primaria 5°,EduMax,227,23,204
2025-08-06,16,Primaria 5°,TopKids,108,7,101
2025-08-06,16,Primaria 5°,TopKids,253,7,246
2025-08-06,16,Primaria 5°,SuperSchool,75,1,74
2025-08-06,16,Primaria 5°,SuperSchool,225,15,210
2025-08-06,16,Primaria 6°,SuperSchool,176,7,169
2025-08-06,16,Primaria 6°,EduMax,166,4,162
2025-08-06,16,Primaria 6°,SuperSchool,50,24,26
2025-08-06,16,Primaria 6°,TopKids,161,22,139
2025-08-06,16,Primaria 6°,SuperSchool,232,16,216
2025-08-06,16,Primaria 6°,EduMax,132,1,131
2025-08-07,9,Preescolar,TopKids,71,24,47
2025-08-07,9,Preescolar,TopKids,158,20,138
2025-08-07,9,Preescolar,SuperSchool,230,4,226
2025-08-07,9,Preescolar,SuperSchool,259,18,241
2025-08-07,9,Preescolar,SuperSchool,195,22,173
2025-08-07,9,Preescolar,EduMax,70,4,66
2025-08-07,9,Preescolar,TopKids,96,7,89
2025-08-07,9,Preescolar,SuperSchool,103,21,82
2025-08-07,9,Preescolar,SuperSchool,129,19,110
2025-08-07,9,Kínder,TopKids,255,17,238
2025-08-07,9,Kínder,SuperSchool,51,20,31
2025-08-07,9,Kínder,EduMax,191,1,190
2025-08-07,9,Kínder,TopKids,235,7,228
2025-08-07,9,Kínder,EduMax,288,19,269
2025-08-07,9,Kínder,EduMax,292,9,283
2025-08-07,9,Kínder,TopKids,172,5,167
2025-08-07,9,Kínder,EduMax,193,4,189
2025-08-07,9,Kínder,SuperSchool,184,14,170
2025-08-07,9,Kínder,TopKids,61,3,58
2025-08-07,9,Kínder,SuperSchool,130,10,120
2025-08-07,9,Kínder,EduMax,220,17,203
2025-08-07,9,Kínder,SuperSchool,94,10,84
2025-08-07,9,Primaria 1°,SuperSchool,210,4,206
2025-08-07,9,Primaria 1°,EduMax,58,18,40
2025-08-07,9,Primaria 1°,EduMax,202,15,187
2025-08-07,9,Primaria 1°,EduMax,169,10,159
2025-08-07,9,Primaria 1°,SuperSchool,128,4,124
2025-08-07,9,Primaria 1°,EduMax,291,17,274
2025-08-07,9,Primaria 1°,TopKids,257,11,246
2025-08-07,9,Primaria 1°,EduMax,180,19,161
2025-08-07,9,Primaria 1°,EduMax,111,10,101
2025-08-07,9,Primaria 1°,EduMax,222,10,212
2025-08-07,9,Primaria 1°,EduMax,235,20,215
2025-08-07,9,Primaria 1°,EduMax,161,6,155
2025-08-07,9,Primaria 1°,SuperSchool,245,23,222
2025-08-07,9,Primaria 2°,SuperSchool,141,20,121
2025-08-07,9,Primaria 2°,SuperSchool,57,12,45
2025-08-07,9,Primaria 2°,EduMax,285,5,280
2025-08-07,9,Primaria 2°,EduMax,118,13,105
2025-08-07,9,Primaria 2°,SuperSchool,283,1,282
2025-08-07,9,Primaria 2°,EduMax,116,18,98
2025-08-07,9,Primaria 2°,SuperSchool,180,9,171
2025-08-07,9,Primaria 2°,EduMax,179,3,176
2025-08-07,9,Primaria 2°,EduMax,117,19,98
2025-08-07,9,Primaria 2°,SuperSchool,280,12,268
2025-08-07,9,Primaria 2°,TopKids,104,23,81
2025-08-07,9,Primaria 2°,SuperSchool,179,22,157
2025-08-07,9,Primaria 2°,SuperSchool,221,12,209
2025-08-07,9,Primaria 2°,TopKids,179,18,161
2025-08-07,9,Primaria 2°,SuperSchool,159,5,154
2025-08-07,9,Primaria 2°,EduMax,155,12,143
2025-08-07,9,Primaria 2°,EduMax,105,11,94
2025-08-07,9,Primaria 2°,TopKids,266,2,264
2025-08-07,9,Primaria 3°,EduMax,120,6,114
2025-08-07,9,Primaria 3°,EduMax,104,3,101
2025-08-07,9,Primaria 3°,SuperSchool,52,24,28
2025-08-07,9,Primaria 3°,SuperSchool,247,11,236
2025-08-07,9,Primaria 3°,EduMax,98,10,88
2025-08-07,9,Primaria 3°,SuperSchool,277,2,275
2025-08-07,9,Primaria 3°,TopKids,152,2,150
2025-08-07,9,Primaria 3°,EduMax,195,21,174
2025-08-07,9,Primaria 3°,EduMax,93,22,71
2025-08-07,9,Primaria 4°,TopKids,271,18,253
2025-08-07,9,Primaria 4°,TopKids,174,8,166
2025-08-07,9,Primaria 4°,EduMax,106,15,91
2025-08-07,9,Primaria 4°,SuperSchool,164,20,144
2025-08-07,9,Primaria 4°,SuperSchool,68,5,63
2025-08-07,9,Primaria 4°,TopKids,256,8,248
2025-08-07,9,Primaria 4°,TopKids,264,8,256
2025-08-07,9,Primaria 4°,EduMax,76,19,57
2025-08-07,9,Primaria 4°,EduMax,219,7,212
2025-08-07,9,Primaria 5°,SuperSchool,82,19,63
2025-08-07,9,Primaria 5°,SuperSchool,260,1,259
2025-08-07,9,Primaria 5°,TopKids,65,23,42
2025-08-07,9,Primaria 5°,TopKids,75,12,63
2025-08-07,9,Primaria 5°,SuperSchool,155,21,134
2025-08-07,9,Primaria 5°,SuperSchool,226,5,221
2025-08-07,9,Primaria 5°,EduMax,256,13,243
2025-08-07,9,Primaria 5°,SuperSchool,156,23,133
2025-08-07,9,Primaria 5°,SuperSchool,284,18,266
2025-08-07,9,Primaria 5°,EduMax,166,16,150
2025-08-07,9,Primaria 5°,SuperSchool,88,1,87
2025-08-07,9,Primaria 5°,EduMax,225,1,224
2025-08-07,9,Primaria 5°,SuperSchool,215,2,213
2025-08-07,9,Primaria 5°,SuperSchool,183,14,169
2025-08-07,9,Primaria 5°,EduMax,215,10,205
2025-08-07,9,Primaria 5°,EduMax,204,9,195
2025-08-07,9,Primaria 6°,EduMax,66,23,43
2025-08-07,9,Primaria 6°,EduMax,206,6,200
2025-08-07,9,Primaria 6°,EduMax,199,22,177
2025-08-07,9,Primaria 6°,EduMax,75,7,68
2025-08-07,9,Primaria 6°,TopKids,191,22,169
2025-08-07,9,Primaria 6°,TopKids,200,16,184
2025-08-07,9,Primaria 6°,TopKids,153,18,135
2025-08-07,9,Primaria 6°,SuperSchool,190,21,169
2025-08-07,9,Primaria 6°,SuperSchool,187,21,166
2025-08-07,9,Primaria 6°,TopKids,58,15,43
2025-08-07,9,Primaria 6°,EduMax,202,13,189
2025-08-07,9,Primaria 6°,EduMax,100,2,98
2025-08-07,10,Preescolar,EduMax,180,10,170
2025-08-07,10,Preescolar,TopKids,119,23,96
2025-08-07,10,Preescolar,SuperSchool,196,3,193
2025-08-07,10,Preescolar,EduMax,152,9,143
2025-08-07,10,Preescolar,SuperSchool,116,11,105
2025-08-07,10,Preescolar,SuperSchool,143,4,139
2025-08-07,10,Preescolar,SuperSchool,178,18,160
2025-08-07,10,Kínder,SuperSchool,90,2,88
2025-08-07,10,Kínder,SuperSchool,222,16,206
2025-08-07,10,Kínder,TopKids,199,4,195
2025-08-07,10,Kínder,TopKids,296,14,282
2025-08-07,10,Kínder,SuperSchool,212,16,196
2025-08-07,10,Kínder,EduMax,192,10,182
2025-08-07,10,Kínder,SuperSchool,92,16,76
2025-08-07,10,Kínder,EduMax,226,19,207
2025-08-07,10,Kínder,EduMax,201,23,178
2025-08-07,10,Kínder,EduMax,215,19,196
2025-08-07,10,Kínder,EduMax,78,3,75
2025-08-07,10,Kínder,EduMax,127,16,111
2025-08-07,10,Kínder,SuperSchool,230,3,227
2025-08-07,10,Kínder,EduMax,139,18,121
2025-08-07,10,Kínder,SuperSchool,87,23,64
2025-08-07,10,Kínder,SuperSchool,298,1,297
2025-08-07,10,Primaria 1°,TopKids,155,6,149
2025-08-07,10,Primaria 1°,TopKids,93,4,89
2025-08-07,10,Primaria 1°,SuperSchool,66,8,58
2025-08-07,10,Primaria 1°,EduMax,293,3,290
2025-08-07,10,Primaria 1°,TopKids,253,2,251
2025-08-07,10,Primaria 1°,EduMax,263,23,240
2025-08-07,10,Primaria 1°,EduMax,118,9,109
2025-08-07,10,Primaria 1°,SuperSchool,60,5,55
2025-08-07,10,Primaria 1°,TopKids,140,17,123
2025-08-07,10,Primaria 2°,TopKids,210,7,203
2025-08-07,10,Primaria 2°,EduMax,223,5,218
2025-08-07,10,Primaria 2°,TopKids,269,11,258
2025-08-07,10,Primaria 2°,TopKids,170,2,168
2025-08-07,10,Primaria 2°,SuperSchool,76,3,73
2025-08-07,10,Primaria 2°,EduMax,152,5,147
2025-08-07,10,Primaria 3°,EduMax,182,20,162
2025-08-07,10,Primaria 3°,SuperSchool,134,20,114
2025-08-07,10,Primaria 3°,TopKids,110,6,104
2025-08-07,10,Primaria 3°,EduMax,74,2,72
2025-08-07,10,Primaria 3°,SuperSchool,209,6,203
2025-08-07,10,Primaria 3°,SuperSchool,298,3,295
2025-08-07,10,Primaria 3°,SuperSchool,50,19,31
2025-08-07,10,Primaria 3°,SuperSchool,62,19,43
2025-08-07,10,Primaria 3°,SuperSchool,106,19,87
2025-08-07,10,Primaria 4°,EduMax,54,2,52
2025-08-07,10,Primaria 4°,EduMax,152,13,139
2025-08-07,10,Primaria 4°,SuperSchool,224,22,202
2025-08-07,10,Primaria 4°,TopKids,173,21,152
2025-08-07,10,Primaria 4°,TopKids,118,24,94
2025-08-07,10,Primaria 4°,EduMax,210,8,202
2025-08-07,10,Primaria 4°,EduMax,261,16,245
2025-08-07,10,Primaria 5°,SuperSchool,158,10,148
2025-08-07,10,Primaria 5°,TopKids,138,14,124
2025-08-07,10,Primaria 5°,EduMax,265,16,249
2025-08-07,10,Primaria 5°,TopKids,221,9,212
2025-08-07,10,Primaria 5°,EduMax,264,18,246
2025-08-07,10,Primaria 5°,SuperSchool,237,18,219
2025-08-07,10,Primaria 6°,SuperSchool,112,5,107
2025-08-07,10,Primaria 6°,EduMax,257,9,248
2025-08-07,10,Primaria 6°,EduMax,73,18,55
2025-08-07,10,Primaria 6°,SuperSchool,195,7,188
2025-08-07,10,Primaria 6°,EduMax,246,23,223
2025-08-07,10,Primaria 6°,TopKids,267,18,249
2025-08-07,10,Primaria 6°,SuperSchool,200,21,179
2025-08-07,10,Primaria 6°,EduMax,128,17,111
2025-08-07,10,Primaria 6°,SuperSchool,202,21,181
2025-08-07,10,Primaria 6°,SuperSchool,72,11,61
2025-08-07,10,Primaria 6°,SuperSchool,235,14,221
2025-08-07,10,Primaria 6°,SuperSchool,69,19,50
2025-08-07,10,Primaria 6°,SuperSchool,152,24,128
2025-08-07,10,Primaria 6°,SuperSchool,259,23,236
2025-08-07,10,Primaria 6°,EduMax,287,1,286
2025-08-07,10,Primaria 6°,TopKids,281,18,263
2025-08-07,10,Primaria 6°,SuperSchool,210,22,188
2025-08-07,10,Primaria 6°,SuperSchool,68,6,62
2025-08-07,10,Primaria 6°,TopKids,169,5,164
2025-08-07,11,Preescolar,SuperSchool,245,10,235
2025-08-07,11,Preescolar,EduMax,137,21,116
2025-08-07,11,Preescolar,TopKids,140,16,124
2025-08-07,11,Preescolar,EduMax,238,17,221
2025-08-07,11,Preescolar,TopKids,65,3,62
2025-08-07,11,Preescolar,EduMax,65,8,57
2025-08-07,11,Kínder,TopKids,290,21,269
2025-08-07,11,Kínder,EduMax,220,4,216
2025-08-07,11,Kínder,SuperSchool,81,9,72
2025-08-07,11,Kínder,EduMax,265,20,245
2025-08-07,11,Kínder,SuperSchool,115,9,106
2025-08-07,11,Kínder,SuperSchool,110,6,104
2025-08-07,11,Kínder,TopKids,261,6,255
2025-08-07,11,Kínder,TopKids,274,23,251
2025-08-07,11,Kínder,SuperSchool,150,6,144
2025-08-07,11,Kínder,SuperSchool,275,15,260
2025-08-07,11,Kínder,TopKids,286,14,272
2025-08-07,11,Kínder,EduMax,231,7,224
2025-08-07,11,Kínder,EduMax,171,24,147
2025-08-07,11,Kínder,TopKids,272,10,262
2025-08-07,11,Kínder,SuperSchool,191,8,183
2025-08-07,11,Kínder,EduMax,289,24,265
2025-08-07,11,Kínder,SuperSchool,240,22,218
2025-08-07,11,Kínder,TopKids,74,20,54
2025-08-07,11,Primaria 1°,EduMax,195,5,190
2025-08-07,11,Primaria 1°,EduMax,186,3,183
2025-08-07,11,Primaria 1°,EduMax,155,22,133
2025-08-07,11,Primaria 1°,TopKids,207,21,186
2025-08-07,11,Primaria 1°,TopKids,284,11,273
2025-08-07,11,Primaria 1°,TopKids,226,16,210
2025-08-07,11,Primaria 2°,EduMax,136,19,117
2025-08-07,11,Primaria 2°,TopKids,208,11,197
2025-08-07,11,Primaria 2°,SuperSchool,214,15,199
2025-08-07,11,Primaria 2°,SuperSchool,163,11,152
2025-08-07,11,Primaria 2°,EduMax,157,2,155
2025-08-07,11,Primaria 2°,TopKids,293,4,289
2025-08-07,11,Primaria 2°,EduMax,99,6,93
2025-08-07,11,Primaria 2°,TopKids,108,19,89
2025-08-07,11,Primaria 2°,TopKids,205,24,181
2025-08-07,11,Primaria 2°,EduMax,172,8,164
2025-08-07,11,Primaria 2°,SuperSchool,188,5,183
2025-08-07,11,Primaria 3°,TopKids,99,14,85
2025-08-07,11,Primaria 3°,EduMax,251,3,248
2025-08-07,11,Primaria 3°,SuperSchool,276,11,265
2025-08-07,11,Primaria 3°,TopKids,157,12,145
2025-08-07,11,Primaria 3°,TopKids,230,7,223
2025-08-07,11,Primaria 3°,EduMax,233,11,222
2025-08-07,11,Primaria 4°,SuperSchool,70,10,60
2025-08-07,11,Primaria 4°,TopKids,64,19,45
2025-08-07,11,Primaria 4°,EduMax,198,20,178
2025-08-07,11,Primaria 4°,EduMax,200,13,187
2025-08-07,11,Primaria 4°,SuperSchool,53,14,39
2025-08-07,11,Primaria 4°,SuperSchool,170,19,151
2025-08-07,11,Primaria 4°,TopKids,150,21,129
2025-08-07,11,Primaria 4°,EduMax,195,1,194
2025-08-07,11,Primaria 4°,TopKids,290,17,273
2025-08-07,11,Primaria 4°,TopKids,144,2,142
2025-08-07,11,Primaria 4°,EduMax,263,14,249
2025-08-07,11,Primaria 5°,SuperSchool,115,2,113
2025-08-07,11,Primaria 5°,TopKids,200,17,183
2025-08-07,11,Primaria 5°,TopKids,271,14,257
2025-08-07,11,Primaria 5°,EduMax,258,14,244
2025-08-07,11,Primaria 5°,EduMax,164,24,140
2025-08-07,11,Primaria 5°,EduMax,76,18,58
2025-08-07,11,Primaria 5°,SuperSchool,169,24,145
2025-08-07,11,Primaria 6°,EduMax,217,15,202
2025-08-07,11,Primaria 6°,TopKids,252,22,230
2025-08-07,11,Primaria 6°,EduMax,73,1,72
2025-08-07,11,Primaria 6°,EduMax,93,12,81
2025-08-07,11,Primaria 6°,SuperSchool,156,8,148
2025-08-07,11,Primaria 6°,TopKids,200,21,179
2025-08-07,11,Primaria 6°,EduMax,188,22,166
2025-08-07,11,Primaria 6°,EduMax,212,20,192
2025-08-07,11,Primaria 6°,SuperSchool,91,18,73
2025-08-07,11,Primaria 6°,EduMax,259,24,235
2025-08-07,12,Preescolar,EduMax,167,13,154
2025-08-07,12,Preescolar,SuperSchool,249,4,245
2025-08-07,12,Preescolar,TopKids,149,5,144
2025-08-07,12,Preescolar,SuperSchool,98,2,96
2025-08-07,12,Preescolar,EduMax,121,7,114
2025-08-07,12,Preescolar,TopKids,224,5,219
2025-08-07,12,Preescolar,EduMax,56,8,48
2025-08-07,12,Preescolar,TopKids,239,7,232
2025-08-07,12,Preescolar,TopKids,255,21,234
2025-08-07,12,Preescolar,EduMax,279,4,275
2025-08-07,12,Preescolar,EduMax,259,12,247
2025-08-07,12,Preescolar,SuperSchool,56,6,50
2025-08-07,12,Kínder,SuperSchool,116,12,104
2025-08-07,12,Kínder,TopKids,160,10,150
2025-08-07,12,Kínder,EduMax,197,19,178
2025-08-07,12,Kínder,TopKids,153,3,150
2025-08-07,12,Kínder,TopKids,56,23,33
2025-08-07,12,Kínder,SuperSchool,248,14,234
2025-08-07,12,Kínder,EduMax,155,19,136
2025-08-07,12,Kínder,EduMax,58,16,42
2025-08-07,12,Kínder,TopKids,259,9,250
2025-08-07,12,Kínder,SuperSchool,283,20,263
2025-08-07,12,Kínder,EduMax,157,19,138
2025-08-07,12,Kínder,TopKids,168,15,153
2025-08-07,12,Kínder,TopKids,153,10,143
2025-08-07,12,Kínder,TopKids,117,19,98
2025-08-07,12,Kínder,TopKids,77,21,56
2025-08-07,12,Kínder,TopKids,288,14,274
2025-08-07,12,Primaria 1°,EduMax,132,22,110
2025-08-07,12,Primaria 1°,TopKids,150,9,141
2025-08-07,12,Primaria 1°,EduMax,252,16,236
2025-08-07,12,Primaria 1°,EduMax,253,22,231
2025-08-07,12,Primaria 1°,EduMax,156,8,148
2025-08-07,12,Primaria 2°,SuperSchool,172,2,170
2025-08-07,12,Primaria 2°,SuperSchool,160,2,158
2025-08-07,12,Primaria 2°,SuperSchool,274,10,264
2025-08-07,12,Primaria 2°,EduMax,285,23,262
2025-08-07,12,Primaria 2°,SuperSchool,295,1,294
2025-08-07,12,Primaria 2°,TopKids,55,12,43
2025-08-07,12,Primaria 2°,TopKids,153,13,140
2025-08-07,12,Primaria 2°,TopKids,273,1,272
2025-08-07,12,Primaria 2°,TopKids,293,1,292
2025-08-07,12,Primaria 2°,EduMax,89,5,84
2025-08-07,12,Primaria 2°,SuperSchool,175,8,167
2025-08-07,12,Primaria 2°,SuperSchool,91,2,89
2025-08-07,12,Primaria 2°,SuperSchool,169,23,146
2025-08-07,12,Primaria 2°,TopKids,291,7,284
2025-08-07,12,Primaria 2°,TopKids,230,22,208
2025-08-07,12,Primaria 2°,EduMax,74,3,71
2025-08-07,12,Primaria 3°,EduMax,232,14,218
2025-08-07,12,Primaria 3°,EduMax,95,22,73
2025-08-07,12,Primaria 3°,TopKids,225,8,217
2025-08-07,12,Primaria 3°,TopKids,284,3,281
2025-08-07,12,Primaria 3°,SuperSchool,95,6,89
2025-08-07,12,Primaria 3°,EduMax,214,8,206
2025-08-07,12,Primaria 3°,EduMax,145,15,130
2025-08-07,12,Primaria 3°,TopKids,66,1,65
2025-08-07,12,Primaria 3°,TopKids,159,20,139
2025-08-07,12,Primaria 3°,EduMax,257,9,248
2025-08-07,12,Primaria 3°,SuperSchool,237,17,220
2025-08-07,12,Primaria 3°,SuperSchool,254,21,233
2025-08-07,12,Primaria 3°,EduMax,134,5,129
2025-08-07,12,Primaria 3°,EduMax,55,24,31
2025-08-07,12,Primaria 3°,TopKids,170,13,157
2025-08-07,12,Primaria 3°,SuperSchool,69,15,54
2025-08-07,12,Primaria 4°,EduMax,250,17,233
2025-08-07,12,Primaria 4°,SuperSchool,244,11,233
2025-08-07,12,Primaria 4°,EduMax,202,17,185
2025-08-07,12,Primaria 4°,SuperSchool,266,11,255
2025-08-07,12,Primaria 4°,EduMax,167,4,163
2025-08-07,12,Primaria 4°,TopKids,102,14,88
2025-08-07,12,Primaria 4°,TopKids,105,8,97
2025-08-07,12,Primaria 4°,SuperSchool,105,22,83
2025-08-07,12,Primaria 4°,SuperSchool,79,12,67
2025-08-07,12,Primaria 4°,TopKids,126,20,106
2025-08-07,12,Primaria 4°,TopKids,151,11,140
2025-08-07,12,Primaria 4°,TopKids,245,20,225
2025-08-07,12,Primaria 4°,TopKids,71,11,60
2025-08-07,12,Primaria 4°,SuperSchool,107,7,100
2025-08-07,12,Primaria 4°,TopKids,177,23,154
2025-08-07,12,Primaria 4°,TopKids,155,16,139
2025-08-07,12,Primaria 4°,EduMax,281,9,272
2025-08-07,12,Primaria 4°,SuperSchool,147,13,134
2025-08-07,12,Primaria 5°,TopKids,168,4,164
2025-08-07,12,Primaria 5°,SuperSchool,201,12,189
2025-08-07,12,Primaria 5°,SuperSchool,179,13,166
2025-08-07,12,Primaria 5°,TopKids,142,18,124
2025-08-07,12,Primaria 5°,TopKids,192,8,184
2025-08-07,12,Primaria 5°,TopKids,82,20,62
2025-08-07,12,Primaria 5°,EduMax,189,5,184
2025-08-07,12,Primaria 5°,SuperSchool,72,8,64
2025-08-07,12,Primaria 5°,EduMax,140,13,127
2025-08-07,12,Primaria 5°,TopKids,134,13,121
2025-08-07,12,Primaria 5°,TopKids,278,16,262
2025-08-07,12,Primaria 5°,EduMax,156,22,134
2025-08-07,12,Primaria 5°,SuperSchool,190,11,179
2025-08-07,12,Primaria 5°,SuperSchool,164,3,161
2025-08-07,12,Primaria 5°,TopKids,280,7,273
2025-08-07,12,Primaria 5°,EduMax,273,3,270
2025-08-07,12,Primaria 5°,EduMax,158,7,151
2025-08-07,12,Primaria 6°,TopKids,291,22,269
2025-08-07,12,Primaria 6°,EduMax,185,17,168
2025-08-07,12,Primaria 6°,TopKids,82,14,68
2025-08-07,12,Primaria 6°,SuperSchool,91,12,79
2025-08-07,12,Primaria 6°,EduMax,175,16,159
2025-08-07,12,Primaria 6°,TopKids,155,17,138
2025-08-07,12,Primaria 6°,TopKids,270,18,252
2025-08-07,12,Primaria 6°,SuperSchool,257,19,238
2025-08-07,12,Primaria 6°,EduMax,87,21,66
2025-08-07,13,Preescolar,SuperSchool,149,12,137
2025-08-07,13,Preescolar,TopKids,194,15,179
2025-08-07,13,Preescolar,SuperSchool,216,10,206
2025-08-07,13,Preescolar,SuperSchool,152,18,134
2025-08-07,13,Preescolar,TopKids,273,6,267
2025-08-07,13,Preescolar,EduMax,285,11,274
2025-08-07,13,Preescolar,TopKids,275,6,269
2025-08-07,13,Preescolar,EduMax,298,5,293
2025-08-07,13,Preescolar,EduMax,193,8,185
2025-08-07,13,Preescolar,SuperSchool,145,20,125
2025-08-07,13,Preescolar,EduMax,208,11,197
2025-08-07,13,Preescolar,EduMax,233,12,221
2025-08-07,13,Preescolar,SuperSchool,141,6,135
2025-08-07,13,Preescolar,TopKids,197,5,192
2025-08-07,13,Preescolar,TopKids,186,16,170
2025-08-07,13,Preescolar,EduMax,95,22,73
2025-08-07,13,Preescolar,TopKids,69,19,50
2025-08-07,13,Kínder,TopKids,86,18,68
2025-08-07,13,Kínder,EduMax,124,22,102
2025-08-07,13,Kínder,SuperSchool,80,22,58
2025-08-07,13,Kínder,EduMax,291,7,284
2025-08-07,13,Kínder,EduMax,162,22,140
2025-08-07,13,Kínder,EduMax,72,14,58
2025-08-07,13,Kínder,TopKids,167,3,164
2025-08-07,13,Kínder,TopKids,215,20,195
2025-08-07,13,Kínder,EduMax,162,12,150
2025-08-07,13,Kínder,EduMax,66,10,56
2025-08-07,13,Kínder,TopKids,133,18,115
2025-08-07,13,Kínder,SuperSchool,157,17,140
2025-08-07,13,Kínder,TopKids,264,10,254
2025-08-07,13,Kínder,TopKids,151,6,145
2025-08-07,13,Kínder,TopKids,282,15,267
2025-08-07,13,Kínder,EduMax,277,5,272
2025-08-07,13,Kínder,SuperSchool,281,8,273
2025-08-07,13,Kínder,EduMax,253,21,232
2025-08-07,13,Primaria 1°,TopKids,116,18,98
2025-08-07,13,Primaria 1°,SuperSchool,292,19,273
2025-08-07,13,Primaria 1°,TopKids,55,16,39
2025-08-07,13,Primaria 1°,EduMax,229,16,213
2025-08-07,13,Primaria 1°,TopKids,88,17,71
2025-08-07,13,Primaria 1°,SuperSchool,189,13,176
2025-08-07,13,Primaria 1°,EduMax,120,14,106
2025-08-07,13,Primaria 1°,TopKids,178,17,161
2025-08-07,13,Primaria 1°,SuperSchool,86,20,66
2025-08-07,13,Primaria 1°,TopKids,74,7,67
2025-08-07,13,Primaria 1°,TopKids,283,17,266
2025-08-07,13,Primaria 1°,SuperSchool,143,7,136
2025-08-07,13,Primaria 2°,TopKids,171,24,147
2025-08-07,13,Primaria 2°,TopKids,122,12,110
2025-08-07,13,Primaria 2°,TopKids,240,4,236
2025-08-07,13,Primaria 2°,SuperSchool,190,23,167
2025-08-07,13,Primaria 2°,TopKids,283,5,278
2025-08-07,13,Primaria 3°,SuperSchool,189,2,187
2025-08-07,13,Primaria 3°,TopKids,124,13,111
2025-08-07,13,Primaria 3°,TopKids,179,7,172
2025-08-07,13,Primaria 3°,TopKids,106,11,95
2025-08-07,13,Primaria 3°,EduMax,152,4,148
2025-08-07,13,Primaria 3°,TopKids,78,2,76
2025-08-07,13,Primaria 3°,SuperSchool,65,7,58
2025-08-07,13,Primaria 3°,SuperSchool,86,17,69
2025-08-07,13,Primaria 3°,SuperSchool,221,19,202
2025-08-07,13,Primaria 3°,TopKids,151,8,143
2025-08-07,13,Primaria 3°,SuperSchool,278,2,276
2025-08-07,13,Primaria 4°,EduMax,252,24,228
2025-08-07,13,Primaria 4°,EduMax,110,7,103
2025-08-07,13,Primaria 4°,SuperSchool,152,19,133
2025-08-07,13,Primaria 4°,EduMax,156,11,145
2025-08-07,13,Primaria 4°,TopKids,243,19,224
2025-08-07,13,Primaria 4°,EduMax,119,17,102
2025-08-07,13,Primaria 4°,SuperSchool,214,7,207
2025-08-07,13,Primaria 4°,SuperSchool,202,1,201
2025-08-07,13,Primaria 4°,TopKids,242,19,223
2025-08-07,13,Primaria 4°,EduMax,67,10,57
2025-08-07,13,Primaria 4°,TopKids,274,1,273
2025-08-07,13,Primaria 4°,SuperSchool,150,20,130
2025-08-07,13,Primaria 4°,SuperSchool,101,3,98
2025-08-07,13,Primaria 5°,SuperSchool,255,17,238
2025-08-07,13,Primaria 5°,TopKids,159,4,155
2025-08-07,13,Primaria 5°,SuperSchool,203,21,182
2025-08-07,13,Primaria 5°,SuperSchool,135,2,133
2025-08-07,13,Primaria 5°,TopKids,135,5,130
2025-08-07,13,Primaria 5°,EduMax,293,21,272
2025-08-07,13,Primaria 6°,EduMax,278,23,255
2025-08-07,13,Primaria 6°,SuperSchool,203,23,180
2025-08-07,13,Primaria 6°,TopKids,261,1,260
2025-08-07,13,Primaria 6°,EduMax,105,4,101
2025-08-07,13,Primaria 6°,SuperSchool,198,14,184
2025-08-07,13,Primaria 6°,EduMax,65,24,41
2025-08-07,13,Primaria 6°,SuperSchool,269,8,261
2025-08-07,13,Primaria 6°,TopKids,266,19,247
2025-08-07,13,Primaria 6°,SuperSchool,115,15,100
2025-08-07,13,Primaria 6°,EduMax,173,10,163
2025-08-07,13,Primaria 6°,EduMax,199,14,185
2025-08-07,13,Primaria 6°,SuperSchool,140,13,127
2025-08-07,13,Primaria 6°,SuperSchool,182,13,169
2025-08-07,13,Primaria 6°,TopKids,170,14,156
2025-08-07,13,Primaria 6°,TopKids,288,19,269
2025-08-07,13,Primaria 6°,TopKids,162,3,159
2025-08-07,13,Primaria 6°,TopKids,255,12,243
2025-08-07,14,Preescolar,SuperSchool,220,17,203
2025-08-07,14,Preescolar,SuperSchool,134,23,111
2025-08-07,14,Preescolar,TopKids,234,2,232
2025-08-07,14,Preescolar,EduMax,123,11,112
2025-08-07,14,Preescolar,EduMax,149,24,125
2025-08-07,14,Preescolar,TopKids,168,23,145
2025-08-07,14,Preescolar,TopKids,235,13,222
2025-08-07,14,Preescolar,SuperSchool,183,1,182
2025-08-07,14,Preescolar,EduMax,227,22,205
2025-08-07,14,Preescolar,SuperSchool,137,15,122
2025-08-07,14,Preescolar,EduMax,249,19,230
2025-08-07,14,Preescolar,EduMax,247,22,225
2025-08-07,14,Preescolar,TopKids,155,1,154
2025-08-07,14,Preescolar,EduMax,85,12,73
2025-08-07,14,Preescolar,EduMax,60,12,48
2025-08-07,14,Preescolar,EduMax,291,7,284
2025-08-07,14,Kínder,TopKids,85,20,65
2025-08-07,14,Kínder,TopKids,82,13,69
2025-08-07,14,Kínder,EduMax,218,24,194
2025-08-07,14,Kínder,SuperSchool,177,23,154
2025-08-07,14,Kínder,SuperSchool,282,10,272
2025-08-07,14,Kínder,EduMax,279,15,264
2025-08-07,14,Kínder,TopKids,92,6,86
2025-08-07,14,Kínder,TopKids,105,11,94
2025-08-07,14,Kínder,TopKids,158,20,138
2025-08-07,14,Kínder,EduMax,215,15,200
2025-08-07,14,Kínder,SuperSchool,99,18,81
2025-08-07,14,Primaria 1°,TopKids,195,18,177
2025-08-07,14,Primaria 1°,SuperSchool,137,2,135
2025-08-07,14,Primaria 1°,EduMax,92,7,85
2025-08-07,14,Primaria 1°,EduMax,143,10,133
2025-08-07,14,Primaria 1°,SuperSchool,188,1,187
2025-08-07,14,Primaria 1°,EduMax,169,1,168
2025-08-07,14,Primaria 1°,TopKids,179,21,158
2025-08-07,14,Primaria 1°,SuperSchool,264,21,243
2025-08-07,14,Primaria 1°,TopKids,189,22,167
2025-08-07,14,Primaria 1°,EduMax,178,1,177
2025-08-07,14,Primaria 1°,EduMax,85,5,80
2025-08-07,14,Primaria 2°,TopKids,104,13,91
2025-08-07,14,Primaria 2°,SuperSchool,201,22,179
2025-08-07,14,Primaria 2°,EduMax,243,16,227
2025-08-07,14,Primaria 2°,EduMax,287,1,286
2025-08-07,14,Primaria 2°,SuperSchool,124,19,105
2025-08-07,14,Primaria 2°,TopKids,92,5,87
2025-08-07,14,Primaria 2°,SuperSchool,235,22,213
2025-08-07,14,Primaria 2°,TopKids,91,11,80
2025-08-07,14,Primaria 2°,TopKids,293,10,283
2025-08-07,14,Primaria 2°,TopKids,283,14,269
2025-08-07,14,Primaria 2°,TopKids,91,10,81
2025-08-07,14,Primaria 2°,EduMax,164,1,163
2025-08-07,14,Primaria 2°,SuperSchool,171,10,161
2025-08-07,14,Primaria 2°,EduMax,130,24,106
2025-08-07,14,Primaria 2°,TopKids,248,20,228
2025-08-07,14,Primaria 3°,SuperSchool,71,2,69
2025-08-07,14,Primaria 3°,EduMax,98,1,97
2025-08-07,14,Primaria 3°,SuperSchool,133,21,112
2025-08-07,14,Primaria 3°,TopKids,149,8,141
2025-08-07,14,Primaria 3°,SuperSchool,245,9,236
2025-08-07,14,Primaria 3°,SuperSchool,199,18,181
2025-08-07,14,Primaria 3°,EduMax,92,7,85
2025-08-07,14,Primaria 3°,SuperSchool,183,19,164
2025-08-07,14,Primaria 3°,EduMax,288,7,281
2025-08-07,14,Primaria 3°,SuperSchool,65,1,64
2025-08-07,14,Primaria 3°,TopKids,86,7,79
2025-08-07,14,Primaria 3°,TopKids,295,5,290
2025-08-07,14,Primaria 3°,SuperSchool,130,22,108
2025-08-07,14,Primaria 3°,EduMax,121,1,120
2025-08-07,14,Primaria 3°,EduMax,79,15,64
2025-08-07,14,Primaria 4°,EduMax,156,10,146
2025-08-07,14,Primaria 4°,SuperSchool,181,13,168
2025-08-07,14,Primaria 4°,SuperSchool,254,18,236
2025-08-07,14,Primaria 4°,SuperSchool,137,2,135
2025-08-07,14,Primaria 4°,SuperSchool,107,19,88
2025-08-07,14,Primaria 4°,SuperSchool,77,3,74
2025-08-07,14,Primaria 4°,SuperSchool,280,10,270
2025-08-07,14,Primaria 4°,SuperSchool,91,21,70
2025-08-07,14,Primaria 5°,TopKids,64,3,61
2025-08-07,14,Primaria 5°,SuperSchool,118,9,109
2025-08-07,14,Primaria 5°,EduMax,199,9,190
2025-08-07,14,Primaria 5°,TopKids,120,24,96
2025-08-07,14,Primaria 5°,TopKids,285,9,276
2025-08-07,14,Primaria 5°,EduMax,168,2,166
2025-08-07,14,Primaria 5°,TopKids,58,17,41
2025-08-07,14,Primaria 5°,SuperSchool,100,6,94
2025-08-07,14,Primaria 5°,SuperSchool,80,2,78
2025-08-07,14,Primaria 5°,SuperSchool,111,14,97
2025-08-07,14,Primaria 5°,SuperSchool,128,8,120
2025-08-07,14,Primaria 5°,EduMax,85,16,69
2025-08-07,14,Primaria 5°,SuperSchool,77,4,73
2025-08-07,14,Primaria 6°,EduMax,253,16,237
2025-08-07,14,Primaria 6°,TopKids,153,6,147
2025-08-07,14,Primaria 6°,EduMax,150,18,132
2025-08-07,14,Primaria 6°,EduMax,155,7,148
2025-08-07,14,Primaria 6°,EduMax,50,7,43
2025-08-07,14,Primaria 6°,SuperSchool,114,15,99
2025-08-07,14,Primaria 6°,SuperSchool,197,10,187
2025-08-07,14,Primaria 6°,TopKids,154,2,152
2025-08-07,14,Primaria 6°,EduMax,225,1,224
2025-08-07,14,Primaria 6°,EduMax,280,10,270
2025-08-07,14,Primaria 6°,EduMax,133,1,132
2025-08-07,14,Primaria 6°,SuperSchool,50,5,45
2025-08-07,14,Primaria 6°,TopKids,290,23,267
2025-08-07,14,Primaria 6°,SuperSchool,156,17,139
2025-08-07,14,Primaria 6°,SuperSchool,147,13,134
2025-08-07,14,Primaria 6°,EduMax,188,10,178
2025-08-07,14,Primaria 6°,TopKids,110,17,93
2025-08-07,14,Primaria 6°,TopKids,250,10,240
2025-08-07,15,Preescolar,SuperSchool,254,18,236
2025-08-07,15,Preescolar,SuperSchool,247,17,230
2025-08-07,15,Preescolar,TopKids,69,16,53
2025-08-07,15,Preescolar,SuperSchool,179,5,174
2025-08-07,15,Preescolar,SuperSchool,181,4,177
2025-08-07,15,Preescolar,EduMax,171,3,168
2025-08-07,15,Preescolar,SuperSchool,263,23,240
2025-08-07,15,Preescolar,EduMax,83,11,72
2025-08-07,15,Preescolar,EduMax,143,22,121
2025-08-07,15,Preescolar,EduMax,291,2,289
2025-08-07,15,Preescolar,EduMax,243,10,233
2025-08-07,15,Preescolar,SuperSchool,294,8,286
2025-08-07,15,Kínder,SuperSchool,64,21,43
2025-08-07,15,Kínder,EduMax,95,5,90
2025-08-07,15,Kínder,EduMax,196,15,181
2025-08-07,15,Kínder,EduMax,172,11,161
2025-08-07,15,Kínder,SuperSchool,92,20,72
2025-08-07,15,Kínder,SuperSchool,131,18,113
2025-08-07,15,Primaria 1°,EduMax,203,9,194
2025-08-07,15,Primaria 1°,EduMax,164,10,154
2025-08-07,15,Primaria 1°,TopKids,117,6,111
2025-08-07,15,Primaria 1°,EduMax,245,15,230
2025-08-07,15,Primaria 1°,TopKids,194,19,175
2025-08-07,15,Primaria 1°,SuperSchool,228,17,211
2025-08-07,15,Primaria 1°,EduMax,112,11,101
2025-08-07,15,Primaria 1°,EduMax,202,8,194
2025-08-07,15,Primaria 1°,TopKids,177,7,170
2025-08-07,15,Primaria 1°,EduMax,105,22,83
2025-08-07,15,Primaria 1°,SuperSchool,68,10,58
2025-08-07,15,Primaria 1°,SuperSchool,277,23,254
2025-08-07,15,Primaria 1°,TopKids,62,2,60
2025-08-07,15,Primaria 1°,EduMax,193,9,184
2025-08-07,15,Primaria 2°,SuperSchool,212,9,203
2025-08-07,15,Primaria 2°,SuperSchool,80,21,59
2025-08-07,15,Primaria 2°,EduMax,275,8,267
2025-08-07,15,Primaria 2°,TopKids,90,16,74
2025-08-07,15,Primaria 2°,EduMax,279,22,257
2025-08-07,15,Primaria 2°,EduMax,205,5,200
2025-08-07,15,Primaria 2°,SuperSchool,242,9,233
2025-08-07,15,Primaria 2°,EduMax,232,4,228
2025-08-07,15,Primaria 2°,TopKids,175,10,165
2025-08-07,15,Primaria 2°,TopKids,124,14,110
2025-08-07,15,Primaria 2°,EduMax,189,13,176
2025-08-07,15,Primaria 2°,SuperSchool,257,3,254
2025-08-07,15,Primaria 2°,EduMax,124,9,115
2025-08-07,15,Primaria 2°,TopKids,78,18,60
2025-08-07,15,Primaria 2°,TopKids,63,2,61
2025-08-07,15,Primaria 2°,SuperSchool,103,8,95
2025-08-07,15,Primaria 3°,EduMax,177,18,159
2025-08-07,15,Primaria 3°,EduMax,74,19,55
2025-08-07,15,Primaria 3°,TopKids,52,3,49
2025-08-07,15,Primaria 3°,TopKids,135,17,118
2025-08-07,15,Primaria 3°,SuperSchool,191,19,172
2025-08-07,15,Primaria 3°,SuperSchool,239,21,218
2025-08-07,15,Primaria 3°,SuperSchool,273,11,262
2025-08-07,15,Primaria 3°,TopKids,102,15,87
2025-08-07,15,Primaria 3°,EduMax,252,20,232
2025-08-07,15,Primaria 3°,TopKids,221,8,213
2025-08-07,15,Primaria 3°,EduMax,96,12,84
2025-08-07,15,Primaria 3°,TopKids,262,20,242
2025-08-07,15,Primaria 3°,TopKids,254,9,245
2025-08-07,15,Primaria 3°,SuperSchool,126,16,110
2025-08-07,15,Primaria 4°,EduMax,155,13,142
2025-08-07,15,Primaria 4°,TopKids,269,19,250
2025-08-07,15,Primaria 4°,TopKids,162,13,149
2025-08-07,15,Primaria 4°,SuperSchool,235,21,214
2025-08-07,15,Primaria 4°,EduMax,59,22,37
2025-08-07,15,Primaria 4°,SuperSchool,107,9,98
2025-08-07,15,Primaria 4°,SuperSchool,191,16,175
2025-08-07,15,Primaria 4°,TopKids,145,1,144
2025-08-07,15,Primaria 4°,SuperSchool,201,13,188
2025-08-07,15,Primaria 4°,EduMax,96,16,80
2025-08-07,15,Primaria 4°,EduMax,258,11,247
2025-08-07,15,Primaria 4°,TopKids,174,12,162
2025-08-07,15,Primaria 4°,EduMax,257,21,236
2025-08-07,15,Primaria 4°,SuperSchool,112,11,101
2025-08-07,15,Primaria 5°,TopKids,295,1,294
2025-08-07,15,Primaria 5°,EduMax,236,12,224
2025-08-07,15,Primaria 5°,TopKids,131,23,108
2025-08-07,15,Primaria 5°,EduMax,143,1,142
2025-08-07,15,Primaria 5°,SuperSchool,111,15,96
2025-08-07,15,Primaria 6°,TopKids,293,10,283
2025-08-07,15,Primaria 6°,EduMax,113,6,107
2025-08-07,15,Primaria 6°,EduMax,233,22,211
2025-08-07,15,Primaria 6°,TopKids,206,20,186
2025-08-07,15,Primaria 6°,EduMax,137,19,118
2025-08-07,15,Primaria 6°,EduMax,199,20,179
2025-08-07,15,Primaria 6°,SuperSchool,121,14,107
2025-08-07,15,Primaria 6°,SuperSchool,147,23,124
2025-08-07,15,Primaria 6°,SuperSchool,104,8,96
2025-08-07,15,Primaria 6°,EduMax,225,13,212
2025-08-07,15,Primaria 6°,SuperSchool,64,1,63
2025-08-07,16,Preescolar,TopKids,151,22,129
2025-08-07,16,Preescolar,EduMax,85,18,67
2025-08-07,16,Preescolar,TopKids,154,18,136
2025-08-07,16,Preescolar,TopKids,59,17,42
2025-08-07,16,Preescolar,TopKids,160,1,159
2025-08-07,16,Preescolar,TopKids,106,11,95
2025-08-07,16,Preescolar,SuperSchool,182,7,175
2025-08-07,16,Preescolar,TopKids,106,24,82
2025-08-07,16,Preescolar,SuperSchool,64,3,61
2025-08-07,16,Preescolar,TopKids,150,23,127
2025-08-07,16,Kínder,EduMax,69,5,64
2025-08-07,16,Kínder,TopKids,122,9,113
2025-08-07,16,Kínder,TopKids,203,2,201
2025-08-07,16,Kínder,TopKids,72,21,51
2025-08-07,16,Kínder,SuperSchool,62,19,43
2025-08-07,16,Kínder,SuperSchool,87,4,83
2025-08-07,16,Kínder,SuperSchool,195,19,176
2025-08-07,16,Kínder,SuperSchool,190,8,182
2025-08-07,16,Kínder,TopKids,158,15,143
2025-08-07,16,Kínder,TopKids,93,14,79
2025-08-07,16,Kínder,SuperSchool,201,4,197
2025-08-07,16,Kínder,TopKids,177,9,168
2025-08-07,16,Kínder,EduMax,149,20,129
2025-08-07,16,Kínder,EduMax,282,13,269
2025-08-07,16,Kínder,TopKids,189,18,171
2025-08-07,16,Kínder,EduMax,285,16,269
2025-08-07,16,Primaria 1°,TopKids,133,12,121
2025-08-07,16,Primaria 1°,SuperSchool,74,11,63
2025-08-07,16,Primaria 1°,SuperSchool,175,18,157
2025-08-07,16,Primaria 1°,EduMax,138,3,135
2025-08-07,16,Primaria 1°,SuperSchool,63,1,62
2025-08-07,16,Primaria 1°,SuperSchool,74,8,66
2025-08-07,16,Primaria 1°,SuperSchool,182,9,173
2025-08-07,16,Primaria 1°,TopKids,196,23,173
2025-08-07,16,Primaria 1°,SuperSchool,167,18,149
2025-08-07,16,Primaria 2°,EduMax,63,14,49
2025-08-07,16,Primaria 2°,SuperSchool,139,16,123
2025-08-07,16,Primaria 2°,TopKids,139,15,124
2025-08-07,16,Primaria 2°,EduMax,270,24,246
2025-08-07,16,Primaria 2°,TopKids,232,15,217
2025-08-07,16,Primaria 3°,EduMax,179,10,169
2025-08-07,16,Primaria 3°,TopKids,264,17,247
2025-08-07,16,Primaria 3°,TopKids,117,14,103
2025-08-07,16,Primaria 3°,TopKids,166,10,156
2025-08-07,16,Primaria 3°,SuperSchool,114,4,110
2025-08-07,16,Primaria 3°,TopKids,273,1,272
2025-08-07,16,Primaria 3°,SuperSchool,139,17,122
2025-08-07,16,Primaria 4°,TopKids,241,20,221
2025-08-07,16,Primaria 4°,TopKids,62,2,60
2025-08-07,16,Primaria 4°,TopKids,201,13,188
2025-08-07,16,Primaria 4°,TopKids,236,22,214
2025-08-07,16,Primaria 4°,TopKids,59,9,50
2025-08-07,16,Primaria 4°,TopKids,237,9,228
2025-08-07,16,Primaria 4°,SuperSchool,66,12,54
2025-08-07,16,Primaria 4°,EduMax,112,5,107
2025-08-07,16,Primaria 4°,EduMax,270,18,252
2025-08-07,16,Primaria 4°,TopKids,87,7,80
2025-08-07,16,Primaria 4°,SuperSchool,119,8,111
2025-08-07,16,Primaria 5°,SuperSchool,255,12,243
2025-08-07,16,Primaria 5°,TopKids,123,22,101
2025-08-07,16,Primaria 5°,TopKids,80,7,73
2025-08-07,16,Primaria 5°,EduMax,154,10,144
2025-08-07,16,Primaria 5°,EduMax,289,7,282
2025-08-07,16,Primaria 5°,EduMax,86,23,63
2025-08-07,16,Primaria 5°,TopKids,291,11,280
2025-08-07,16,Primaria 5°,TopKids,262,20,242
2025-08-07,16,Primaria 5°,SuperSchool,105,12,93
2025-08-07,16,Primaria 5°,TopKids,186,7,179
2025-08-07,16,Primaria 5°,EduMax,174,23,151
2025-08-07,16,Primaria 5°,TopKids,158,8,150
2025-08-07,16,Primaria 5°,EduMax,201,19,182
2025-08-07,16,Primaria 5°,EduMax,267,1,266
2025-08-07,16,Primaria 5°,EduMax,290,18,272
2025-08-07,16,Primaria 5°,TopKids,259,7,252
2025-08-07,16,Primaria 6°,EduMax,121,6,115
2025-08-07,16,Primaria 6°,EduMax,152,23,129
2025-08-07,16,Primaria 6°,EduMax,283,11,272
2025-08-07,16,Primaria 6°,SuperSchool,158,9,149
2025-08-07,16,Primaria 6°,TopKids,120,9,111
2025-08-07,16,Primaria 6°,SuperSchool,235,3,232
2025-08-08,9,Preescolar,SuperSchool,70,20,50
2025-08-08,9,Preescolar,EduMax,273,3,270
2025-08-08,9,Preescolar,TopKids,169,6,163
2025-08-08,9,Preescolar,EduMax,158,21,137
2025-08-08,9,Preescolar,SuperSchool,81,20,61
2025-08-08,9,Preescolar,TopKids,274,21,253
2025-08-08,9,Preescolar,EduMax,275,15,260
2025-08-08,9,Kínder,TopKids,156,15,141
2025-08-08,9,Kínder,EduMax,293,9,284
2025-08-08,9,Kínder,SuperSchool,261,2,259
2025-08-08,9,Kínder,EduMax,75,18,57
2025-08-08,9,Kínder,SuperSchool,296,19,277
2025-08-08,9,Kínder,SuperSchool,273,21,252
2025-08-08,9,Kínder,TopKids,247,14,233
2025-08-08,9,Kínder,EduMax,137,13,124
2025-08-08,9,Kínder,TopKids,125,19,106
2025-08-08,9,Kínder,TopKids,198,19,179
2025-08-08,9,Kínder,EduMax,222,14,208
2025-08-08,9,Kínder,EduMax,285,4,281
2025-08-08,9,Kínder,EduMax,206,17,189
2025-08-08,9,Kínder,SuperSchool,110,4,106
2025-08-08,9,Kínder,EduMax,202,3,199
2025-08-08,9,Kínder,TopKids,51,17,34
2025-08-08,9,Kínder,EduMax,75,8,67
2025-08-08,9,Kínder,TopKids,76,18,58
2025-08-08,9,Primaria 1°,SuperSchool,238,16,222
2025-08-08,9,Primaria 1°,TopKids,180,23,157
2025-08-08,9,Primaria 1°,SuperSchool,214,19,195
2025-08-08,9,Primaria 1°,TopKids,57,6,51
2025-08-08,9,Primaria 1°,EduMax,132,24,108
2025-08-08,9,Primaria 1°,TopKids,267,7,260
2025-08-08,9,Primaria 1°,EduMax,151,14,137
2025-08-08,9,Primaria 1°,SuperSchool,218,19,199
2025-08-08,9,Primaria 1°,EduMax,54,23,31
2025-08-08,9,Primaria 1°,TopKids,248,19,229
2025-08-08,9,Primaria 2°,EduMax,280,24,256
2025-08-08,9,Primaria 2°,EduMax,298,23,275
2025-08-08,9,Primaria 2°,SuperSchool,89,6,83
2025-08-08,9,Primaria 2°,EduMax,218,4,214
2025-08-08,9,Primaria 2°,TopKids,252,5,247
2025-08-08,9,Primaria 2°,SuperSchool,66,20,46
2025-08-08,9,Primaria 2°,TopKids,268,15,253
2025-08-08,9,Primaria 2°,SuperSchool,128,14,114
2025-08-08,9,Primaria 2°,SuperSchool,188,13,175
2025-08-08,9,Primaria 2°,EduMax,135,24,111
2025-08-08,9,Primaria 2°,SuperSchool,122,10,112
2025-08-08,9,Primaria 2°,SuperSchool,95,24,71
2025-08-08,9,Primaria 2°,EduMax,92,16,76
2025-08-08,9,Primaria 2°,SuperSchool,142,7,135
2025-08-08,9,Primaria 2°,EduMax,122,3,119
2025-08-08,9,Primaria 2°,EduMax,232,14,218
2025-08-08,9,Primaria 2°,EduMax,266,15,251
2025-08-08,9,Primaria 2°,EduMax,73,14,59
2025-08-08,9,Primaria 2°,TopKids,149,18,131
2025-08-08,9,Primaria 3°,TopKids,214,6,208
2025-08-08,9,Primaria 3°,EduMax,140,7,133
2025-08-08,9,Primaria 3°,TopKids,256,1,255
2025-08-08,9,Primaria 3°,SuperSchool,298,1,297
2025-08-08,9,Primaria 3°,TopKids,99,14,85
2025-08-08,9,Primaria 3°,EduMax,188,10,178
2025-08-08,9,Primaria 3°,TopKids,111,17,94
2025-08-08,9,Primaria 3°,TopKids,267,16,251
2025-08-08,9,Primaria 3°,SuperSchool,190,9,181
2025-08-08,9,Primaria 3°,TopKids,252,6,246
2025-08-08,9,Primaria 3°,SuperSchool,167,6,161
2025-08-08,9,Primaria 3°,SuperSchool,263,24,239
2025-08-08,9,Primaria 4°,EduMax,86,15,71
2025-08-08,9,Primaria 4°,TopKids,163,20,143
2025-08-08,9,Primaria 4°,EduMax,177,15,162
2025-08-08,9,Primaria 4°,EduMax,118,4,114
2025-08-08,9,Primaria 4°,EduMax,113,7,106
2025-08-08,9,Primaria 4°,EduMax,97,10,87
2025-08-08,9,Primaria 4°,EduMax,130,21,109
2025-08-08,9,Primaria 4°,SuperSchool,50,1,49
2025-08-08,9,Primaria 4°,TopKids,82,6,76
2025-08-08,9,Primaria 4°,SuperSchool,203,13,190
2025-08-08,9,Primaria 4°,TopKids,269,1,268
2025-08-08,9,Primaria 4°,SuperSchool,176,9,167
2025-08-08,9,Primaria 4°,EduMax,106,17,89
2025-08-08,9,Primaria 4°,SuperSchool,224,24,200
2025-08-08,9,Primaria 4°,SuperSchool,61,5,56
2025-08-08,9,Primaria 4°,EduMax,138,1,137
2025-08-08,9,Primaria 4°,SuperSchool,50,10,40
2025-08-08,9,Primaria 4°,EduMax,180,17,163
2025-08-08,9,Primaria 4°,TopKids,109,11,98
2025-08-08,9,Primaria 5°,EduMax,51,9,42
2025-08-08,9,Primaria 5°,SuperSchool,237,14,223
2025-08-08,9,Primaria 5°,SuperSchool,66,17,49
2025-08-08,9,Primaria 5°,EduMax,180,11,169
2025-08-08,9,Primaria 5°,SuperSchool,99,4,95
2025-08-08,9,Primaria 5°,SuperSchool,227,5,222
2025-08-08,9,Primaria 5°,EduMax,219,15,204
2025-08-08,9,Primaria 5°,SuperSchool,129,11,118
2025-08-08,9,Primaria 5°,TopKids,197,6,191
2025-08-08,9,Primaria 5°,SuperSchool,241,22,219
2025-08-08,9,Primaria 5°,EduMax,275,1,274
2025-08-08,9,Primaria 5°,SuperSchool,263,12,251
2025-08-08,9,Primaria 5°,SuperSchool,175,15,160
2025-08-08,9,Primaria 5°,EduMax,100,22,78
2025-08-08,9,Primaria 5°,EduMax,110,12,98
2025-08-08,9,Primaria 5°,EduMax,208,9,199
2025-08-08,9,Primaria 5°,TopKids,286,3,283
2025-08-08,9,Primaria 6°,SuperSchool,95,21,74
2025-08-08,9,Primaria 6°,EduMax,129,7,122
2025-08-08,9,Primaria 6°,TopKids,101,23,78
2025-08-08,9,Primaria 6°,SuperSchool,208,11,197
2025-08-08,9,Primaria 6°,EduMax,103,23,80
2025-08-08,9,Primaria 6°,TopKids,66,13,53
2025-08-08,9,Primaria 6°,TopKids,207,3,204
2025-08-08,9,Primaria 6°,SuperSchool,279,22,257
2025-08-08,9,Primaria 6°,SuperSchool,92,16,76
2025-08-08,10,Preescolar,TopKids,86,14,72
2025-08-08,10,Preescolar,SuperSchool,84,4,80
2025-08-08,10,Preescolar,SuperSchool,203,4,199
2025-08-08,10,Preescolar,TopKids,171,17,154
2025-08-08,10,Preescolar,SuperSchool,203,22,181
2025-08-08,10,Preescolar,TopKids,107,24,83
2025-08-08,10,Preescolar,SuperSchool,221,4,217
2025-08-08,10,Kínder,SuperSchool,115,17,98
2025-08-08,10,Kínder,EduMax,134,9,125
2025-08-08,10,Kínder,SuperSchool,252,16,236
2025-08-08,10,Kínder,TopKids,51,10,41
2025-08-08,10,Kínder,TopKids,175,10,165
2025-08-08,10,Kínder,SuperSchool,106,17,89
2025-08-08,10,Kínder,TopKids,265,3,262
2025-08-08,10,Kínder,EduMax,293,13,280
2025-08-08,10,Kínder,TopKids,56,9,47
2025-08-08,10,Kínder,TopKids,286,22,264
2025-08-08,10,Kínder,EduMax,131,23,108
2025-08-08,10,Kínder,EduMax,227,18,209
2025-08-08,10,Kínder,TopKids,80,1,79
2025-08-08,10,Kínder,EduMax,129,11,118
2025-08-08,10,Kínder,SuperSchool,177,7,170
2025-08-08,10,Primaria 1°,SuperSchool,225,14,211
2025-08-08,10,Primaria 1°,TopKids,255,21,234
2025-08-08,10,Primaria 1°,TopKids,257,19,238
2025-08-08,10,Primaria 1°,SuperSchool,172,6,166
2025-08-08,10,Primaria 1°,TopKids,98,9,89
2025-08-08,10,Primaria 1°,EduMax,130,12,118
2025-08-08,10,Primaria 1°,TopKids,103,22,81
2025-08-08,10,Primaria 1°,EduMax,246,11,235
2025-08-08,10,Primaria 1°,TopKids,213,3,210
2025-08-08,10,Primaria 1°,EduMax,265,23,242
2025-08-08,10,Primaria 1°,SuperSchool,194,7,187
2025-08-08,10,Primaria 1°,EduMax,245,23,222
2025-08-08,10,Primaria 1°,SuperSchool,253,1,252
2025-08-08,10,Primaria 1°,SuperSchool,260,21,239
2025-08-08,10,Primaria 1°,EduMax,220,20,200
2025-08-08,10,Primaria 1°,TopKids,162,12,150
2025-08-08,10,Primaria 1°,EduMax,113,8,105
2025-08-08,10,Primaria 1°,TopKids,118,4,114
2025-08-08,10,Primaria 1°,EduMax,77,21,56
2025-08-08,10,Primaria 2°,TopKids,230,4,226
2025-08-08,10,Primaria 2°,TopKids,66,12,54
2025-08-08,10,Primaria 2°,TopKids,123,15,108
2025-08-08,10,Primaria 2°,EduMax,233,23,210
2025-08-08,10,Primaria 2°,EduMax,178,3,175
2025-08-08,10,Primaria 2°,SuperSchool,235,12,223
2025-08-08,10,Primaria 2°,SuperSchool,180,3,177
2025-08-08,10,Primaria 2°,SuperSchool,260,1,259
2025-08-08,10,Primaria 3°,SuperSchool,270,4,266
2025-08-08,10,Primaria 3°,SuperSchool,63,18,45
2025-08-08,10,Primaria 3°,TopKids,210,22,188
2025-08-08,10,Primaria 3°,TopKids,264,21,243
2025-08-08,10,Primaria 3°,SuperSchool,200,4,196
2025-08-08,10,Primaria 3°,SuperSchool,278,11,267
2025-08-08,10,Primaria 3°,TopKids,262,9,253
2025-08-08,10,Primaria 3°,EduMax,276,6,270
2025-08-08,10,Primaria 4°,TopKids,282,15,267
2025-08-08,10,Primaria 4°,TopKids,109,3,106
2025-08-08,10,Primaria 4°,SuperSchool,293,22,271
2025-08-08,10,Primaria 4°,TopKids,223,17,206
2025-08-08,10,Primaria 4°,EduMax,127,17,110
2025-08-08,10,Primaria 4°,SuperSchool,172,14,158
2025-08-08,10,Primaria 4°,SuperSchool,126,6,120
2025-08-08,10,Primaria 4°,SuperSchool,189,23,166
2025-08-08,10,Primaria 4°,TopKids,151,7,144
2025-08-08,10,Primaria 4°,SuperSchool,210,5,205
2025-08-08,10,Primaria 4°,EduMax,208,16,192
2025-08-08,10,Primaria 4°,TopKids,266,16,250
2025-08-08,10,Primaria 5°,SuperSchool,254,20,234
2025-08-08,10,Primaria 5°,EduMax,265,10,255
2025-08-08,10,Primaria 5°,SuperSchool,272,13,259
2025-08-08,10,Primaria 5°,TopKids,236,18,218
2025-08-08,10,Primaria 5°,EduMax,226,19,207
2025-08-08,10,Primaria 5°,TopKids,158,13,145
2025-08-08,10,Primaria 5°,SuperSchool,275,1,274
2025-08-08,10,Primaria 5°,SuperSchool,169,3,166
2025-08-08,10,Primaria 5°,SuperSchool,237,7,230
2025-08-08,10,Primaria 5°,TopKids,263,13,250
2025-08-08,10,Primaria 5°,SuperSchool,200,18,182
2025-08-08,10,Primaria 5°,SuperSchool,56,1,55
2025-08-08,10,Primaria 5°,SuperSchool,162,8,154
2025-08-08,10,Primaria 5°,TopKids,229,4,225
2025-08-08,10,Primaria 5°,EduMax,246,1,245
2025-08-08,10,Primaria 5°,SuperSchool,246,6,240
2025-08-08,10,Primaria 5°,EduMax,171,1,170
2025-08-08,10,Primaria 5°,TopKids,103,1,102
2025-08-08,10,Primaria 6°,SuperSchool,222,23,199
2025-08-08,10,Primaria 6°,TopKids,267,23,244
2025-08-08,10,Primaria 6°,EduMax,111,20,91
2025-08-08,10,Primaria 6°,EduMax,61,1,60
2025-08-08,10,Primaria 6°,EduMax,122,3,119
2025-08-08,11,Preescolar,TopKids,267,9,258
2025-08-08,11,Preescolar,EduMax,228,16,212
2025-08-08,11,Preescolar,EduMax,127,3,124
2025-08-08,11,Preescolar,EduMax,274,18,256
2025-08-08,11,Preescolar,SuperSchool,190,2,188
2025-08-08,11,Preescolar,TopKids,161,21,140
2025-08-08,11,Preescolar,TopKids,138,15,123
2025-08-08,11,Preescolar,EduMax,252,1,251
2025-08-08,11,Preescolar,SuperSchool,216,20,196
2025-08-08,11,Preescolar,EduMax,278,9,269
2025-08-08,11,Preescolar,SuperSchool,266,1,265
2025-08-08,11,Preescolar,EduMax,68,14,54
2025-08-08,11,Preescolar,EduMax,282,10,272
2025-08-08,11,Preescolar,SuperSchool,119,17,102
2025-08-08,11,Preescolar,SuperSchool,279,4,275
2025-08-08,11,Preescolar,EduMax,133,3,130
2025-08-08,11,Kínder,TopKids,131,24,107
2025-08-08,11,Kínder,SuperSchool,272,5,267
2025-08-08,11,Kínder,SuperSchool,170,1,169
2025-08-08,11,Kínder,TopKids,222,4,218
2025-08-08,11,Kínder,EduMax,177,24,153
2025-08-08,11,Kínder,EduMax,148,5,143
2025-08-08,11,Kínder,TopKids,82,23,59
2025-08-08,11,Kínder,SuperSchool,61,11,50
2025-08-08,11,Kínder,SuperSchool,215,22,193
2025-08-08,11,Kínder,EduMax,68,20,48
2025-08-08,11,Kínder,EduMax,82,10,72
2025-08-08,11,Primaria 1°,TopKids,141,11,130
2025-08-08,11,Primaria 1°,TopKids,229,1,228
2025-08-08,11,Primaria 1°,TopKids,198,22,176
2025-08-08,11,Primaria 1°,SuperSchool,58,9,49
2025-08-08,11,Primaria 1°,TopKids,66,12,54
2025-08-08,11,Primaria 1°,SuperSchool,94,8,86
2025-08-08,11,Primaria 1°,EduMax,174,1,173
2025-08-08,11,Primaria 1°,SuperSchool,253,6,247
2025-08-08,11,Primaria 1°,SuperSchool,232,5,227
2025-08-08,11,Primaria 1°,TopKids,129,18,111
2025-08-08,11,Primaria 1°,SuperSchool,131,1,130
2025-08-08,11,Primaria 1°,TopKids,231,8,223
2025-08-08,11,Primaria 1°,TopKids,299,5,294
2025-08-08,11,Primaria 1°,TopKids,217,19,198
2025-08-08,11,Primaria 1°,EduMax,227,21,206
2025-08-08,11,Primaria 1°,TopKids,82,15,67
2025-08-08,11,Primaria 1°,EduMax,174,7,167
2025-08-08,11,Primaria 1°,TopKids,129,15,114
2025-08-08,11,Primaria 2°,SuperSchool,184,14,170
2025-08-08,11,Primaria 2°,TopKids,230,16,214
2025-08-08,11,Primaria 2°,SuperSchool,209,6,203
2025-08-08,11,Primaria 2°,EduMax,193,20,173
2025-08-08,11,Primaria 2°,SuperSchool,193,12,181
2025-08-08,11,Primaria 2°,SuperSchool,278,13,265
2025-08-08,11,Primaria 2°,SuperSchool,61,9,52
2025-08-08,11,Primaria 2°,TopKids,276,1,275
2025-08-08,11,Primaria 2°,SuperSchool,263,18,245
2025-08-08,11,Primaria 2°,SuperSchool,282,18,264
2025-08-08,11,Primaria 3°,SuperSchool,88,4,84
2025-08-08,11,Primaria 3°,SuperSchool,66,24,42
2025-08-08,11,Primaria 3°,EduMax,95,3,92
2025-08-08,11,Primaria 3°,SuperSchool,191,3,188
2025-08-08,11,Primaria 3°,TopKids,280,18,262
2025-08-08,11,Primaria 3°,SuperSchool,238,23,215
2025-08-08,11,Primaria 4°,EduMax,187,13,174
2025-08-08,11,Primaria 4°,SuperSchool,147,23,124
2025-08-08,11,Primaria 4°,SuperSchool,110,22,88
2025-08-08,11,Primaria 4°,SuperSchool,264,22,242
2025-08-08,11,Primaria 4°,SuperSchool,250,20,230
2025-08-08,11,Primaria 4°,EduMax,273,24,249
2025-08-08,11,Primaria 4°,EduMax,294,22,272
2025-08-08,11,Primaria 4°,TopKids,126,8,118
2025-08-08,11,Primaria 4°,TopKids,242,17,225
2025-08-08,11,Primaria 4°,SuperSchool,254,9,245
2025-08-08,11,Primaria 4°,TopKids,56,23,33
2025-08-08,11,Primaria 4°,TopKids,118,5,113
2025-08-08,11,Primaria 4°,SuperSchool,79,9,70
2025-08-08,11,Primaria 4°,EduMax,138,19,119
2025-08-08,11,Primaria 4°,SuperSchool,115,10,105
2025-08-08,11,Primaria 5°,TopKids,126,13,113
2025-08-08,11,Primaria 5°,SuperSchool,96,14,82
2025-08-08,11,Primaria 5°,TopKids,259,24,235
2025-08-08,11,Primaria 5°,EduMax,59,1,58
2025-08-08,11,Primaria 5°,SuperSchool,54,13,41
2025-08-08,11,Primaria 5°,SuperSchool,264,8,256
2025-08-08,11,Primaria 5°,TopKids,116,7,109
2025-08-08,11,Primaria 5°,TopKids,64,8,56
2025-08-08,11,Primaria 5°,TopKids,142,7,135
2025-08-08,11,Primaria 6°,TopKids,220,17,203
2025-08-08,11,Primaria 6°,EduMax,89,1,88
2025-08-08,11,Primaria 6°,SuperSchool,123,19,104
2025-08-08,11,Primaria 6°,TopKids,85,11,74
2025-08-08,11,Primaria 6°,TopKids,274,9,265
2025-08-08,11,Primaria 6°,TopKids,164,13,151
2025-08-08,12,Preescolar,SuperSchool,133,13,120
2025-08-08,12,Preescolar,SuperSchool,54,5,49
2025-08-08,12,Preescolar,EduMax,140,23,117
2025-08-08,12,Preescolar,EduMax,153,4,149
2025-08-08,12,Preescolar,TopKids,293,19,274
2025-08-08,12,Preescolar,TopKids,103,4,99
2025-08-08,12,Preescolar,EduMax,260,9,251
2025-08-08,12,Preescolar,SuperSchool,126,14,112
2025-08-08,12,Preescolar,TopKids,109,14,95
2025-08-08,12,Preescolar,EduMax,123,16,107
2025-08-08,12,Preescolar,TopKids,214,23,191
2025-08-08,12,Preescolar,TopKids,119,2,117
2025-08-08,12,Preescolar,SuperSchool,238,13,225
2025-08-08,12,Preescolar,TopKids,99,19,80
2025-08-08,12,Kínder,EduMax,161,2,159
2025-08-08,12,Kínder,EduMax,97,23,74
2025-08-08,12,Kínder,TopKids,258,23,235
2025-08-08,12,Kínder,TopKids,156,8,148
2025-08-08,12,Kínder,EduMax,117,11,106
2025-08-08,12,Primaria 1°,SuperSchool,139,2,137
2025-08-08,12,Primaria 1°,TopKids,119,21,98
2025-08-08,12,Primaria 1°,SuperSchool,139,19,120
2025-08-08,12,Primaria 1°,EduMax,73,16,57
2025-08-08,12,Primaria 1°,SuperSchool,105,24,81
2025-08-08,12,Primaria 1°,TopKids,81,18,63
2025-08-08,12,Primaria 1°,SuperSchool,243,20,223
2025-08-08,12,Primaria 1°,SuperSchool,115,10,105
2025-08-08,12,Primaria 1°,SuperSchool,213,12,201
2025-08-08,12,Primaria 1°,SuperSchool,213,9,204
2025-08-08,12,Primaria 1°,TopKids,269,6,263
2025-08-08,12,Primaria 1°,SuperSchool,219,14,205
2025-08-08,12,Primaria 2°,SuperSchool,238,18,220
2025-08-08,12,Primaria 2°,EduMax,131,20,111
2025-08-08,12,Primaria 2°,TopKids,225,8,217
2025-08-08,12,Primaria 2°,SuperSchool,168,11,157
2025-08-08,12,Primaria 2°,SuperSchool,106,7,99
2025-08-08,12,Primaria 2°,SuperSchool,227,22,205
2025-08-08,12,Primaria 2°,TopKids,292,13,279
2025-08-08,12,Primaria 2°,TopKids,136,22,114
2025-08-08,12,Primaria 2°,SuperSchool,71,1,70
2025-08-08,12,Primaria 2°,SuperSchool,97,5,92
2025-08-08,12,Primaria 3°,TopKids,296,10,286
2025-08-08,12,Primaria 3°,TopKids,150,7,143
2025-08-08,12,Primaria 3°,EduMax,212,13,199
2025-08-08,12,Primaria 3°,SuperSchool,187,2,185
2025-08-08,12,Primaria 3°,EduMax,121,4,117
2025-08-08,12,Primaria 3°,SuperSchool,221,15,206
2025-08-08,12,Primaria 3°,TopKids,223,23,200
2025-08-08,12,Primaria 3°,TopKids,95,22,73
2025-08-08,12,Primaria 3°,SuperSchool,70,1,69
2025-08-08,12,Primaria 3°,TopKids,196,1,195
2025-08-08,12,Primaria 3°,EduMax,52,20,32
2025-08-08,12,Primaria 3°,SuperSchool,276,6,270
2025-08-08,12,Primaria 3°,EduMax,232,12,220
2025-08-08,12,Primaria 3°,TopKids,274,16,258
2025-08-08,12,Primaria 4°,SuperSchool,218,10,208
2025-08-08,12,Primaria 4°,SuperSchool,224,12,212
2025-08-08,12,Primaria 4°,SuperSchool,150,18,132
2025-08-08,12,Primaria 4°,TopKids,148,7,141
2025-08-08,12,Primaria 4°,SuperSchool,164,18,146
2025-08-08,12,Primaria 4°,SuperSchool,266,24,242
2025-08-08,12,Primaria 4°,TopKids,150,2,148
2025-08-08,12,Primaria 4°,SuperSchool,216,11,205
2025-08-08,12,Primaria 4°,TopKids,240,18,222
2025-08-08,12,Primaria 4°,SuperSchool,275,7,268
2025-08-08,12,Primaria 4°,TopKids,155,22,133
2025-08-08,12,Primaria 4°,SuperSchool,276,12,264
2025-08-08,12,Primaria 4°,TopKids,60,12,48
2025-08-08,12,Primaria 4°,SuperSchool,117,16,101
2025-08-08,12,Primaria 4°,EduMax,272,4,268
2025-08-08,12,Primaria 4°,EduMax,215,21,194
2025-08-08,12,Primaria 4°,TopKids,224,1,223
2025-08-08,12,Primaria 4°,TopKids,278,22,256
2025-08-08,12,Primaria 4°,EduMax,113,17,96
2025-08-08,12,Primaria 5°,EduMax,154,3,151
2025-08-08,12,Primaria 5°,EduMax,62,3,59
2025-08-08,12,Primaria 5°,TopKids,179,24,155
2025-08-08,12,Primaria 5°,TopKids,254,19,235
2025-08-08,12,Primaria 5°,EduMax,193,18,175
2025-08-08,12,Primaria 5°,TopKids,94,4,90
2025-08-08,12,Primaria 5°,SuperSchool,271,10,261
2025-08-08,12,Primaria 5°,SuperSchool,184,15,169
2025-08-08,12,Primaria 5°,TopKids,284,5,279
2025-08-08,12,Primaria 5°,EduMax,283,16,267
2025-08-08,12,Primaria 5°,TopKids,126,8,118
2025-08-08,12,Primaria 5°,SuperSchool,284,11,273
2025-08-08,12,Primaria 5°,TopKids,171,16,155
2025-08-08,12,Primaria 5°,EduMax,174,24,150
2025-08-08,12,Primaria 5°,SuperSchool,183,12,171
2025-08-08,12,Primaria 5°,EduMax,163,18,145
2025-08-08,12,Primaria 5°,TopKids,250,7,243
2025-08-08,12,Primaria 5°,EduMax,57,11,46
2025-08-08,12,Primaria 6°,SuperSchool,89,3,86
2025-08-08,12,Primaria 6°,SuperSchool,243,15,228
2025-08-08,12,Primaria 6°,EduMax,270,18,252
2025-08-08,12,Primaria 6°,EduMax,53,20,33
2025-08-08,12,Primaria 6°,EduMax,215,11,204
2025-08-08,12,Primaria 6°,EduMax,66,24,42
2025-08-08,12,Primaria 6°,TopKids,80,13,67
2025-08-08,12,Primaria 6°,EduMax,212,16,196
2025-08-08,12,Primaria 6°,TopKids,156,18,138
2025-08-08,12,Primaria 6°,TopKids,150,16,134
2025-08-08,12,Primaria 6°,EduMax,161,17,144
2025-08-08,13,Preescolar,TopKids,296,3,293
2025-08-08,13,Preescolar,SuperSchool,295,3,292
2025-08-08,13,Preescolar,TopKids,174,6,168
2025-08-08,13,Preescolar,SuperSchool,253,15,238
2025-08-08,13,Preescolar,SuperSchool,101,3,98
2025-08-08,13,Preescolar,EduMax,146,19,127
2025-08-08,13,Preescolar,TopKids,104,23,81
2025-08-08,13,Preescolar,SuperSchool,176,12,164
2025-08-08,13,Preescolar,SuperSchool,292,24,268
2025-08-08,13,Preescolar,SuperSchool,296,23,273
2025-08-08,13,Preescolar,TopKids,257,11,246
2025-08-08,13,Preescolar,EduMax,188,3,185
2025-08-08,13,Preescolar,TopKids,50,7,43
2025-08-08,13,Kínder,SuperSchool,145,9,136
2025-08-08,13,Kínder,SuperSchool,75,23,52
2025-08-08,13,Kínder,SuperSchool,284,20,264
2025-08-08,13,Kínder,EduMax,274,7,267
2025-08-08,13,Kínder,TopKids,209,22,187
2025-08-08,13,Primaria 1°,TopKids,100,17,83
2025-08-08,13,Primaria 1°,TopKids,178,18,160
2025-08-08,13,Primaria 1°,TopKids,294,15,279
2025-08-08,13,Primaria 1°,SuperSchool,261,14,247
2025-08-08,13,Primaria 1°,SuperSchool,264,13,251
2025-08-08,13,Primaria 1°,TopKids,183,1,182
2025-08-08,13,Primaria 1°,TopKids,68,13,55
2025-08-08,13,Primaria 1°,SuperSchool,238,6,232
2025-08-08,13,Primaria 2°,TopKids,289,10,279
2025-08-08,13,Primaria 2°,EduMax,154,9,145
2025-08-08,13,Primaria 2°,SuperSchool,194,17,177
2025-08-08,13,Primaria 2°,SuperSchool,207,12,195
2025-08-08,13,Primaria 2°,EduMax,251,23,228
2025-08-08,13,Primaria 2°,TopKids,206,2,204
2025-08-08,13,Primaria 2°,TopKids,184,15,169
2025-08-08,13,Primaria 2°,TopKids,297,6,291
2025-08-08,13,Primaria 2°,TopKids,151,16,135
2025-08-08,13,Primaria 2°,EduMax,144,7,137
2025-08-08,13,Primaria 2°,EduMax,220,7,213
2025-08-08,13,Primaria 2°,SuperSchool,73,20,53
2025-08-08,13,Primaria 2°,TopKids,117,12,105
2025-08-08,13,Primaria 2°,SuperSchool,104,19,85
2025-08-08,13,Primaria 2°,EduMax,86,19,67
2025-08-08,13,Primaria 2°,SuperSchool,207,3,204
2025-08-08,13,Primaria 2°,TopKids,171,11,160
2025-08-08,13,Primaria 2°,TopKids,174,17,157
2025-08-08,13,Primaria 2°,SuperSchool,122,21,101
2025-08-08,13,Primaria 3°,EduMax,126,15,111
2025-08-08,13,Primaria 3°,EduMax,176,5,171
2025-08-08,13,Primaria 3°,SuperSchool,276,8,268
2025-08-08,13,Primaria 3°,EduMax,62,3,59
2025-08-08,13,Primaria 3°,SuperSchool,231,8,223
2025-08-08,13,Primaria 3°,SuperSchool,144,9,135
2025-08-08,13,Primaria 3°,EduMax,263,21,242
2025-08-08,13,Primaria 3°,TopKids,51,18,33
2025-08-08,13,Primaria 3°,SuperSchool,243,2,241
2025-08-08,13,Primaria 3°,TopKids,129,19,110
2025-08-08,13,Primaria 3°,TopKids,298,18,280
2025-08-08,13,Primaria 3°,SuperSchool,207,18,189
2025-08-08,13,Primaria 3°,EduMax,188,17,171
2025-08-08,13,Primaria 4°,SuperSchool,72,24,48
2025-08-08,13,Primaria 4°,SuperSchool,51,24,27
2025-08-08,13,Primaria 4°,TopKids,204,2,202
2025-08-08,13,Primaria 4°,SuperSchool,127,4,123
2025-08-08,13,Primaria 4°,SuperSchool,190,4,186
2025-08-08,13,Primaria 4°,TopKids,285,22,263
2025-08-08,13,Primaria 4°,TopKids,249,2,247
2025-08-08,13,Primaria 4°,EduMax,80,22,58
2025-08-08,13,Primaria 4°,EduMax,285,21,264
2025-08-08,13,Primaria 4°,EduMax,251,23,228
2025-08-08,13,Primaria 4°,TopKids,209,20,189
2025-08-08,13,Primaria 4°,EduMax,78,9,69
2025-08-08,13,Primaria 4°,TopKids,223,2,221
2025-08-08,13,Primaria 4°,SuperSchool,133,8,125
2025-08-08,13,Primaria 5°,EduMax,188,12,176
2025-08-08,13,Primaria 5°,EduMax,292,10,282
2025-08-08,13,Primaria 5°,SuperSchool,270,21,249
2025-08-08,13,Primaria 5°,EduMax,180,18,162
2025-08-08,13,Primaria 5°,TopKids,279,10,269
2025-08-08,13,Primaria 5°,TopKids,61,7,54
2025-08-08,13,Primaria 5°,SuperSchool,242,18,224
2025-08-08,13,Primaria 5°,EduMax,64,19,45
2025-08-08,13,Primaria 5°,SuperSchool,111,5,106
2025-08-08,13,Primaria 5°,TopKids,144,3,141
2025-08-08,13,Primaria 5°,SuperSchool,249,12,237
2025-08-08,13,Primaria 6°,EduMax,298,19,279
2025-08-08,13,Primaria 6°,SuperSchool,106,12,94
2025-08-08,13,Primaria 6°,TopKids,126,1,125
2025-08-08,13,Primaria 6°,TopKids,119,8,111
2025-08-08,13,Primaria 6°,SuperSchool,266,22,244
2025-08-08,13,Primaria 6°,TopKids,72,4,68
2025-08-08,13,Primaria 6°,EduMax,224,21,203
2025-08-08,13,Primaria 6°,SuperSchool,233,9,224
2025-08-08,13,Primaria 6°,EduMax,236,7,229
2025-08-08,13,Primaria 6°,SuperSchool,65,17,48
2025-08-08,13,Primaria 6°,EduMax,136,2,134
2025-08-08,13,Primaria 6°,TopKids,83,1,82
2025-08-08,13,Primaria 6°,EduMax,115,23,92
2025-08-08,13,Primaria 6°,SuperSchool,263,2,261
2025-08-08,13,Primaria 6°,TopKids,59,15,44
2025-08-08,14,Preescolar,SuperSchool,234,23,211
2025-08-08,14,Preescolar,TopKids,66,9,57
2025-08-08,14,Preescolar,EduMax,85,9,76
2025-08-08,14,Preescolar,TopKids,146,23,123
2025-08-08,14,Preescolar,TopKids,119,10,109
2025-08-08,14,Preescolar,EduMax,199,13,186
2025-08-08,14,Preescolar,EduMax,270,6,264
2025-08-08,14,Preescolar,EduMax,124,24,100
2025-08-08,14,Preescolar,SuperSchool,52,20,32
2025-08-08,14,Preescolar,EduMax,174,1,173
2025-08-08,14,Preescolar,TopKids,267,12,255
2025-08-08,14,Preescolar,EduMax,138,8,130
2025-08-08,14,Preescolar,TopKids,117,7,110
2025-08-08,14,Preescolar,EduMax,164,4,160
2025-08-08,14,Kínder,EduMax,294,18,276
2025-08-08,14,Kínder,EduMax,299,16,283
2025-08-08,14,Kínder,EduMax,220,10,210
2025-08-08,14,Kínder,SuperSchool,159,22,137
2025-08-08,14,Kínder,TopKids,115,7,108
2025-08-08,14,Kínder,SuperSchool,196,16,180
2025-08-08,14,Primaria 1°,SuperSchool,161,18,143
2025-08-08,14,Primaria 1°,TopKids,166,21,145
2025-08-08,14,Primaria 1°,TopKids,88,9,79
2025-08-08,14,Primaria 1°,SuperSchool,240,13,227
2025-08-08,14,Primaria 1°,TopKids,267,4,263
2025-08-08,14,Primaria 1°,TopKids,147,9,138
2025-08-08,14,Primaria 1°,EduMax,279,5,274
2025-08-08,14,Primaria 1°,EduMax,246,20,226
2025-08-08,14,Primaria 1°,EduMax,182,4,178
2025-08-08,14,Primaria 1°,SuperSchool,58,22,36
2025-08-08,14,Primaria 2°,EduMax,257,10,247
2025-08-08,14,Primaria 2°,SuperSchool,283,19,264
2025-08-08,14,Primaria 2°,EduMax,183,17,166
2025-08-08,14,Primaria 2°,SuperSchool,171,6,165
2025-08-08,14,Primaria 2°,TopKids,172,24,148
2025-08-08,14,Primaria 2°,TopKids,112,15,97
2025-08-08,14,Primaria 2°,SuperSchool,236,19,217
2025-08-08,14,Primaria 2°,EduMax,181,8,173
2025-08-08,14,Primaria 2°,TopKids,97,24,73
2025-08-08,14,Primaria 2°,TopKids,229,3,226
2025-08-08,14,Primaria 2°,EduMax,83,4,79
2025-08-08,14,Primaria 2°,EduMax,220,14,206
2025-08-08,14,Primaria 2°,TopKids,230,19,211
2025-08-08,14,Primaria 2°,EduMax,266,17,249
2025-08-08,14,Primaria 2°,SuperSchool,130,15,115
2025-08-08,14,Primaria 3°,TopKids,103,23,80
2025-08-08,14,Primaria 3°,TopKids,196,3,193
2025-08-08,14,Primaria 3°,SuperSchool,236,1,235
2025-08-08,14,Primaria 3°,EduMax,75,8,67
2025-08-08,14,Primaria 3°,TopKids,104,23,81
2025-08-08,14,Primaria 3°,SuperSchool,183,1,182
2025-08-08,14,Primaria 3°,SuperSchool,100,11,89
2025-08-08,14,Primaria 3°,SuperSchool,265,15,250
2025-08-08,14,Primaria 3°,TopKids,241,11,230
2025-08-08,14,Primaria 3°,TopKids,142,21,121
2025-08-08,14,Primaria 3°,EduMax,105,12,93
2025-08-08,14,Primaria 3°,SuperSchool,169,7,162
2025-08-08,14,Primaria 3°,SuperSchool,238,10,228
2025-08-08,14,Primaria 3°,TopKids,109,6,103
2025-08-08,14,Primaria 3°,SuperSchool,99,5,94
2025-08-08,14,Primaria 3°,EduMax,239,17,222
2025-08-08,14,Primaria 3°,EduMax,257,8,249
2025-08-08,14,Primaria 3°,SuperSchool,206,24,182
2025-08-08,14,Primaria 4°,EduMax,172,3,169
2025-08-08,14,Primaria 4°,SuperSchool,67,5,62
2025-08-08,14,Primaria 4°,SuperSchool,251,5,246
2025-08-08,14,Primaria 4°,EduMax,159,17,142
2025-08-08,14,Primaria 4°,SuperSchool,112,2,110
2025-08-08,14,Primaria 4°,TopKids,59,20,39
2025-08-08,14,Primaria 4°,TopKids,105,16,89
2025-08-08,14,Primaria 4°,SuperSchool,206,12,194
2025-08-08,14,Primaria 4°,SuperSchool,97,20,77
2025-08-08,14,Primaria 4°,EduMax,161,19,142
2025-08-08,14,Primaria 4°,EduMax,288,12,276
2025-08-08,14,Primaria 4°,SuperSchool,91,22,69
2025-08-08,14,Primaria 4°,EduMax,56,13,43
2025-08-08,14,Primaria 4°,TopKids,64,1,63
2025-08-08,14,Primaria 4°,EduMax,276,10,266
2025-08-08,14,Primaria 5°,TopKids,128,22,106
2025-08-08,14,Primaria 5°,TopKids,183,20,163
2025-08-08,14,Primaria 5°,TopKids,137,21,116
2025-08-08,14,Primaria 5°,TopKids,170,21,149
2025-08-08,14,Primaria 5°,TopKids,118,4,114
2025-08-08,14,Primaria 5°,EduMax,67,3,64
2025-08-08,14,Primaria 5°,SuperSchool,291,18,273
2025-08-08,14,Primaria 5°,EduMax,190,22,168
2025-08-08,14,Primaria 5°,TopKids,246,3,243
2025-08-08,14,Primaria 5°,SuperSchool,86,5,81
2025-08-08,14,Primaria 5°,TopKids,240,3,237
2025-08-08,14,Primaria 5°,TopKids,173,18,155
2025-08-08,14,Primaria 5°,EduMax,293,4,289
2025-08-08,14,Primaria 5°,SuperSchool,241,16,225
2025-08-08,14,Primaria 5°,SuperSchool,217,7,210
2025-08-08,14,Primaria 6°,SuperSchool,105,12,93
2025-08-08,14,Primaria 6°,TopKids,157,19,138
2025-08-08,14,Primaria 6°,TopKids,123,7,116
2025-08-08,14,Primaria 6°,SuperSchool,97,9,88
2025-08-08,14,Primaria 6°,TopKids,165,22,143
2025-08-08,14,Primaria 6°,EduMax,127,11,116
2025-08-08,14,Primaria 6°,TopKids,78,10,68
2025-08-08,14,Primaria 6°,SuperSchool,122,4,118
2025-08-08,14,Primaria 6°,EduMax,260,24,236
2025-08-08,14,Primaria 6°,TopKids,66,9,57
2025-08-08,14,Primaria 6°,SuperSchool,146,2,144
2025-08-08,14,Primaria 6°,SuperSchool,265,9,256
2025-08-08,14,Primaria 6°,TopKids,193,19,174
2025-08-08,15,Preescolar,EduMax,163,19,144
2025-08-08,15,Preescolar,TopKids,174,12,162
2025-08-08,15,Preescolar,SuperSchool,299,10,289
2025-08-08,15,Preescolar,SuperSchool,189,21,168
2025-08-08,15,Preescolar,EduMax,69,18,51
2025-08-08,15,Preescolar,SuperSchool,86,12,74
2025-08-08,15,Preescolar,EduMax,148,8,140
2025-08-08,15,Preescolar,EduMax,179,18,161
2025-08-08,15,Preescolar,SuperSchool,94,7,87
2025-08-08,15,Preescolar,EduMax,186,22,164
2025-08-08,15,Preescolar,TopKids,54,12,42
2025-08-08,15,Kínder,EduMax,87,19,68
2025-08-08,15,Kínder,TopKids,257,19,238
2025-08-08,15,Kínder,TopKids,136,10,126
2025-08-08,15,Kínder,TopKids,131,13,118
2025-08-08,15,Kínder,EduMax,195,3,192
2025-08-08,15,Primaria 1°,TopKids,180,23,157
2025-08-08,15,Primaria 1°,SuperSchool,268,12,256
2025-08-08,15,Primaria 1°,TopKids,140,20,120
2025-08-08,15,Primaria 1°,TopKids,266,24,242
2025-08-08,15,Primaria 1°,SuperSchool,159,5,154
2025-08-08,15,Primaria 1°,EduMax,166,19,147
2025-08-08,15,Primaria 1°,SuperSchool,129,24,105
2025-08-08,15,Primaria 1°,SuperSchool,149,8,141
2025-08-08,15,Primaria 1°,TopKids,288,6,282
2025-08-08,15,Primaria 1°,SuperSchool,191,21,170
2025-08-08,15,Primaria 1°,SuperSchool,219,18,201
2025-08-08,15,Primaria 1°,SuperSchool,53,8,45
2025-08-08,15,Primaria 1°,TopKids,66,18,48
2025-08-08,15,Primaria 1°,SuperSchool,106,11,95
2025-08-08,15,Primaria 2°,SuperSchool,268,16,252
2025-08-08,15,Primaria 2°,TopKids,267,21,246
2025-08-08,15,Primaria 2°,SuperSchool,80,16,64
2025-08-08,15,Primaria 2°,TopKids,183,12,171
2025-08-08,15,Primaria 2°,TopKids,211,12,199
2025-08-08,15,Primaria 2°,SuperSchool,191,16,175
2025-08-08,15,Primaria 2°,TopKids,165,9,156
2025-08-08,15,Primaria 2°,EduMax,130,12,118
2025-08-08,15,Primaria 2°,EduMax,196,11,185
2025-08-08,15,Primaria 2°,SuperSchool,230,6,224
2025-08-08,15,Primaria 2°,TopKids,138,24,114
2025-08-08,15,Primaria 2°,SuperSchool,193,20,173
2025-08-08,15,Primaria 2°,EduMax,214,21,193
2025-08-08,15,Primaria 2°,EduMax,141,6,135
2025-08-08,15,Primaria 2°,SuperSchool,141,17,124
2025-08-08,15,Primaria 2°,EduMax,120,22,98
2025-08-08,15,Primaria 3°,SuperSchool,270,20,250
2025-08-08,15,Primaria 3°,TopKids,79,15,64
2025-08-08,15,Primaria 3°,EduMax,148,18,130
2025-08-08,15,Primaria 3°,EduMax,147,10,137
2025-08-08,15,Primaria 3°,TopKids,76,24,52
2025-08-08,15,Primaria 3°,TopKids,216,8,208
2025-08-08,15,Primaria 3°,TopKids,67,13,54
2025-08-08,15,Primaria 4°,TopKids,136,12,124
2025-08-08,15,Primaria 4°,SuperSchool,271,22,249
2025-08-08,15,Primaria 4°,SuperSchool,74,12,62
2025-08-08,15,Primaria 4°,TopKids,287,7,280
2025-08-08,15,Primaria 4°,SuperSchool,183,24,159
2025-08-08,15,Primaria 4°,TopKids,132,4,128
2025-08-08,15,Primaria 4°,TopKids,58,16,42
2025-08-08,15,Primaria 4°,TopKids,213,6,207
2025-08-08,15,Primaria 4°,TopKids,270,24,246
2025-08-08,15,Primaria 4°,TopKids,118,21,97
2025-08-08,15,Primaria 4°,EduMax,219,23,196
2025-08-08,15,Primaria 4°,SuperSchool,174,14,160
2025-08-08,15,Primaria 4°,TopKids,206,20,186
2025-08-08,15,Primaria 4°,EduMax,184,5,179
2025-08-08,15,Primaria 4°,SuperSchool,67,23,44
2025-08-08,15,Primaria 4°,EduMax,236,1,235
2025-08-08,15,Primaria 4°,TopKids,93,15,78
2025-08-08,15,Primaria 5°,TopKids,268,20,248
2025-08-08,15,Primaria 5°,TopKids,57,11,46
2025-08-08,15,Primaria 5°,SuperSchool,180,5,175
2025-08-08,15,Primaria 5°,EduMax,145,15,130
2025-08-08,15,Primaria 5°,EduMax,172,4,168
2025-08-08,15,Primaria 5°,TopKids,172,5,167
2025-08-08,15,Primaria 5°,SuperSchool,209,16,193
2025-08-08,15,Primaria 6°,SuperSchool,231,11,220
2025-08-08,15,Primaria 6°,SuperSchool,57,8,49
2025-08-08,15,Primaria 6°,EduMax,286,3,283
2025-08-08,15,Primaria 6°,TopKids,268,20,248
2025-08-08,15,Primaria 6°,TopKids,256,21,235
2025-08-08,16,Preescolar,SuperSchool,141,10,131
2025-08-08,16,Preescolar,SuperSchool,93,14,79
2025-08-08,16,Preescolar,SuperSchool,223,14,209
2025-08-08,16,Preescolar,EduMax,242,16,226
2025-08-08,16,Preescolar,EduMax,184,15,169
2025-08-08,16,Preescolar,SuperSchool,176,19,157
2025-08-08,16,Preescolar,TopKids,190,9,181
2025-08-08,16,Preescolar,TopKids,234,3,231
2025-08-08,16,Preescolar,SuperSchool,193,8,185
2025-08-08,16,Preescolar,SuperSchool,264,13,251
2025-08-08,16,Preescolar,TopKids,89,17,72
2025-08-08,16,Preescolar,EduMax,296,14,282
2025-08-08,16,Preescolar,TopKids,294,21,273
2025-08-08,16,Preescolar,TopKids,176,15,161
2025-08-08,16,Preescolar,TopKids,183,23,160
2025-08-08,16,Preescolar,SuperSchool,93,18,75
2025-08-08,16,Preescolar,SuperSchool,241,8,233
2025-08-08,16,Kínder,SuperSchool,271,22,249
2025-08-08,16,Kínder,SuperSchool,299,21,278
2025-08-08,16,Kínder,TopKids,96,22,74
2025-08-08,16,Kínder,SuperSchool,126,9,117
2025-08-08,16,Kínder,TopKids,213,13,200
2025-08-08,16,Kínder,TopKids,221,5,216
2025-08-08,16,Kínder,TopKids,249,5,244
2025-08-08,16,Kínder,SuperSchool,255,12,243
2025-08-08,16,Kínder,SuperSchool,281,17,264
2025-08-08,16,Kínder,SuperSchool,270,1,269
2025-08-08,16,Kínder,EduMax,117,24,93
2025-08-08,16,Kínder,SuperSchool,210,7,203
2025-08-08,16,Kínder,SuperSchool,282,3,279
2025-08-08,16,Kínder,TopKids,128,22,106
2025-08-08,16,Kínder,EduMax,295,6,289
2025-08-08,16,Primaria 1°,SuperSchool,166,22,144
2025-08-08,16,Primaria 1°,SuperSchool,130,21,109
2025-08-08,16,Primaria 1°,TopKids,227,11,216
2025-08-08,16,Primaria 1°,TopKids,219,7,212
2025-08-08,16,Primaria 1°,SuperSchool,285,16,269
2025-08-08,16,Primaria 1°,SuperSchool,106,21,85
2025-08-08,16,Primaria 1°,EduMax,148,20,128
2025-08-08,16,Primaria 1°,TopKids,118,13,105
2025-08-08,16,Primaria 1°,TopKids,125,23,102
2025-08-08,16,Primaria 1°,SuperSchool,86,6,80
2025-08-08,16,Primaria 1°,TopKids,75,10,65
2025-08-08,16,Primaria 1°,SuperSchool,268,4,264
2025-08-08,16,Primaria 1°,SuperSchool,208,21,187
2025-08-08,16,Primaria 1°,SuperSchool,280,15,265
2025-08-08,16,Primaria 1°,SuperSchool,212,17,195
2025-08-08,16,Primaria 1°,TopKids,218,5,213
2025-08-08,16,Primaria 1°,SuperSchool,91,15,76
2025-08-08,16,Primaria 2°,SuperSchool,191,4,187
2025-08-08,16,Primaria 2°,SuperSchool,133,2,131
2025-08-08,16,Primaria 2°,SuperSchool,201,20,181
2025-08-08,16,Primaria 2°,SuperSchool,279,24,255
2025-08-08,16,Primaria 2°,TopKids,281,7,274
2025-08-08,16,Primaria 2°,EduMax,257,20,237
2025-08-08,16,Primaria 2°,TopKids,223,23,200
2025-08-08,16,Primaria 2°,SuperSchool,221,16,205
2025-08-08,16,Primaria 2°,TopKids,142,13,129
2025-08-08,16,Primaria 2°,TopKids,175,17,158
2025-08-08,16,Primaria 2°,SuperSchool,64,14,50
2025-08-08,16,Primaria 2°,EduMax,285,16,269
2025-08-08,16,Primaria 2°,TopKids,283,4,279
2025-08-08,16,Primaria 2°,TopKids,264,9,255
2025-08-08,16,Primaria 2°,SuperSchool,101,9,92
2025-08-08,16,Primaria 2°,SuperSchool,106,24,82
2025-08-08,16,Primaria 3°,TopKids,92,7,85
2025-08-08,16,Primaria 3°,SuperSchool,219,4,215
2025-08-08,16,Primaria 3°,SuperSchool,182,11,171
2025-08-08,16,Primaria 3°,TopKids,282,16,266
2025-08-08,16,Primaria 3°,SuperSchool,295,4,291
2025-08-08,16,Primaria 3°,TopKids,51,14,37
2025-08-08,16,Primaria 3°,TopKids,291,21,270
2025-08-08,16,Primaria 3°,EduMax,92,21,71
2025-08-08,16,Primaria 4°,SuperSchool,186,20,166
2025-08-08,16,Primaria 4°,EduMax,131,19,112
2025-08-08,16,Primaria 4°,TopKids,122,4,118
2025-08-08,16,Primaria 4°,TopKids,98,17,81
2025-08-08,16,Primaria 4°,TopKids,104,23,81
2025-08-08,16,Primaria 4°,EduMax,154,9,145
2025-08-08,16,Primaria 5°,TopKids,224,3,221
2025-08-08,16,Primaria 5°,TopKids,205,3,202
2025-08-08,16,Primaria 5°,EduMax,53,24,29
2025-08-08,16,Primaria 5°,TopKids,94,13,81
2025-08-08,16,Primaria 5°,TopKids,124,5,119
2025-08-08,16,Primaria 5°,SuperSchool,58,17,41
2025-08-08,16,Primaria 5°,EduMax,114,3,111
2025-08-08,16,Primaria 5°,TopKids,75,21,54
2025-08-08,16,Primaria 5°,TopKids,75,23,52
2025-08-08,16,Primaria 6°,EduMax,121,12,109
2025-08-08,16,Primaria 6°,SuperSchool,113,22,91
2025-08-08,16,Primaria 6°,TopKids,172,9,163
2025-08-08,16,Primaria 6°,SuperSchool,123,20,103
2025-08-08,16,Primaria 6°,SuperSchool,96,23,73
2025-08-08,16,Primaria 6°,SuperSchool,230,1,229
2025-08-08,16,Primaria 6°,EduMax,107,19,88
2025-08-08,16,Primaria 6°,EduMax,255,8,247
2025-08-08,16,Primaria 6°,EduMax,189,15,174
2025-08-08,16,Primaria 6°,EduMax,294,1,293
2025-08-08,16,Primaria 6°,TopKids,269,3,266
2025-08-08,16,Primaria 6°,TopKids,195,20,175
2025-08-08,16,Primaria 6°,EduMax,145,7,138
2025-08-08,16,Primaria 6°,TopKids,295,15,280
2025-08-08,16,Primaria 6°,EduMax,71,1,70
2025-08-08,16,Primaria 6°,EduMax,177,13,164
2025-08-08,16,Primaria 6°,EduMax,84,11,73
2025-08-08,16,Primaria 6°,TopKids,132,10,122
2025-08-11,9,Preescolar,TopKids,188,15,173
2025-08-11,9,Preescolar,EduMax,73,13,60
2025-08-11,9,Preescolar,SuperSchool,181,13,168
2025-08-11,9,Preescolar,SuperSchool,234,17,217
2025-08-11,9,Preescolar,EduMax,169,5,164
2025-08-11,9,Preescolar,TopKids,50,12,38
2025-08-11,9,Preescolar,SuperSchool,188,12,176
2025-08-11,9,Preescolar,TopKids,235,12,223
2025-08-11,9,Preescolar,EduMax,275,2,273
2025-08-11,9,Preescolar,SuperSchool,181,20,161
2025-08-11,9,Preescolar,TopKids,267,16,251
2025-08-11,9,Preescolar,EduMax,158,2,156
2025-08-11,9,Preescolar,TopKids,260,6,254
2025-08-11,9,Preescolar,TopKids,236,21,215
2025-08-11,9,Preescolar,TopKids,57,14,43
2025-08-11,9,Kínder,TopKids,215,15,200
2025-08-11,9,Kínder,TopKids,72,18,54
2025-08-11,9,Kínder,EduMax,260,10,250
2025-08-11,9,Kínder,TopKids,53,23,30
2025-08-11,9,Kínder,EduMax,116,7,109
2025-08-11,9,Kínder,TopKids,257,10,247
2025-08-11,9,Kínder,TopKids,205,17,188
2025-08-11,9,Kínder,TopKids,278,23,255
2025-08-11,9,Kínder,SuperSchool,126,11,115
2025-08-11,9,Kínder,TopKids,225,15,210
2025-08-11,9,Kínder,SuperSchool,231,18,213
2025-08-11,9,Kínder,TopKids,53,22,31
2025-08-11,9,Kínder,EduMax,168,5,163
2025-08-11,9,Kínder,TopKids,83,1,82
2025-08-11,9,Primaria 1°,EduMax,89,1,88
2025-08-11,9,Primaria 1°,EduMax,205,10,195
2025-08-11,9,Primaria 1°,EduMax,258,3,255
2025-08-11,9,Primaria 1°,TopKids,285,8,277
2025-08-11,9,Primaria 1°,TopKids,258,9,249
2025-08-11,9,Primaria 1°,EduMax,135,6,129
2025-08-11,9,Primaria 1°,SuperSchool,274,22,252
2025-08-11,9,Primaria 1°,SuperSchool,254,15,239
2025-08-11,9,Primaria 1°,EduMax,271,11,260
2025-08-11,9,Primaria 1°,SuperSchool,275,12,263
2025-08-11,9,Primaria 1°,EduMax,299,16,283
2025-08-11,9,Primaria 1°,SuperSchool,276,10,266
2025-08-11,9,Primaria 1°,TopKids,249,7,242
2025-08-11,9,Primaria 1°,SuperSchool,93,5,88
2025-08-11,9,Primaria 1°,SuperSchool,85,17,68
2025-08-11,9,Primaria 1°,SuperSchool,179,12,167
2025-08-11,9,Primaria 2°,EduMax,253,12,241
2025-08-11,9,Primaria 2°,TopKids,170,17,153
2025-08-11,9,Primaria 2°,EduMax,237,11,226
2025-08-11,9,Primaria 2°,SuperSchool,140,8,132
2025-08-11,9,Primaria 2°,EduMax,249,20,229
2025-08-11,9,Primaria 3°,SuperSchool,120,14,106
2025-08-11,9,Primaria 3°,EduMax,170,11,159
2025-08-11,9,Primaria 3°,SuperSchool,262,15,247
2025-08-11,9,Primaria 3°,TopKids,72,14,58
2025-08-11,9,Primaria 3°,EduMax,64,2,62
2025-08-11,9,Primaria 3°,SuperSchool,164,12,152
2025-08-11,9,Primaria 3°,SuperSchool,101,4,97
2025-08-11,9,Primaria 3°,TopKids,118,3,115
2025-08-11,9,Primaria 3°,SuperSchool,224,19,205
2025-08-11,9,Primaria 3°,EduMax,221,5,216
2025-08-11,9,Primaria 3°,EduMax,258,14,244
2025-08-11,9,Primaria 3°,TopKids,103,10,93
2025-08-11,9,Primaria 4°,EduMax,169,22,147
2025-08-11,9,Primaria 4°,TopKids,96,21,75
2025-08-11,9,Primaria 4°,EduMax,141,20,121
2025-08-11,9,Primaria 4°,EduMax,284,22,262
2025-08-11,9,Primaria 4°,SuperSchool,50,5,45
2025-08-11,9,Primaria 4°,SuperSchool,134,14,120
2025-08-11,9,Primaria 4°,SuperSchool,194,15,179
2025-08-11,9,Primaria 5°,TopKids,280,22,258
2025-08-11,9,Primaria 5°,EduMax,61,23,38
2025-08-11,9,Primaria 5°,EduMax,102,16,86
2025-08-11,9,Primaria 5°,EduMax,54,9,45
2025-08-11,9,Primaria 5°,EduMax,281,14,267
2025-08-11,9,Primaria 5°,TopKids,155,20,135
2025-08-11,9,Primaria 5°,EduMax,102,13,89
2025-08-11,9,Primaria 5°,SuperSchool,68,15,53
2025-08-11,9,Primaria 5°,TopKids,166,10,156
2025-08-11,9,Primaria 6°,TopKids,102,3,99
2025-08-11,9,Primaria 6°,EduMax,54,16,38
2025-08-11,9,Primaria 6°,SuperSchool,209,6,203
2025-08-11,9,Primaria 6°,EduMax,273,20,253
2025-08-11,9,Primaria 6°,EduMax,261,15,246
2025-08-11,9,Primaria 6°,EduMax,50,19,31
2025-08-11,9,Primaria 6°,EduMax,157,7,150
2025-08-11,10,Preescolar,EduMax,159,8,151
2025-08-11,10,Preescolar,EduMax,63,5,58
2025-08-11,10,Preescolar,SuperSchool,89,2,87
2025-08-11,10,Preescolar,SuperSchool,248,16,232
2025-08-11,10,Preescolar,TopKids,204,14,190
2025-08-11,10,Preescolar,EduMax,221,1,220
2025-08-11,10,Kínder,SuperSchool,160,4,156
2025-08-11,10,Kínder,TopKids,209,16,193
2025-08-11,10,Kínder,TopKids,216,24,192
2025-08-11,10,Kínder,EduMax,119,16,103
2025-08-11,10,Kínder,TopKids,103,6,97
2025-08-11,10,Primaria 1°,TopKids,81,13,68
2025-08-11,10,Primaria 1°,SuperSchool,247,24,223
2025-08-11,10,Primaria 1°,SuperSchool,102,19,83
2025-08-11,10,Primaria 1°,TopKids,215,18,197
2025-08-11,10,Primaria 1°,TopKids,158,7,151
2025-08-11,10,Primaria 1°,TopKids,126,21,105
2025-08-11,10,Primaria 1°,EduMax,294,17,277
2025-08-11,10,Primaria 1°,SuperSchool,165,13,152
2025-08-11,10,Primaria 1°,EduMax,149,2,147
2025-08-11,10,Primaria 1°,EduMax,54,19,35
2025-08-11,10,Primaria 1°,EduMax,67,21,46
2025-08-11,10,Primaria 1°,EduMax,86,17,69
2025-08-11,10,Primaria 1°,EduMax,62,23,39
2025-08-11,10,Primaria 1°,SuperSchool,58,24,34
2025-08-11,10,Primaria 2°,EduMax,95,8,87
2025-08-11,10,Primaria 2°,TopKids,214,19,195
2025-08-11,10,Primaria 2°,TopKids,269,14,255
2025-08-11,10,Primaria 2°,SuperSchool,143,7,136
2025-08-11,10,Primaria 2°,TopKids,299,8,291
2025-08-11,10,Primaria 2°,EduMax,167,14,153
2025-08-11,10,Primaria 2°,TopKids,63,21,42
2025-08-11,10,Primaria 2°,TopKids,121,3,118
2025-08-11,10,Primaria 2°,SuperSchool,206,23,183
2025-08-11,10,Primaria 2°,EduMax,212,13,199
2025-08-11,10,Primaria 2°,TopKids,163,5,158
2025-08-11,10,Primaria 2°,TopKids,124,11,113
2025-08-11,10,Primaria 2°,TopKids,288,10,278
2025-08-11,10,Primaria 2°,TopKids,144,13,131
2025-08-11,10,Primaria 2°,EduMax,162,13,149
2025-08-11,10,Primaria 2°,EduMax,138,1,137
2025-08-11,10,Primaria 3°,EduMax,128,16,112
2025-08-11,10,Primaria 3°,EduMax,169,6,163
2025-08-11,10,Primaria 3°,EduMax,157,15,142
2025-08-11,10,Primaria 3°,EduMax,211,24,187
2025-08-11,10,Primaria 3°,TopKids,165,9,156
2025-08-11,10,Primaria 4°,SuperSchool,249,14,235
2025-08-11,10,Primaria 4°,SuperSchool,136,21,115
2025-08-11,10,Primaria 4°,TopKids,125,2,123
2025-08-11,10,Primaria 4°,SuperSchool,175,4,171
2025-08-11,10,Primaria 4°,EduMax,164,16,148
2025-08-11,10,Primaria 4°,TopKids,127,8,119
2025-08-11,10,Primaria 4°,SuperSchool,279,18,261
2025-08-11,10,Primaria 4°,EduMax,104,8,96
2025-08-11,10,Primaria 4°,EduMax,183,10,173
2025-08-11,10,Primaria 4°,EduMax,144,17,127
2025-08-11,10,Primaria 4°,SuperSchool,110,12,98
2025-08-11,10,Primaria 4°,SuperSchool,62,19,43
2025-08-11,10,Primaria 4°,SuperSchool,144,5,139
2025-08-11,10,Primaria 4°,SuperSchool,65,6,59
2025-08-11,10,Primaria 4°,TopKids,290,23,267
2025-08-11,10,Primaria 4°,EduMax,183,23,160
2025-08-11,10,Primaria 4°,EduMax,109,11,98
2025-08-11,10,Primaria 4°,SuperSchool,149,7,142
2025-08-11,10,Primaria 4°,EduMax,183,6,177
2025-08-11,10,Primaria 5°,EduMax,229,8,221
2025-08-11,10,Primaria 5°,SuperSchool,57,8,49
2025-08-11,10,Primaria 5°,SuperSchool,83,12,71
2025-08-11,10,Primaria 5°,TopKids,277,3,274
2025-08-11,10,Primaria 5°,EduMax,71,23,48
2025-08-11,10,Primaria 5°,SuperSchool,232,19,213
2025-08-11,10,Primaria 6°,SuperSchool,144,13,131
2025-08-11,10,Primaria 6°,EduMax,133,1,132
2025-08-11,10,Primaria 6°,EduMax,142,23,119
2025-08-11,10,Primaria 6°,EduMax,56,6,50
2025-08-11,10,Primaria 6°,SuperSchool,117,2,115
2025-08-11,10,Primaria 6°,EduMax,135,5,130
2025-08-11,10,Primaria 6°,EduMax,283,23,260
2025-08-11,10,Primaria 6°,EduMax,64,9,55
2025-08-11,10,Primaria 6°,TopKids,299,21,278
2025-08-11,10,Primaria 6°,SuperSchool,138,17,121
2025-08-11,11,Preescolar,SuperSchool,296,16,280
2025-08-11,11,Preescolar,EduMax,199,11,188
2025-08-11,11,Preescolar,TopKids,226,4,222
2025-08-11,11,Preescolar,SuperSchool,64,1,63
2025-08-11,11,Preescolar,EduMax,207,20,187
2025-08-11,11,Preescolar,SuperSchool,282,12,270
2025-08-11,11,Preescolar,EduMax,126,7,119
2025-08-11,11,Preescolar,SuperSchool,156,9,147
2025-08-11,11,Preescolar,SuperSchool,169,16,153
2025-08-11,11,Kínder,TopKids,80,12,68
2025-08-11,11,Kínder,TopKids,127,19,108
2025-08-11,11,Kínder,EduMax,166,17,149
2025-08-11,11,Kínder,TopKids,178,19,159
2025-08-11,11,Kínder,SuperSchool,181,23,158
2025-08-11,11,Kínder,TopKids,125,21,104
2025-08-11,11,Kínder,SuperSchool,158,17,141
2025-08-11,11,Kínder,SuperSchool,229,5,224
2025-08-11,11,Kínder,EduMax,128,12,116
2025-08-11,11,Kínder,SuperSchool,162,15,147
2025-08-11,11,Kínder,EduMax,119,17,102
2025-08-11,11,Kínder,SuperSchool,298,20,278
2025-08-11,11,Kínder,SuperSchool,108,5,103
2025-08-11,11,Kínder,TopKids,210,6,204
2025-08-11,11,Primaria 1°,EduMax,194,19,175
2025-08-11,11,Primaria 1°,SuperSchool,178,13,165
2025-08-11,11,Primaria 1°,EduMax,204,6,198
2025-08-11,11,Primaria 1°,TopKids,55,1,54
2025-08-11,11,Primaria 1°,EduMax,159,3,156
2025-08-11,11,Primaria 1°,TopKids,187,19,168
2025-08-11,11,Primaria 1°,TopKids,100,23,77
2025-08-11,11,Primaria 1°,TopKids,91,2,89
2025-08-11,11,Primaria 1°,EduMax,111,7,104
2025-08-11,11,Primaria 1°,SuperSchool,248,18,230
2025-08-11,11,Primaria 1°,EduMax,203,22,181
2025-08-11,11,Primaria 1°,TopKids,58,20,38
2025-08-11,11,Primaria 2°,SuperSchool,99,16,83
2025-08-11,11,Primaria 2°,EduMax,130,22,108
2025-08-11,11,Primaria 2°,SuperSchool,189,10,179
2025-08-11,11,Primaria 2°,SuperSchool,273,8,265
2025-08-11,11,Primaria 2°,SuperSchool,71,18,53
2025-08-11,11,Primaria 2°,EduMax,225,12,213
2025-08-11,11,Primaria 2°,SuperSchool,244,22,222
2025-08-11,11,Primaria 2°,EduMax,262,4,258
2025-08-11,11,Primaria 2°,EduMax,83,8,75
2025-08-11,11,Primaria 2°,EduMax,97,23,74
2025-08-11,11,Primaria 2°,TopKids,291,22,269
2025-08-11,11,Primaria 2°,EduMax,217,23,194
2025-08-11,11,Primaria 2°,TopKids,130,21,109
2025-08-11,11,Primaria 2°,EduMax,145,6,139
2025-08-11,11,Primaria 3°,EduMax,95,23,72
2025-08-11,11,Primaria 3°,TopKids,88,15,73
2025-08-11,11,Primaria 3°,SuperSchool,265,16,249
2025-08-11,11,Primaria 3°,TopKids,119,2,117
2025-08-11,11,Primaria 3°,EduMax,190,12,178
2025-08-11,11,Primaria 3°,TopKids,58,2,56
2025-08-11,11,Primaria 3°,SuperSchool,268,5,263
2025-08-11,11,Primaria 3°,TopKids,135,19,116
2025-08-11,11,Primaria 3°,TopKids,83,16,67
2025-08-11,11,Primaria 3°,TopKids,256,1,255
2025-08-11,11,Primaria 3°,SuperSchool,190,23,167
2025-08-11,11,Primaria 4°,SuperSchool,163,3,160
2025-08-11,11,Primaria 4°,SuperSchool,96,13,83
2025-08-11,11,Primaria 4°,SuperSchool,170,13,157
2025-08-11,11,Primaria 4°,EduMax,54,19,35
2025-08-11,11,Primaria 4°,SuperSchool,201,18,183
2025-08-11,11,Primaria 4°,SuperSchool,103,10,93
2025-08-11,11,Primaria 4°,TopKids,262,20,242
2025-08-11,11,Primaria 4°,SuperSchool,177,23,154
2025-08-11,11,Primaria 4°,EduMax,245,2,243
2025-08-11,11,Primaria 4°,EduMax,205,3,202
2025-08-11,11,Primaria 5°,EduMax,200,6,194
2025-08-11,11,Primaria 5°,EduMax,201,17,184
2025-08-11,11,Primaria 5°,SuperSchool,114,6,108
2025-08-11,11,Primaria 5°,SuperSchool,170,13,157
2025-08-11,11,Primaria 5°,TopKids,227,12,215
2025-08-11,11,Primaria 5°,TopKids,224,3,221
2025-08-11,11,Primaria 5°,SuperSchool,204,16,188
2025-08-11,11,Primaria 5°,EduMax,93,19,74
2025-08-11,11,Primaria 5°,TopKids,185,23,162
2025-08-11,11,Primaria 5°,TopKids,51,17,34
2025-08-11,11,Primaria 5°,TopKids,222,1,221
2025-08-11,11,Primaria 6°,SuperSchool,60,10,50
2025-08-11,11,Primaria 6°,TopKids,139,24,115
2025-08-11,11,Primaria 6°,TopKids,197,17,180
2025-08-11,11,Primaria 6°,SuperSchool,117,5,112
2025-08-11,11,Primaria 6°,TopKids,223,20,203
2025-08-11,11,Primaria 6°,EduMax,223,1,222
2025-08-11,11,Primaria 6°,TopKids,203,23,180
2025-08-11,11,Primaria 6°,EduMax,97,18,79
2025-08-11,11,Primaria 6°,EduMax,299,10,289
2025-08-11,11,Primaria 6°,SuperSchool,251,18,233
2025-08-11,12,Preescolar,EduMax,180,8,172
2025-08-11,12,Preescolar,TopKids,239,9,230
2025-08-11,12,Preescolar,SuperSchool,174,2,172
2025-08-11,12,Preescolar,EduMax,280,17,263
2025-08-11,12,Preescolar,EduMax,285,2,283
2025-08-11,12,Preescolar,EduMax,69,1,68
2025-08-11,12,Preescolar,SuperSchool,285,11,274
2025-08-11,12,Preescolar,SuperSchool,219,15,204
2025-08-11,12,Preescolar,SuperSchool,266,17,249
2025-08-11,12,Kínder,SuperSchool,211,9,202
2025-08-11,12,Kínder,EduMax,195,14,181
2025-08-11,12,Kínder,TopKids,255,8,247
2025-08-11,12,Kínder,SuperSchool,237,3,234
2025-08-11,12,Kínder,SuperSchool,91,17,74
2025-08-11,12,Kínder,TopKids,156,8,148
2025-08-11,12,Kínder,SuperSchool,158,21,137
2025-08-11,12,Kínder,TopKids,287,5,282
2025-08-11,12,Kínder,EduMax,284,17,267
2025-08-11,12,Kínder,SuperSchool,69,3,66
2025-08-11,12,Kínder,SuperSchool,267,15,252
2025-08-11,12,Kínder,TopKids,225,8,217
2025-08-11,12,Kínder,SuperSchool,225,3,222
2025-08-11,12,Kínder,SuperSchool,122,9,113
2025-08-11,12,Kínder,EduMax,203,17,186
2025-08-11,12,Kínder,EduMax,186,24,162
2025-08-11,12,Primaria 1°,SuperSchool,118,9,109
2025-08-11,12,Primaria 1°,SuperSchool,50,15,35
2025-08-11,12,Primaria 1°,TopKids,229,10,219
2025-08-11,12,Primaria 1°,SuperSchool,175,6,169
2025-08-11,12,Primaria 1°,TopKids,297,12,285
2025-08-11,12,Primaria 1°,EduMax,229,16,213
2025-08-11,12,Primaria 1°,TopKids,223,1,222
2025-08-11,12,Primaria 2°,TopKids,192,7,185
2025-08-11,12,Primaria 2°,EduMax,297,16,281
2025-08-11,12,Primaria 2°,EduMax,180,17,163
2025-08-11,12,Primaria 2°,SuperSchool,159,18,141
2025-08-11,12,Primaria 2°,TopKids,175,22,153
2025-08-11,12,Primaria 2°,TopKids,276,12,264
2025-08-11,12,Primaria 2°,EduMax,118,10,108
2025-08-11,12,Primaria 2°,SuperSchool,210,13,197
2025-08-11,12,Primaria 2°,TopKids,228,11,217
2025-08-11,12,Primaria 2°,EduMax,73,3,70
2025-08-11,12,Primaria 2°,TopKids,119,8,111
2025-08-11,12,Primaria 2°,EduMax,158,12,146
2025-08-11,12,Primaria 2°,EduMax,283,3,280
2025-08-11,12,Primaria 2°,SuperSchool,254,24,230
2025-08-11,12,Primaria 3°,EduMax,284,19,265
2025-08-11,12,Primaria 3°,TopKids,61,11,50
2025-08-11,12,Primaria 3°,EduMax,189,9,180
2025-08-11,12,Primaria 3°,SuperSchool,155,3,152
2025-08-11,12,Primaria 3°,TopKids,133,23,110
2025-08-11,12,Primaria 3°,TopKids,219,24,195
2025-08-11,12,Primaria 3°,TopKids,217,6,211
2025-08-11,12,Primaria 3°,TopKids,145,21,124
2025-08-11,12,Primaria 4°,EduMax,62,22,40
2025-08-11,12,Primaria 4°,TopKids,96,22,74
2025-08-11,12,Primaria 4°,SuperSchool,287,18,269
2025-08-11,12,Primaria 4°,TopKids,237,14,223
2025-08-11,12,Primaria 4°,SuperSchool,70,14,56
2025-08-11,12,Primaria 4°,SuperSchool,140,8,132
2025-08-11,12,Primaria 4°,TopKids,272,15,257
2025-08-11,12,Primaria 4°,SuperSchool,224,19,205
2025-08-11,12,Primaria 4°,EduMax,261,6,255
2025-08-11,12,Primaria 4°,TopKids,76,8,68
2025-08-11,12,Primaria 4°,EduMax,165,23,142
2025-08-11,12,Primaria 4°,SuperSchool,64,3,61
2025-08-11,12,Primaria 4°,EduMax,256,24,232
2025-08-11,12,Primaria 4°,SuperSchool,177,19,158
2025-08-11,12,Primaria 4°,TopKids,225,5,220
2025-08-11,12,Primaria 4°,SuperSchool,113,14,99
2025-08-11,12,Primaria 5°,EduMax,121,5,116
2025-08-11,12,Primaria 5°,TopKids,176,16,160
2025-08-11,12,Primaria 5°,TopKids,127,5,122
2025-08-11,12,Primaria 5°,SuperSchool,181,4,177
2025-08-11,12,Primaria 5°,SuperSchool,160,4,156
2025-08-11,12,Primaria 5°,EduMax,129,4,125
2025-08-11,12,Primaria 6°,SuperSchool,289,16,273
2025-08-11,12,Primaria 6°,EduMax,282,4,278
2025-08-11,12,Primaria 6°,SuperSchool,255,4,251
2025-08-11,12,Primaria 6°,EduMax,277,18,259
2025-08-11,12,Primaria 6°,SuperSchool,190,14,176
2025-08-11,12,Primaria 6°,TopKids,259,1,258
2025-08-11,12,Primaria 6°,SuperSchool,257,15,242
2025-08-11,12,Primaria 6°,EduMax,234,5,229
2025-08-11,12,Primaria 6°,SuperSchool,119,6,113
2025-08-11,12,Primaria 6°,TopKids,97,12,85
2025-08-11,13,Preescolar,SuperSchool,85,1,84
2025-08-11,13,Preescolar,TopKids,198,8,190
2025-08-11,13,Preescolar,SuperSchool,239,2,237
2025-08-11,13,Preescolar,EduMax,66,7,59
2025-08-11,13,Preescolar,TopKids,117,5,112
2025-08-11,13,Preescolar,EduMax,145,11,134
2025-08-11,13,Preescolar,SuperSchool,202,10,192
2025-08-11,13,Preescolar,SuperSchool,284,24,260
2025-08-11,13,Kínder,SuperSchool,57,13,44
2025-08-11,13,Kínder,TopKids,101,18,83
2025-08-11,13,Kínder,TopKids,135,16,119
2025-08-11,13,Kínder,EduMax,54,18,36
2025-08-11,13,Kínder,TopKids,268,22,246
2025-08-11,13,Kínder,SuperSchool,257,6,251
2025-08-11,13,Kínder,TopKids,56,18,38
2025-08-11,13,Kínder,EduMax,215,8,207
2025-08-11,13,Kínder,TopKids,160,15,145
2025-08-11,13,Kínder,SuperSchool,92,5,87
2025-08-11,13,Kínder,SuperSchool,270,21,249
2025-08-11,13,Kínder,EduMax,179,6,173
2025-08-11,13,Kínder,EduMax,220,4,216
2025-08-11,13,Kínder,SuperSchool,236,9,227
2025-08-11,13,Kínder,TopKids,267,16,251
2025-08-11,13,Kínder,TopKids,268,4,264
2025-08-11,13,Kínder,SuperSchool,106,21,85
2025-08-11,13,Kínder,EduMax,193,19,174
2025-08-11,13,Kínder,TopKids,267,8,259
2025-08-11,13,Primaria 1°,TopKids,50,21,29
2025-08-11,13,Primaria 1°,EduMax,122,12,110
2025-08-11,13,Primaria 1°,EduMax,57,17,40
2025-08-11,13,Primaria 1°,EduMax,204,7,197
2025-08-11,13,Primaria 1°,TopKids,74,6,68
2025-08-11,13,Primaria 1°,SuperSchool,201,24,177
2025-08-11,13,Primaria 1°,TopKids,227,15,212
2025-08-11,13,Primaria 1°,EduMax,191,21,170
2025-08-11,13,Primaria 1°,EduMax,145,16,129
2025-08-11,13,Primaria 1°,TopKids,217,10,207
2025-08-11,13,Primaria 1°,TopKids,153,13,140
2025-08-11,13,Primaria 1°,TopKids,75,12,63
2025-08-11,13,Primaria 1°,TopKids,228,14,214
2025-08-11,13,Primaria 1°,TopKids,259,13,246
2025-08-11,13,Primaria 1°,TopKids,98,19,79
2025-08-11,13,Primaria 1°,TopKids,186,23,163
2025-08-11,13,Primaria 1°,TopKids,114,7,107
2025-08-11,13,Primaria 1°,EduMax,120,20,100
2025-08-11,13,Primaria 1°,TopKids,249,16,233
2025-08-11,13,Primaria 2°,SuperSchool,187,18,169
2025-08-11,13,Primaria 2°,TopKids,262,21,241
2025-08-11,13,Primaria 2°,EduMax,150,23,127
2025-08-11,13,Primaria 2°,SuperSchool,140,24,116
2025-08-11,13,Primaria 2°,EduMax,152,22,130
2025-08-11,13,Primaria 2°,SuperSchool,53,24,29
2025-08-11,13,Primaria 2°,TopKids,225,19,206
2025-08-11,13,Primaria 3°,TopKids,140,3,137
2025-08-11,13,Primaria 3°,TopKids,130,10,120
2025-08-11,13,Primaria 3°,SuperSchool,263,17,246
2025-08-11,13,Primaria 3°,SuperSchool,149,21,128
2025-08-11,13,Primaria 3°,TopKids,279,12,267
2025-08-11,13,Primaria 3°,SuperSchool,103,20,83
2025-08-11,13,Primaria 3°,SuperSchool,98,10,88
2025-08-11,13,Primaria 3°,TopKids,78,16,62
2025-08-11,13,Primaria 3°,SuperSchool,62,3,59
2025-08-11,13,Primaria 3°,EduMax,65,6,59
2025-08-11,13,Primaria 3°,EduMax,94,7,87
2025-08-11,13,Primaria 3°,SuperSchool,105,7,98
2025-08-11,13,Primaria 3°,EduMax,176,17,159
2025-08-11,13,Primaria 3°,SuperSchool,207,21,186
2025-08-11,13,Primaria 4°,TopKids,262,16,246
2025-08-11,13,Primaria 4°,EduMax,69,2,67
2025-08-11,13,Primaria 4°,SuperSchool,259,7,252
2025-08-11,13,Primaria 4°,TopKids,106,11,95
2025-08-11,13,Primaria 4°,EduMax,258,16,242
2025-08-11,13,Primaria 4°,SuperSchool,135,5,130
2025-08-11,13,Primaria 4°,EduMax,231,16,215
2025-08-11,13,Primaria 4°,EduMax,55,2,53
2025-08-11,13,Primaria 4°,TopKids,127,16,111
2025-08-11,13,Primaria 4°,TopKids,175,20,155
2025-08-11,13,Primaria 4°,SuperSchool,96,12,84
2025-08-11,13,Primaria 4°,SuperSchool,209,18,191
2025-08-11,13,Primaria 4°,SuperSchool,63,20,43
2025-08-11,13,Primaria 4°,SuperSchool,85,8,77
2025-08-11,13,Primaria 4°,EduMax,199,16,183
2025-08-11,13,Primaria 4°,TopKids,169,10,159
2025-08-11,13,Primaria 5°,TopKids,70,17,53
2025-08-11,13,Primaria 5°,SuperSchool,80,18,62
2025-08-11,13,Primaria 5°,EduMax,267,21,246
2025-08-11,13,Primaria 5°,SuperSchool,181,4,177
2025-08-11,13,Primaria 5°,EduMax,181,17,164
2025-08-11,13,Primaria 5°,SuperSchool,79,19,60
2025-08-11,13,Primaria 5°,SuperSchool,53,5,48
2025-08-11,13,Primaria 5°,SuperSchool,286,23,263
2025-08-11,13,Primaria 5°,EduMax,278,8,270
2025-08-11,13,Primaria 5°,EduMax,274,23,251
2025-08-11,13,Primaria 5°,EduMax,156,16,140
2025-08-11,13,Primaria 5°,SuperSchool,257,7,250
2025-08-11,13,Primaria 5°,TopKids,114,9,105
2025-08-11,13,Primaria 6°,SuperSchool,171,15,156
2025-08-11,13,Primaria 6°,TopKids,201,10,191
2025-08-11,13,Primaria 6°,SuperSchool,254,16,238
2025-08-11,13,Primaria 6°,TopKids,231,23,208
2025-08-11,13,Primaria 6°,TopKids,258,14,244
2025-08-11,13,Primaria 6°,TopKids,293,16,277
2025-08-11,14,Preescolar,TopKids,69,24,45
2025-08-11,14,Preescolar,TopKids,118,13,105
2025-08-11,14,Preescolar,EduMax,269,5,264
2025-08-11,14,Preescolar,SuperSchool,88,6,82
2025-08-11,14,Preescolar,EduMax,156,7,149
2025-08-11,14,Preescolar,EduMax,198,8,190
2025-08-11,14,Preescolar,SuperSchool,131,22,109
2025-08-11,14,Preescolar,EduMax,61,17,44
2025-08-11,14,Preescolar,SuperSchool,159,6,153
2025-08-11,14,Kínder,TopKids,127,18,109
2025-08-11,14,Kínder,SuperSchool,151,3,148
2025-08-11,14,Kínder,SuperSchool,93,11,82
2025-08-11,14,Kínder,SuperSchool,97,18,79
2025-08-11,14,Kínder,TopKids,258,17,241
2025-08-11,14,Kínder,SuperSchool,252,20,232
2025-08-11,14,Kínder,EduMax,78,16,62
2025-08-11,14,Kínder,EduMax,258,22,236
2025-08-11,14,Kínder,EduMax,165,10,155
2025-08-11,14,Kínder,SuperSchool,221,15,206
2025-08-11,14,Kínder,TopKids,241,22,219
2025-08-11,14,Kínder,SuperSchool,267,13,254
2025-08-11,14,Kínder,EduMax,150,2,148
2025-08-11,14,Kínder,TopKids,107,20,87
2025-08-11,14,Kínder,SuperSchool,206,3,203
2025-08-11,14,Kínder,TopKids,225,1,224
2025-08-11,14,Kínder,TopKids,124,9,115
2025-08-11,14,Kínder,EduMax,58,7,51
2025-08-11,14,Kínder,TopKids,270,19,251
2025-08-11,14,Primaria 1°,TopKids,168,12,156
2025-08-11,14,Primaria 1°,EduMax,259,5,254
2025-08-11,14,Primaria 1°,TopKids,168,22,146
2025-08-11,14,Primaria 1°,EduMax,155,12,143
2025-08-11,14,Primaria 1°,TopKids,96,1,95
2025-08-11,14,Primaria 1°,TopKids,268,18,250
2025-08-11,14,Primaria 1°,EduMax,79,2,77
2025-08-11,14,Primaria 1°,SuperSchool,142,1,141
2025-08-11,14,Primaria 2°,EduMax,155,5,150
2025-08-11,14,Primaria 2°,EduMax,134,15,119
2025-08-11,14,Primaria 2°,SuperSchool,208,12,196
2025-08-11,14,Primaria 2°,SuperSchool,143,12,131
2025-08-11,14,Primaria 2°,EduMax,82,4,78
2025-08-11,14,Primaria 2°,SuperSchool,236,15,221
2025-08-11,14,Primaria 2°,EduMax,178,11,167
2025-08-11,14,Primaria 2°,TopKids,51,1,50
2025-08-11,14,Primaria 2°,TopKids,221,16,205
2025-08-11,14,Primaria 2°,EduMax,199,10,189
2025-08-11,14,Primaria 2°,EduMax,224,17,207
2025-08-11,14,Primaria 2°,EduMax,59,3,56
2025-08-11,14,Primaria 2°,EduMax,111,21,90
2025-08-11,14,Primaria 2°,EduMax,116,9,107
2025-08-11,14,Primaria 3°,SuperSchool,254,18,236
2025-08-11,14,Primaria 3°,EduMax,295,24,271
2025-08-11,14,Primaria 3°,TopKids,295,4,291
2025-08-11,14,Primaria 3°,EduMax,201,8,193
2025-08-11,14,Primaria 3°,SuperSchool,123,2,121
2025-08-11,14,Primaria 3°,EduMax,161,18,143
2025-08-11,14,Primaria 3°,SuperSchool,151,13,138
2025-08-11,14,Primaria 3°,TopKids,159,21,138
2025-08-11,14,Primaria 3°,EduMax,187,24,163
2025-08-11,14,Primaria 3°,TopKids,190,12,178
2025-08-11,14,Primaria 3°,SuperSchool,245,7,238
2025-08-11,14,Primaria 3°,SuperSchool,167,2,165
2025-08-11,14,Primaria 3°,TopKids,110,9,101
2025-08-11,14,Primaria 3°,SuperSchool,128,18,110
2025-08-11,14,Primaria 3°,TopKids,101,7,94
2025-08-11,14,Primaria 4°,SuperSchool,94,24,70
2025-08-11,14,Primaria 4°,SuperSchool,77,23,54
2025-08-11,14,Primaria 4°,TopKids,76,1,75
2025-08-11,14,Primaria 4°,EduMax,130,5,125
2025-08-11,14,Primaria 4°,EduMax,111,6,105
2025-08-11,14,Primaria 4°,EduMax,170,24,146
2025-08-11,14,Primaria 4°,TopKids,173,21,152
2025-08-11,14,Primaria 4°,EduMax,224,19,205
2025-08-11,14,Primaria 4°,SuperSchool,62,5,57
2025-08-11,14,Primaria 4°,TopKids,209,3,206
2025-08-11,14,Primaria 4°,TopKids,191,16,175
2025-08-11,14,Primaria 4°,EduMax,130,4,126
2025-08-11,14,Primaria 4°,SuperSchool,281,19,262
2025-08-11,14,Primaria 4°,SuperSchool,115,15,100
2025-08-11,14,Primaria 5°,TopKids,94,23,71
2025-08-11,14,Primaria 5°,EduMax,116,5,111
2025-08-11,14,Primaria 5°,TopKids,215,13,202
2025-08-11,14,Primaria 5°,EduMax,260,8,252
2025-08-11,14,Primaria 5°,EduMax,212,24,188
2025-08-11,14,Primaria 5°,SuperSchool,89,10,79
2025-08-11,14,Primaria 6°,TopKids,55,2,53
2025-08-11,14,Primaria 6°,SuperSchool,168,24,144
2025-08-11,14,Primaria 6°,TopKids,162,7,155
2025-08-11,14,Primaria 6°,SuperSchool,102,5,97
2025-08-11,14,Primaria 6°,TopKids,146,8,138
2025-08-11,14,Primaria 6°,EduMax,225,10,215
2025-08-11,15,Preescolar,SuperSchool,73,15,58
2025-08-11,15,Preescolar,EduMax,230,7,223
2025-08-11,15,Preescolar,EduMax,244,2,242
2025-08-11,15,Preescolar,EduMax,70,9,61
2025-08-11,15,Preescolar,EduMax,85,3,82
2025-08-11,15,Preescolar,SuperSchool,265,22,243
2025-08-11,15,Preescolar,SuperSchool,255,10,245
2025-08-11,15,Preescolar,SuperSchool,93,1,92
2025-08-11,15,Preescolar,EduMax,142,19,123
2025-08-11,15,Preescolar,TopKids,247,13,234
2025-08-11,15,Preescolar,TopKids,126,22,104
2025-08-11,15,Preescolar,SuperSchool,277,24,253
2025-08-11,15,Preescolar,EduMax,224,12,212
2025-08-11,15,Preescolar,EduMax,76,7,69
2025-08-11,15,Preescolar,EduMax,144,23,121
2025-08-11,15,Preescolar,SuperSchool,130,4,126
2025-08-11,15,Preescolar,SuperSchool,191,20,171
2025-08-11,15,Preescolar,SuperSchool,52,18,34
2025-08-11,15,Preescolar,EduMax,224,3,221
2025-08-11,15,Kínder,EduMax,201,17,184
2025-08-11,15,Kínder,TopKids,63,3,60
2025-08-11,15,Kínder,SuperSchool,224,18,206
2025-08-11,15,Kínder,EduMax,262,3,259
2025-08-11,15,Kínder,TopKids,89,4,85
2025-08-11,15,Primaria 1°,TopKids,284,1,283
2025-08-11,15,Primaria 1°,TopKids,210,7,203
2025-08-11,15,Primaria 1°,SuperSchool,165,20,145
2025-08-11,15,Primaria 1°,TopKids,204,14,190
2025-08-11,15,Primaria 1°,EduMax,257,14,243
2025-08-11,15,Primaria 1°,SuperSchool,287,10,277
2025-08-11,15,Primaria 1°,SuperSchool,287,18,269
2025-08-11,15,Primaria 1°,EduMax,186,17,169
2025-08-11,15,Primaria 2°,EduMax,190,18,172
2025-08-11,15,Primaria 2°,SuperSchool,55,21,34
2025-08-11,15,Primaria 2°,TopKids,85,7,78
2025-08-11,15,Primaria 2°,SuperSchool,188,12,176
2025-08-11,15,Primaria 2°,EduMax,286,10,276
2025-08-11,15,Primaria 2°,EduMax,289,5,284
2025-08-11,15,Primaria 2°,EduMax,246,24,222
2025-08-11,15,Primaria 2°,SuperSchool,75,6,69
2025-08-11,15,Primaria 2°,TopKids,52,12,40
2025-08-11,15,Primaria 2°,EduMax,278,6,272
2025-08-11,15,Primaria 3°,EduMax,129,23,106
2025-08-11,15,Primaria 3°,TopKids,278,9,269
2025-08-11,15,Primaria 3°,TopKids,180,8,172
2025-08-11,15,Primaria 3°,EduMax,117,12,105
2025-08-11,15,Primaria 3°,TopKids,266,21,245
2025-08-11,15,Primaria 3°,TopKids,91,22,69
2025-08-11,15,Primaria 3°,EduMax,176,13,163
2025-08-11,15,Primaria 4°,TopKids,125,5,120
2025-08-11,15,Primaria 4°,EduMax,181,2,179
2025-08-11,15,Primaria 4°,TopKids,171,12,159
2025-08-11,15,Primaria 4°,TopKids,245,6,239
2025-08-11,15,Primaria 4°,TopKids,251,1,250
2025-08-11,15,Primaria 4°,SuperSchool,65,9,56
2025-08-11,15,Primaria 4°,SuperSchool,230,9,221
2025-08-11,15,Primaria 4°,TopKids,168,9,159
2025-08-11,15,Primaria 4°,TopKids,90,15,75
2025-08-11,15,Primaria 4°,EduMax,124,11,113
2025-08-11,15,Primaria 4°,TopKids,273,6,267
2025-08-11,15,Primaria 4°,SuperSchool,197,7,190
2025-08-11,15,Primaria 4°,TopKids,121,18,103
2025-08-11,15,Primaria 5°,TopKids,83,21,62
2025-08-11,15,Primaria 5°,TopKids,169,19,150
2025-08-11,15,Primaria 5°,TopKids,208,18,190
2025-08-11,15,Primaria 5°,EduMax,152,21,131
2025-08-11,15,Primaria 5°,TopKids,149,17,132
2025-08-11,15,Primaria 6°,SuperSchool,107,20,87
2025-08-11,15,Primaria 6°,SuperSchool,170,18,152
2025-08-11,15,Primaria 6°,SuperSchool,213,21,192
2025-08-11,15,Primaria 6°,TopKids,249,1,248
2025-08-11,15,Primaria 6°,SuperSchool,298,9,289
2025-08-11,15,Primaria 6°,SuperSchool,273,2,271
2025-08-11,15,Primaria 6°,SuperSchool,58,20,38
2025-08-11,15,Primaria 6°,EduMax,109,1,108
2025-08-11,15,Primaria 6°,SuperSchool,54,3,51
2025-08-11,16,Preescolar,SuperSchool,127,9,118
2025-08-11,16,Preescolar,EduMax,201,4,197
2025-08-11,16,Preescolar,EduMax,255,4,251
2025-08-11,16,Preescolar,SuperSchool,251,3,248
2025-08-11,16,Preescolar,TopKids,184,10,174
2025-08-11,16,Preescolar,SuperSchool,245,18,227
2025-08-11,16,Preescolar,TopKids,106,4,102
2025-08-11,16,Preescolar,EduMax,259,8,251
2025-08-11,16,Kínder,EduMax,214,23,191
2025-08-11,16,Kínder,TopKids,253,3,250
2025-08-11,16,Kínder,EduMax,53,10,43
2025-08-11,16,Kínder,TopKids,145,10,135
2025-08-11,16,Kínder,SuperSchool,175,22,153
2025-08-11,16,Kínder,TopKids,196,20,176
2025-08-11,16,Kínder,TopKids,67,12,55
2025-08-11,16,Kínder,SuperSchool,65,1,64
2025-08-11,16,Kínder,EduMax,105,15,90
2025-08-11,16,Kínder,TopKids,77,1,76
2025-08-11,16,Kínder,SuperSchool,155,22,133
2025-08-11,16,Kínder,SuperSchool,149,14,135
2025-08-11,16,Kínder,SuperSchool,114,16,98
2025-08-11,16,Kínder,TopKids,282,22,260
2025-08-11,16,Kínder,TopKids,128,14,114
2025-08-11,16,Primaria 1°,EduMax,294,12,282
2025-08-11,16,Primaria 1°,SuperSchool,166,17,149
2025-08-11,16,Primaria 1°,SuperSchool,177,23,154
2025-08-11,16,Primaria 1°,TopKids,234,18,216
2025-08-11,16,Primaria 1°,TopKids,250,22,228
2025-08-11,16,Primaria 1°,EduMax,294,12,282
2025-08-11,16,Primaria 1°,TopKids,95,15,80
2025-08-11,16,Primaria 1°,TopKids,215,21,194
2025-08-11,16,Primaria 2°,EduMax,249,13,236
2025-08-11,16,Primaria 2°,TopKids,247,5,242
2025-08-11,16,Primaria 2°,SuperSchool,298,1,297
2025-08-11,16,Primaria 2°,SuperSchool,55,20,35
2025-08-11,16,Primaria 2°,EduMax,175,7,168
2025-08-11,16,Primaria 2°,SuperSchool,86,14,72
2025-08-11,16,Primaria 2°,SuperSchool,57,7,50
2025-08-11,16,Primaria 2°,SuperSchool,190,8,182
2025-08-11,16,Primaria 2°,TopKids,141,18,123
2025-08-11,16,Primaria 2°,SuperSchool,132,6,126
2025-08-11,16,Primaria 2°,EduMax,243,13,230
2025-08-11,16,Primaria 2°,TopKids,74,11,63
2025-08-11,16,Primaria 2°,SuperSchool,137,2,135
2025-08-11,16,Primaria 2°,EduMax,258,8,250
2025-08-11,16,Primaria 2°,EduMax,151,22,129
2025-08-11,16,Primaria 2°,SuperSchool,225,8,217
2025-08-11,16,Primaria 2°,TopKids,129,13,116
2025-08-11,16,Primaria 2°,EduMax,80,20,60
2025-08-11,16,Primaria 3°,TopKids,97,23,74
2025-08-11,16,Primaria 3°,SuperSchool,189,14,175
2025-08-11,16,Primaria 3°,EduMax,204,18,186
2025-08-11,16,Primaria 3°,SuperSchool,235,9,226
2025-08-11,16,Primaria 3°,EduMax,77,9,68
2025-08-11,16,Primaria 3°,SuperSchool,213,9,204
2025-08-11,16,Primaria 3°,TopKids,255,19,236
2025-08-11,16,Primaria 3°,SuperSchool,171,6,165
2025-08-11,16,Primaria 3°,TopKids,299,22,277
2025-08-11,16,Primaria 3°,EduMax,133,24,109
2025-08-11,16,Primaria 3°,TopKids,66,16,50
2025-08-11,16,Primaria 4°,TopKids,207,2,205
2025-08-11,16,Primaria 4°,EduMax,71,12,59
2025-08-11,16,Primaria 4°,SuperSchool,64,18,46
2025-08-11,16,Primaria 4°,SuperSchool,262,17,245
2025-08-11,16,Primaria 4°,SuperSchool,234,3,231
2025-08-11,16,Primaria 4°,EduMax,160,1,159
2025-08-11,16,Primaria 4°,SuperSchool,97,4,93
2025-08-11,16,Primaria 4°,SuperSchool,210,7,203
2025-08-11,16,Primaria 4°,EduMax,200,23,177
2025-08-11,16,Primaria 4°,TopKids,267,13,254
2025-08-11,16,Primaria 5°,SuperSchool,127,17,110
2025-08-11,16,Primaria 5°,SuperSchool,81,24,57
2025-08-11,16,Primaria 5°,SuperSchool,297,20,277
2025-08-11,16,Primaria 5°,TopKids,105,21,84
2025-08-11,16,Primaria 5°,EduMax,83,18,65
2025-08-11,16,Primaria 5°,EduMax,298,15,283
2025-08-11,16,Primaria 5°,EduMax,203,19,184
2025-08-11,16,Primaria 5°,TopKids,75,20,55
2025-08-11,16,Primaria 5°,EduMax,141,24,117
2025-08-11,16,Primaria 5°,TopKids,171,10,161
2025-08-11,16,Primaria 5°,SuperSchool,200,5,195
2025-08-11,16,Primaria 6°,TopKids,286,18,268
2025-08-11,16,Primaria 6°,SuperSchool,204,6,198
2025-08-11,16,Primaria 6°,EduMax,115,24,91
2025-08-11,16,Primaria 6°,EduMax,77,21,56
2025-08-11,16,Primaria 6°,SuperSchool,163,7,156
2025-08-11,16,Primaria 6°,EduMax,110,14,96
2025-08-11,16,Primaria 6°,SuperSchool,163,11,152
2025-08-11,16,Primaria 6°,EduMax,220,2,218
2025-08-11,16,Primaria 6°,TopKids,280,9,271
2025-08-11,16,Primaria 6°,SuperSchool,248,20,228
2025-08-11,16,Primaria 6°,EduMax,84,2,82
2025-08-11,16,Primaria 6°,SuperSchool,263,23,240
2025-08-11,16,Primaria 6°,TopKids,245,24,221
2025-08-12,9,Preescolar,TopKids,141,22,119
2025-08-12,9,Preescolar,TopKids,194,19,175
2025-08-12,9,Preescolar,EduMax,225,3,222
2025-08-12,9,Preescolar,TopKids,287,15,272
2025-08-12,9,Preescolar,EduMax,152,3,149
2025-08-12,9,Preescolar,EduMax,194,10,184
2025-08-12,9,Preescolar,TopKids,78,6,72
2025-08-12,9,Preescolar,SuperSchool,258,14,244
2025-08-12,9,Kínder,SuperSchool,99,5,94
2025-08-12,9,Kínder,SuperSchool,153,7,146
2025-08-12,9,Kínder,TopKids,145,4,141
2025-08-12,9,Kínder,EduMax,86,16,70
2025-08-12,9,Kínder,EduMax,204,19,185
2025-08-12,9,Kínder,TopKids,287,9,278
2025-08-12,9,Kínder,EduMax,130,19,111
2025-08-12,9,Kínder,SuperSchool,124,22,102
2025-08-12,9,Kínder,SuperSchool,249,14,235
2025-08-12,9,Kínder,TopKids,211,11,200
2025-08-12,9,Kínder,TopKids,188,24,164
2025-08-12,9,Kínder,EduMax,105,6,99
2025-08-12,9,Primaria 1°,SuperSchool,159,10,149
2025-08-12,9,Primaria 1°,EduMax,268,8,260
2025-08-12,9,Primaria 1°,TopKids,57,8,49
2025-08-12,9,Primaria 1°,TopKids,83,16,67
2025-08-12,9,Primaria 1°,SuperSchool,190,23,167
2025-08-12,9,Primaria 1°,TopKids,199,17,182
2025-08-12,9,Primaria 1°,TopKids,113,2,111
2025-08-12,9,Primaria 1°,SuperSchool,274,19,255
2025-08-12,9,Primaria 1°,TopKids,118,1,117
2025-08-12,9,Primaria 2°,EduMax,286,8,278
2025-08-12,9,Primaria 2°,EduMax,238,17,221
2025-08-12,9,Primaria 2°,SuperSchool,116,14,102
2025-08-12,9,Primaria 2°,EduMax,144,8,136
2025-08-12,9,Primaria 2°,TopKids,236,14,222
2025-08-12,9,Primaria 2°,SuperSchool,212,7,205
2025-08-12,9,Primaria 2°,TopKids,53,16,37
2025-08-12,9,Primaria 2°,SuperSchool,261,19,242
2025-08-12,9,Primaria 3°,TopKids,278,20,258
2025-08-12,9,Primaria 3°,EduMax,171,13,158
2025-08-12,9,Primaria 3°,EduMax,289,22,267
2025-08-12,9,Primaria 3°,EduMax,260,17,243
2025-08-12,9,Primaria 3°,SuperSchool,138,18,120
2025-08-12,9,Primaria 3°,TopKids,102,18,84
2025-08-12,9,Primaria 3°,TopKids,256,13,243
2025-08-12,9,Primaria 3°,SuperSchool,65,22,43
2025-08-12,9,Primaria 3°,SuperSchool,69,2,67
2025-08-12,9,Primaria 4°,TopKids,296,19,277
2025-08-12,9,Primaria 4°,SuperSchool,214,22,192
2025-08-12,9,Primaria 4°,EduMax,63,4,59
2025-08-12,9,Primaria 4°,EduMax,292,23,269
2025-08-12,9,Primaria 4°,TopKids,277,2,275
2025-08-12,9,Primaria 4°,TopKids,56,3,53
2025-08-12,9,Primaria 4°,TopKids,274,2,272
2025-08-12,9,Primaria 5°,SuperSchool,109,15,94
2025-08-12,9,Primaria 5°,TopKids,144,14,130
2025-08-12,9,Primaria 5°,EduMax,255,6,249
2025-08-12,9,Primaria 5°,EduMax,130,18,112
2025-08-12,9,Primaria 5°,TopKids,239,17,222
2025-08-12,9,Primaria 5°,TopKids,229,12,217
2025-08-12,9,Primaria 5°,SuperSchool,76,14,62
2025-08-12,9,Primaria 5°,SuperSchool,240,10,230
2025-08-12,9,Primaria 5°,TopKids,66,17,49
2025-08-12,9,Primaria 5°,SuperSchool,277,17,260
2025-08-12,9,Primaria 5°,EduMax,165,23,142
2025-08-12,9,Primaria 5°,EduMax,121,13,108
2025-08-12,9,Primaria 5°,TopKids,106,22,84
2025-08-12,9,Primaria 5°,EduMax,288,20,268
2025-08-12,9,Primaria 6°,SuperSchool,212,3,209
2025-08-12,9,Primaria 6°,EduMax,82,14,68
2025-08-12,9,Primaria 6°,SuperSchool,222,19,203
2025-08-12,9,Primaria 6°,EduMax,136,15,121
2025-08-12,9,Primaria 6°,TopKids,170,14,156
2025-08-12,9,Primaria 6°,EduMax,88,17,71
2025-08-12,9,Primaria 6°,EduMax,247,21,226
2025-08-12,9,Primaria 6°,TopKids,51,1,50
2025-08-12,9,Primaria 6°,TopKids,263,24,239
2025-08-12,9,Primaria 6°,TopKids,176,15,161
2025-08-12,9,Primaria 6°,SuperSchool,175,24,151
2025-08-12,10,Preescolar,EduMax,105,6,99
2025-08-12,10,Preescolar,SuperSchool,77,7,70
2025-08-12,10,Preescolar,EduMax,241,24,217
2025-08-12,10,Preescolar,SuperSchool,168,4,164
2025-08-12,10,Preescolar,SuperSchool,277,12,265
2025-08-12,10,Preescolar,SuperSchool,207,24,183
2025-08-12,10,Kínder,EduMax,233,24,209
2025-08-12,10,Kínder,TopKids,267,13,254
2025-08-12,10,Kínder,EduMax,185,23,162
2025-08-12,10,Kínder,SuperSchool,221,13,208
2025-08-12,10,Kínder,SuperSchool,69,14,55
2025-08-12,10,Kínder,EduMax,76,24,52
2025-08-12,10,Kínder,SuperSchool,101,4,97
2025-08-12,10,Kínder,SuperSchool,67,7,60
2025-08-12,10,Primaria 1°,SuperSchool,87,16,71
2025-08-12,10,Primaria 1°,SuperSchool,193,22,171
2025-08-12,10,Primaria 1°,TopKids,194,9,185
2025-08-12,10,Primaria 1°,SuperSchool,148,20,128
2025-08-12,10,Primaria 1°,SuperSchool,280,18,262
2025-08-12,10,Primaria 1°,TopKids,97,22,75
2025-08-12,10,Primaria 1°,TopKids,297,17,280
2025-08-12,10,Primaria 1°,TopKids,178,2,176
2025-08-12,10,Primaria 1°,EduMax,74,2,72
2025-08-12,10,Primaria 1°,TopKids,250,9,241
2025-08-12,10,Primaria 1°,SuperSchool,247,15,232
2025-08-12,10,Primaria 1°,TopKids,230,15,215
2025-08-12,10,Primaria 1°,EduMax,248,11,237
2025-08-12,10,Primaria 1°,EduMax,217,2,215
2025-08-12,10,Primaria 1°,TopKids,289,7,282
2025-08-12,10,Primaria 1°,EduMax,157,17,140
2025-08-12,10,Primaria 1°,TopKids,167,8,159
2025-08-12,10,Primaria 1°,TopKids,245,3,242
2025-08-12,10,Primaria 1°,TopKids,96,4,92
2025-08-12,10,Primaria 2°,SuperSchool,154,13,141
2025-08-12,10,Primaria 2°,EduMax,198,16,182
2025-08-12,10,Primaria 2°,SuperSchool,277,18,259
2025-08-12,10,Primaria 2°,SuperSchool,92,20,72
2025-08-12,10,Primaria 2°,SuperSchool,294,21,273
2025-08-12,10,Primaria 2°,TopKids,68,23,45
2025-08-12,10,Primaria 2°,TopKids,99,19,80
2025-08-12,10,Primaria 2°,TopKids,148,8,140
2025-08-12,10,Primaria 2°,TopKids,155,16,139
2025-08-12,10,Primaria 2°,SuperSchool,293,9,284
2025-08-12,10,Primaria 2°,TopKids,129,7,122
2025-08-12,10,Primaria 2°,TopKids,265,21,244
2025-08-12,10,Primaria 2°,TopKids,98,6,92
2025-08-12,10,Primaria 2°,TopKids,121,7,114
2025-08-12,10,Primaria 2°,EduMax,271,13,258
2025-08-12,10,Primaria 2°,EduMax,264,6,258
2025-08-12,10,Primaria 2°,SuperSchool,278,20,258
2025-08-12,10,Primaria 2°,SuperSchool,78,18,60
2025-08-12,10,Primaria 2°,TopKids,72,10,62
2025-08-12,10,Primaria 3°,SuperSchool,297,13,284
2025-08-12,10,Primaria 3°,EduMax,166,2,164
2025-08-12,10,Primaria 3°,SuperSchool,162,18,144
2025-08-12,10,Primaria 3°,SuperSchool,114,12,102
2025-08-12,10,Primaria 3°,SuperSchool,86,8,78
2025-08-12,10,Primaria 3°,TopKids,224,3,221
2025-08-12,10,Primaria 3°,EduMax,237,13,224
2025-08-12,10,Primaria 4°,TopKids,195,24,171
2025-08-12,10,Primaria 4°,SuperSchool,74,7,67
2025-08-12,10,Primaria 4°,EduMax,206,12,194
2025-08-12,10,Primaria 4°,TopKids,85,19,66
2025-08-12,10,Primaria 4°,EduMax,202,9,193
2025-08-12,10,Primaria 4°,EduMax,214,13,201
2025-08-12,10,Primaria 4°,SuperSchool,177,2,175
2025-08-12,10,Primaria 4°,EduMax,134,1,133
2025-08-12,10,Primaria 4°,SuperSchool,93,10,83
2025-08-12,10,Primaria 4°,EduMax,109,9,100
2025-08-12,10,Primaria 4°,EduMax,296,24,272
2025-08-12,10,Primaria 4°,EduMax,71,14,57
2025-08-12,10,Primaria 4°,TopKids,296,11,285
2025-08-12,10,Primaria 4°,SuperSchool,149,13,136
2025-08-12,10,Primaria 4°,TopKids,65,1,64
2025-08-12,10,Primaria 4°,SuperSchool,114,11,103
2025-08-12,10,Primaria 5°,TopKids,285,5,280
2025-08-12,10,Primaria 5°,SuperSchool,267,12,255
2025-08-12,10,Primaria 5°,EduMax,143,10,133
2025-08-12,10,Primaria 5°,TopKids,246,5,241
2025-08-12,10,Primaria 5°,SuperSchool,204,20,184
2025-08-12,10,Primaria 5°,SuperSchool,283,21,262
2025-08-12,10,Primaria 5°,SuperSchool,295,16,279
2025-08-12,10,Primaria 5°,EduMax,107,15,92
2025-08-12,10,Primaria 5°,TopKids,130,20,110
2025-08-12,10,Primaria 5°,SuperSchool,126,1,125
2025-08-12,10,Primaria 6°,SuperSchool,55,23,32
2025-08-12,10,Primaria 6°,EduMax,255,22,233
2025-08-12,10,Primaria 6°,TopKids,60,6,54
2025-08-12,10,Primaria 6°,TopKids,126,12,114
2025-08-12,10,Primaria 6°,EduMax,243,21,222
2025-08-12,10,Primaria 6°,TopKids,296,4,292
2025-08-12,10,Primaria 6°,SuperSchool,77,22,55
2025-08-12,10,Primaria 6°,EduMax,56,15,41
2025-08-12,10,Primaria 6°,TopKids,73,3,70
2025-08-12,10,Primaria 6°,EduMax,247,2,245
2025-08-12,10,Primaria 6°,SuperSchool,127,9,118
2025-08-12,10,Primaria 6°,EduMax,100,12,88
2025-08-12,10,Primaria 6°,TopKids,62,12,50
2025-08-12,11,Preescolar,EduMax,58,17,41
2025-08-12,11,Preescolar,SuperSchool,97,17,80
2025-08-12,11,Preescolar,SuperSchool,233,8,225
2025-08-12,11,Preescolar,TopKids,73,2,71
2025-08-12,11,Preescolar,SuperSchool,82,23,59
2025-08-12,11,Preescolar,SuperSchool,103,21,82
2025-08-12,11,Preescolar,SuperSchool,255,14,241
2025-08-12,11,Preescolar,SuperSchool,151,7,144
2025-08-12,11,Preescolar,EduMax,139,1,138
2025-08-12,11,Preescolar,SuperSchool,256,20,236
2025-08-12,11,Preescolar,SuperSchool,195,13,182
2025-08-12,11,Preescolar,EduMax,179,19,160
2025-08-12,11,Preescolar,TopKids,157,15,142
2025-08-12,11,Preescolar,SuperSchool,99,14,85
2025-08-12,11,Preescolar,EduMax,125,20,105
2025-08-12,11,Preescolar,TopKids,207,6,201
2025-08-12,11,Kínder,EduMax,90,4,86
2025-08-12,11,Kínder,SuperSchool,147,16,131
2025-08-12,11,Kínder,EduMax,139,8,131
2025-08-12,11,Kínder,EduMax,80,2,78
2025-08-12,11,Kínder,SuperSchool,104,20,84
2025-08-12,11,Kínder,TopKids,255,8,247
2025-08-12,11,Kínder,SuperSchool,74,3,71
2025-08-12,11,Kínder,SuperSchool,151,22,129
2025-08-12,11,Kínder,EduMax,89,6,83
2025-08-12,11,Kínder,EduMax,245,7,238
2025-08-12,11,Kínder,EduMax,207,24,183
2025-08-12,11,Kínder,TopKids,280,3,277
2025-08-12,11,Kínder,SuperSchool,210,14,196
2025-08-12,11,Kínder,EduMax,187,14,173
2025-08-12,11,Primaria 1°,EduMax,193,21,172
2025-08-12,11,Primaria 1°,TopKids,146,6,140
2025-08-12,11,Primaria 1°,SuperSchool,176,15,161
2025-08-12,11,Primaria 1°,TopKids,92,15,77
2025-08-12,11,Primaria 1°,TopKids,63,2,61
2025-08-12,11,Primaria 1°,SuperSchool,181,19,162
2025-08-12,11,Primaria 1°,EduMax,194,3,191
2025-08-12,11,Primaria 1°,EduMax,161,22,139
2025-08-12,11,Primaria 2°,TopKids,70,15,55
2025-08-12,11,Primaria 2°,TopKids,161,21,140
2025-08-12,11,Primaria 2°,SuperSchool,262,12,250
2025-08-12,11,Primaria 2°,TopKids,54,7,47
2025-08-12,11,Primaria 2°,SuperSchool,166,18,148
2025-08-12,11,Primaria 2°,SuperSchool,121,12,109
2025-08-12,11,Primaria 2°,EduMax,123,19,104
2025-08-12,11,Primaria 2°,SuperSchool,298,24,274
2025-08-12,11,Primaria 2°,SuperSchool,87,12,75
2025-08-12,11,Primaria 2°,SuperSchool,297,19,278
2025-08-12,11,Primaria 2°,TopKids,290,2,288
2025-08-12,11,Primaria 2°,TopKids,144,18,126
2025-08-12,11,Primaria 2°,TopKids,173,22,151
2025-08-12,11,Primaria 3°,EduMax,89,15,74
2025-08-12,11,Primaria 3°,SuperSchool,224,7,217
2025-08-12,11,Primaria 3°,SuperSchool,158,1,157
2025-08-12,11,Primaria 3°,SuperSchool,179,23,156
2025-08-12,11,Primaria 3°,TopKids,213,6,207
2025-08-12,11,Primaria 3°,TopKids,152,6,146
2025-08-12,11,Primaria 3°,TopKids,277,10,267
2025-08-12,11,Primaria 3°,EduMax,102,9,93
2025-08-12,11,Primaria 3°,EduMax,87,20,67
2025-08-12,11,Primaria 3°,TopKids,92,7,85
2025-08-12,11,Primaria 3°,EduMax,53,5,48
2025-08-12,11,Primaria 3°,TopKids,222,16,206
2025-08-12,11,Primaria 3°,SuperSchool,255,11,244
2025-08-12,11,Primaria 3°,SuperSchool,211,22,189
2025-08-12,11,Primaria 3°,EduMax,169,24,145
2025-08-12,11,Primaria 4°,TopKids,75,11,64
2025-08-12,11,Primaria 4°,TopKids,238,16,222
2025-08-12,11,Primaria 4°,EduMax,279,6,273
2025-08-12,11,Primaria 4°,EduMax,105,8,97
2025-08-12,11,Primaria 4°,EduMax,76,7,69
2025-08-12,11,Primaria 4°,TopKids,266,24,242
2025-08-12,11,Primaria 4°,EduMax,218,15,203
2025-08-12,11,Primaria 4°,SuperSchool,135,18,117
2025-08-12,11,Primaria 4°,TopKids,228,13,215
2025-08-12,11,Primaria 4°,TopKids,138,10,128
2025-08-12,11,Primaria 4°,EduMax,123,2,121
2025-08-12,11,Primaria 4°,EduMax,126,22,104
2025-08-12,11,Primaria 4°,SuperSchool,151,9,142
2025-08-12,11,Primaria 4°,SuperSchool,186,13,173
2025-08-12,11,Primaria 4°,SuperSchool,191,5,186
2025-08-12,11,Primaria 5°,TopKids,217,22,195
2025-08-12,11,Primaria 5°,TopKids,232,24,208
2025-08-12,11,Primaria 5°,TopKids,281,1,280
2025-08-12,11,Primaria 5°,TopKids,68,2,66
2025-08-12,11,Primaria 5°,EduMax,99,15,84
2025-08-12,11,Primaria 5°,EduMax,233,19,214
2025-08-12,11,Primaria 5°,EduMax,100,22,78
2025-08-12,11,Primaria 5°,TopKids,139,17,122
2025-08-12,11,Primaria 5°,EduMax,205,19,186
2025-08-12,11,Primaria 5°,TopKids,225,20,205
2025-08-12,11,Primaria 5°,SuperSchool,196,1,195
2025-08-12,11,Primaria 5°,TopKids,56,23,33
2025-08-12,11,Primaria 5°,TopKids,118,17,101
2025-08-12,11,Primaria 6°,EduMax,185,10,175
2025-08-12,11,Primaria 6°,EduMax,62,18,44
2025-08-12,11,Primaria 6°,EduMax,100,20,80
2025-08-12,11,Primaria 6°,SuperSchool,261,16,245
2025-08-12,11,Primaria 6°,SuperSchool,52,15,37
2025-08-12,11,Primaria 6°,EduMax,147,13,134
2025-08-12,11,Primaria 6°,EduMax,281,23,258
2025-08-12,11,Primaria 6°,TopKids,239,17,222
2025-08-12,11,Primaria 6°,TopKids,103,9,94
2025-08-12,11,Primaria 6°,TopKids,160,9,151
2025-08-12,11,Primaria 6°,SuperSchool,282,14,268
2025-08-12,11,Primaria 6°,TopKids,166,16,150
2025-08-12,11,Primaria 6°,TopKids,233,23,210
2025-08-12,11,Primaria 6°,SuperSchool,75,17,58
2025-08-12,11,Primaria 6°,TopKids,222,9,213
2025-08-12,12,Preescolar,TopKids,274,1,273
2025-08-12,12,Preescolar,SuperSchool,233,9,224
2025-08-12,12,Preescolar,EduMax,205,13,192
2025-08-12,12,Preescolar,EduMax,77,8,69
2025-08-12,12,Preescolar,TopKids,183,6,177
2025-08-12,12,Preescolar,TopKids,134,18,116
2025-08-12,12,Preescolar,TopKids,180,12,168
2025-08-12,12,Preescolar,TopKids,294,21,273
2025-08-12,12,Preescolar,EduMax,134,6,128
2025-08-12,12,Preescolar,TopKids,195,20,175
2025-08-12,12,Preescolar,SuperSchool,161,6,155
2025-08-12,12,Preescolar,SuperSchool,194,9,185
2025-08-12,12,Preescolar,TopKids,195,23,172
2025-08-12,12,Preescolar,SuperSchool,109,6,103
2025-08-12,12,Preescolar,TopKids,289,20,269
2025-08-12,12,Preescolar,SuperSchool,261,9,252
2025-08-12,12,Preescolar,SuperSchool,107,3,104
2025-08-12,12,Preescolar,TopKids,240,21,219
2025-08-12,12,Preescolar,TopKids,186,22,164
2025-08-12,12,Kínder,SuperSchool,104,14,90
2025-08-12,12,Kínder,TopKids,111,23,88
2025-08-12,12,Kínder,TopKids,268,7,261
2025-08-12,12,Kínder,TopKids,76,14,62
2025-08-12,12,Kínder,EduMax,82,18,64
2025-08-12,12,Kínder,TopKids,144,6,138
2025-08-12,12,Kínder,EduMax,222,9,213
2025-08-12,12,Primaria 1°,SuperSchool,240,15,225
2025-08-12,12,Primaria 1°,SuperSchool,177,22,155
2025-08-12,12,Primaria 1°,EduMax,267,14,253
2025-08-12,12,Primaria 1°,TopKids,87,2,85
2025-08-12,12,Primaria 1°,SuperSchool,105,14,91
2025-08-12,12,Primaria 1°,TopKids,169,14,155
2025-08-12,12,Primaria 1°,EduMax,133,1,132
2025-08-12,12,Primaria 1°,TopKids,57,9,48
2025-08-12,12,Primaria 1°,EduMax,194,20,174
2025-08-12,12,Primaria 1°,SuperSchool,86,10,76
2025-08-12,12,Primaria 1°,SuperSchool,166,6,160
2025-08-12,12,Primaria 1°,TopKids,173,15,158
2025-08-12,12,Primaria 1°,TopKids,271,6,265
2025-08-12,12,Primaria 2°,TopKids,150,3,147
2025-08-12,12,Primaria 2°,EduMax,234,9,225
2025-08-12,12,Primaria 2°,EduMax,62,22,40
2025-08-12,12,Primaria 2°,EduMax,293,4,289
2025-08-12,12,Primaria 2°,EduMax,107,4,103
2025-08-12,12,Primaria 2°,SuperSchool,283,18,265
2025-08-12,12,Primaria 2°,SuperSchool,175,1,174
2025-08-12,12,Primaria 2°,SuperSchool,99,15,84
2025-08-12,12,Primaria 3°,TopKids,174,14,160
2025-08-12,12,Primaria 3°,EduMax,96,14,82
2025-08-12,12,Primaria 3°,TopKids,206,15,191
2025-08-12,12,Primaria 3°,TopKids,68,9,59
2025-08-12,12,Primaria 3°,SuperSchool,86,11,75
2025-08-12,12,Primaria 3°,SuperSchool,265,4,261
2025-08-12,12,Primaria 4°,EduMax,138,3,135
2025-08-12,12,Primaria 4°,EduMax,216,8,208
2025-08-12,12,Primaria 4°,TopKids,56,17,39
2025-08-12,12,Primaria 4°,EduMax,263,22,241
2025-08-12,12,Primaria 4°,EduMax,105,14,91
2025-08-12,12,Primaria 4°,TopKids,256,5,251
2025-08-12,12,Primaria 4°,SuperSchool,51,20,31
2025-08-12,12,Primaria 4°,SuperSchool,154,22,132
2025-08-12,12,Primaria 5°,TopKids,218,4,214
2025-08-12,12,Primaria 5°,TopKids,92,1,91
2025-08-12,12,Primaria 5°,EduMax,270,1,269
2025-08-12,12,Primaria 5°,SuperSchool,193,22,171
2025-08-12,12,Primaria 5°,EduMax,71,9,62
2025-08-12,12,Primaria 5°,TopKids,138,18,120
2025-08-12,12,Primaria 5°,TopKids,118,2,116
2025-08-12,12,Primaria 5°,TopKids,172,10,162
2025-08-12,12,Primaria 5°,TopKids,298,7,291
2025-08-12,12,Primaria 5°,SuperSchool,160,20,140
2025-08-12,12,Primaria 5°,TopKids,283,24,259
2025-08-12,12,Primaria 5°,EduMax,174,14,160
2025-08-12,12,Primaria 5°,EduMax,171,10,161
2025-08-12,12,Primaria 5°,SuperSchool,294,14,280
2025-08-12,12,Primaria 5°,EduMax,161,13,148
2025-08-12,12,Primaria 6°,SuperSchool,120,16,104
2025-08-12,12,Primaria 6°,EduMax,297,22,275
2025-08-12,12,Primaria 6°,SuperSchool,135,23,112
2025-08-12,12,Primaria 6°,TopKids,289,9,280
2025-08-12,12,Primaria 6°,TopKids,265,17,248
2025-08-12,12,Primaria 6°,TopKids,92,8,84
2025-08-12,12,Primaria 6°,TopKids,141,19,122
2025-08-12,12,Primaria 6°,TopKids,133,12,121
2025-08-12,12,Primaria 6°,TopKids,89,7,82
2025-08-12,12,Primaria 6°,EduMax,74,9,65
2025-08-12,12,Primaria 6°,TopKids,190,7,183
2025-08-12,12,Primaria 6°,EduMax,290,17,273
2025-08-12,12,Primaria 6°,EduMax,147,8,139
2025-08-12,12,Primaria 6°,SuperSchool,222,18,204
2025-08-12,12,Primaria 6°,EduMax,109,10,99
2025-08-12,13,Preescolar,EduMax,140,14,126
2025-08-12,13,Preescolar,TopKids,294,21,273
2025-08-12,13,Preescolar,TopKids,205,14,191
2025-08-12,13,Preescolar,SuperSchool,53,4,49
2025-08-12,13,Preescolar,EduMax,180,1,179
2025-08-12,13,Preescolar,SuperSchool,248,16,232
2025-08-12,13,Kínder,SuperSchool,196,7,189
2025-08-12,13,Kínder,EduMax,211,3,208
2025-08-12,13,Kínder,SuperSchool,257,8,249
2025-08-12,13,Kínder,EduMax,224,7,217
2025-08-12,13,Kínder,TopKids,282,6,276
2025-08-12,13,Kínder,EduMax,227,24,203
2025-08-12,13,Kínder,EduMax,63,14,49
2025-08-12,13,Kínder,SuperSchool,277,4,273
2025-08-12,13,Kínder,TopKids,256,18,238
2025-08-12,13,Kínder,EduMax,299,1,298
2025-08-12,13,Kínder,EduMax,238,20,218
2025-08-12,13,Kínder,EduMax,59,24,35
2025-08-12,13,Kínder,EduMax,238,8,230
2025-08-12,13,Kínder,SuperSchool,176,1,175
2025-08-12,13,Kínder,TopKids,186,16,170
2025-08-12,13,Kínder,SuperSchool,147,23,124
2025-08-12,13,Kínder,TopKids,163,19,144
2025-08-12,13,Kínder,SuperSchool,177,24,153
2025-08-12,13,Primaria 1°,TopKids,66,5,61
2025-08-12,13,Primaria 1°,SuperSchool,239,20,219
2025-08-12,13,Primaria 1°,SuperSchool,155,8,147
2025-08-12,13,Primaria 1°,SuperSchool,153,19,134
2025-08-12,13,Primaria 1°,EduMax,93,7,86
2025-08-12,13,Primaria 1°,SuperSchool,198,22,176
2025-08-12,13,Primaria 1°,EduMax,251,10,241
2025-08-12,13,Primaria 1°,SuperSchool,257,1,256
2025-08-12,13,Primaria 1°,SuperSchool,79,21,58
2025-08-12,13,Primaria 1°,SuperSchool,287,19,268
2025-08-12,13,Primaria 1°,SuperSchool,134,17,117
2025-08-12,13,Primaria 1°,EduMax,153,21,132
2025-08-12,13,Primaria 1°,SuperSchool,154,8,146
2025-08-12,13,Primaria 1°,SuperSchool,226,19,207
2025-08-12,13,Primaria 1°,TopKids,130,1,129
2025-08-12,13,Primaria 2°,SuperSchool,119,2,117
2025-08-12,13,Primaria 2°,TopKids,273,16,257
2025-08-12,13,Primaria 2°,EduMax,182,5,177
2025-08-12,13,Primaria 2°,TopKids,253,3,250
2025-08-12,13,Primaria 2°,EduMax,225,6,219
2025-08-12,13,Primaria 2°,TopKids,192,16,176
2025-08-12,13,Primaria 2°,SuperSchool,93,10,83
2025-08-12,13,Primaria 2°,EduMax,144,2,142
2025-08-12,13,Primaria 2°,SuperSchool,180,9,171
2025-08-12,13,Primaria 3°,TopKids,202,22,180
2025-08-12,13,Primaria 3°,EduMax,299,14,285
2025-08-12,13,Primaria 3°,SuperSchool,133,21,112
2025-08-12,13,Primaria 3°,EduMax,199,9,190
2025-08-12,13,Primaria 3°,SuperSchool,113,5,108
2025-08-12,13,Primaria 3°,TopKids,178,21,157
2025-08-12,13,Primaria 3°,EduMax,114,22,92
2025-08-12,13,Primaria 3°,TopKids,109,14,95
2025-08-12,13,Primaria 3°,SuperSchool,162,22,140
2025-08-12,13,Primaria 3°,EduMax,230,6,224
2025-08-12,13,Primaria 3°,TopKids,187,15,172
2025-08-12,13,Primaria 3°,TopKids,296,2,294
2025-08-12,13,Primaria 3°,TopKids,61,19,42
2025-08-12,13,Primaria 3°,EduMax,116,2,114
2025-08-12,13,Primaria 3°,SuperSchool,188,3,185
2025-08-12,13,Primaria 4°,EduMax,214,22,192
2025-08-12,13,Primaria 4°,TopKids,252,3,249
2025-08-12,13,Primaria 4°,TopKids,286,21,265
2025-08-12,13,Primaria 4°,EduMax,275,4,271
2025-08-12,13,Primaria 4°,EduMax,100,4,96
2025-08-12,13,Primaria 4°,EduMax,186,16,170
2025-08-12,13,Primaria 4°,EduMax,151,4,147
2025-08-12,13,Primaria 5°,TopKids,94,9,85
2025-08-12,13,Primaria 5°,EduMax,166,19,147
2025-08-12,13,Primaria 5°,EduMax,176,21,155
2025-08-12,13,Primaria 5°,TopKids,52,5,47
2025-08-12,13,Primaria 5°,SuperSchool,291,14,277
2025-08-12,13,Primaria 5°,EduMax,58,15,43
2025-08-12,13,Primaria 5°,TopKids,191,6,185
2025-08-12,13,Primaria 5°,SuperSchool,64,20,44
2025-08-12,13,Primaria 5°,EduMax,153,1,152
2025-08-12,13,Primaria 5°,EduMax,290,19,271
2025-08-12,13,Primaria 5°,SuperSchool,271,22,249
2025-08-12,13,Primaria 5°,TopKids,184,18,166
2025-08-12,13,Primaria 5°,EduMax,179,15,164
2025-08-12,13,Primaria 6°,TopKids,99,9,90
2025-08-12,13,Primaria 6°,EduMax,182,11,171
2025-08-12,13,Primaria 6°,SuperSchool,241,11,230
2025-08-12,13,Primaria 6°,SuperSchool,162,22,140
2025-08-12,13,Primaria 6°,TopKids,68,22,46
2025-08-12,13,Primaria 6°,EduMax,105,17,88
2025-08-12,13,Primaria 6°,SuperSchool,233,17,216
2025-08-12,13,Primaria 6°,EduMax,269,18,251
2025-08-12,13,Primaria 6°,TopKids,195,13,182
2025-08-12,13,Primaria 6°,EduMax,105,16,89
2025-08-12,13,Primaria 6°,EduMax,107,18,89
2025-08-12,13,Primaria 6°,TopKids,258,7,251
2025-08-12,13,Primaria 6°,EduMax,59,5,54
2025-08-12,13,Primaria 6°,SuperSchool,180,19,161
2025-08-12,13,Primaria 6°,SuperSchool,93,3,90
2025-08-12,13,Primaria 6°,EduMax,191,4,187
2025-08-12,13,Primaria 6°,SuperSchool,292,18,274
2025-08-12,13,Primaria 6°,SuperSchool,276,20,256
2025-08-12,14,Preescolar,TopKids,221,19,202
2025-08-12,14,Preescolar,TopKids,169,4,165
2025-08-12,14,Preescolar,SuperSchool,115,13,102
2025-08-12,14,Preescolar,EduMax,299,13,286
2025-08-12,14,Preescolar,EduMax,147,19,128
2025-08-12,14,Preescolar,EduMax,137,16,121
2025-08-12,14,Preescolar,SuperSchool,154,17,137
2025-08-12,14,Preescolar,EduMax,131,19,112
2025-08-12,14,Preescolar,TopKids,106,19,87
2025-08-12,14,Preescolar,TopKids,218,10,208
2025-08-12,14,Kínder,EduMax,53,5,48
2025-08-12,14,Kínder,SuperSchool,157,23,134
2025-08-12,14,Kínder,SuperSchool,150,11,139
2025-08-12,14,Kínder,TopKids,124,13,111
2025-08-12,14,Kínder,EduMax,237,8,229
2025-08-12,14,Kínder,SuperSchool,259,19,240
2025-08-12,14,Kínder,EduMax,59,7,52
2025-08-12,14,Kínder,EduMax,221,14,207
2025-08-12,14,Kínder,TopKids,65,2,63
2025-08-12,14,Kínder,EduMax,79,18,61
2025-08-12,14,Kínder,TopKids,285,16,269
2025-08-12,14,Primaria 1°,SuperSchool,163,3,160
2025-08-12,14,Primaria 1°,TopKids,155,1,154
2025-08-12,14,Primaria 1°,EduMax,276,19,257
2025-08-12,14,Primaria 1°,SuperSchool,261,23,238
2025-08-12,14,Primaria 1°,TopKids,57,8,49
2025-08-12,14,Primaria 1°,TopKids,177,7,170
2025-08-12,14,Primaria 1°,EduMax,134,6,128
2025-08-12,14,Primaria 1°,EduMax,85,13,72
2025-08-12,14,Primaria 1°,EduMax,102,14,88
2025-08-12,14,Primaria 1°,SuperSchool,252,23,229
2025-08-12,14,Primaria 1°,EduMax,124,17,107
2025-08-12,14,Primaria 1°,EduMax,244,11,233
2025-08-12,14,Primaria 1°,EduMax,212,15,197
2025-08-12,14,Primaria 1°,TopKids,124,20,104
2025-08-12,14,Primaria 1°,SuperSchool,124,19,105
2025-08-12,14,Primaria 1°,SuperSchool,236,5,231
2025-08-12,14,Primaria 1°,EduMax,91,14,77
2025-08-12,14,Primaria 2°,EduMax,67,13,54
2025-08-12,14,Primaria 2°,TopKids,182,20,162
2025-08-12,14,Primaria 2°,EduMax,176,11,165
2025-08-12,14,Primaria 2°,EduMax,271,18,253
2025-08-12,14,Primaria 2°,EduMax,215,23,192
2025-08-12,14,Primaria 2°,EduMax,263,23,240
2025-08-12,14,Primaria 3°,EduMax,220,19,201
2025-08-12,14,Primaria 3°,SuperSchool,265,4,261
2025-08-12,14,Primaria 3°,EduMax,297,14,283
2025-08-12,14,Primaria 3°,TopKids,101,4,97
2025-08-12,14,Primaria 3°,EduMax,235,4,231
2025-08-12,14,Primaria 4°,EduMax,186,21,165
2025-08-12,14,Primaria 4°,SuperSchool,299,8,291
2025-08-12,14,Primaria 4°,TopKids,204,5,199
2025-08-12,14,Primaria 4°,EduMax,54,19,35
2025-08-12,14,Primaria 4°,TopKids,57,9,48
2025-08-12,14,Primaria 4°,TopKids,277,9,268
2025-08-12,14,Primaria 4°,TopKids,273,8,265
2025-08-12,14,Primaria 4°,TopKids,164,15,149
2025-08-12,14,Primaria 4°,SuperSchool,132,7,125
2025-08-12,14,Primaria 4°,EduMax,260,17,243
2025-08-12,14,Primaria 5°,TopKids,176,11,165
2025-08-12,14,Primaria 5°,TopKids,59,11,48
2025-08-12,14,Primaria 5°,TopKids,116,3,113
2025-08-12,14,Primaria 5°,EduMax,202,11,191
2025-08-12,14,Primaria 5°,EduMax,142,22,120
2025-08-12,14,Primaria 5°,EduMax,170,15,155
2025-08-12,14,Primaria 5°,TopKids,59,21,38
2025-08-12,14,Primaria 5°,TopKids,293,10,283
2025-08-12,14,Primaria 5°,SuperSchool,96,23,73
2025-08-12,14,Primaria 5°,EduMax,264,4,260
2025-08-12,14,Primaria 5°,SuperSchool,244,21,223
2025-08-12,14,Primaria 5°,SuperSchool,179,4,175
2025-08-12,14,Primaria 5°,SuperSchool,128,1,127
2025-08-12,14,Primaria 5°,EduMax,184,19,165
2025-08-12,14,Primaria 6°,TopKids,114,7,107
2025-08-12,14,Primaria 6°,TopKids,158,12,146
2025-08-12,14,Primaria 6°,EduMax,126,14,112
2025-08-12,14,Primaria 6°,EduMax,79,12,67
2025-08-12,14,Primaria 6°,TopKids,215,10,205
2025-08-12,14,Primaria 6°,TopKids,238,24,214
2025-08-12,14,Primaria 6°,SuperSchool,211,7,204
2025-08-12,14,Primaria 6°,SuperSchool,170,12,158
2025-08-12,14,Primaria 6°,SuperSchool,114,22,92
2025-08-12,14,Primaria 6°,TopKids,209,8,201
2025-08-12,14,Primaria 6°,SuperSchool,67,13,54
2025-08-12,14,Primaria 6°,SuperSchool,145,1,144
2025-08-12,14,Primaria 6°,SuperSchool,259,16,243
2025-08-12,14,Primaria 6°,TopKids,299,10,289
2025-08-12,14,Primaria 6°,EduMax,213,1,212
2025-08-12,14,Primaria 6°,TopKids,217,5,212
2025-08-12,15,Preescolar,SuperSchool,144,7,137
2025-08-12,15,Preescolar,SuperSchool,141,6,135
2025-08-12,15,Preescolar,SuperSchool,71,15,56
2025-08-12,15,Preescolar,SuperSchool,64,18,46
2025-08-12,15,Preescolar,EduMax,202,21,181
2025-08-12,15,Preescolar,SuperSchool,296,6,290
2025-08-12,15,Kínder,TopKids,162,21,141
2025-08-12,15,Kínder,TopKids,243,2,241
2025-08-12,15,Kínder,EduMax,64,20,44
2025-08-12,15,Kínder,EduMax,213,19,194
2025-08-12,15,Kínder,SuperSchool,248,13,235
2025-08-12,15,Kínder,TopKids,240,12,228
2025-08-12,15,Primaria 1°,SuperSchool,256,14,242
2025-08-12,15,Primaria 1°,SuperSchool,286,23,263
2025-08-12,15,Primaria 1°,EduMax,85,21,64
2025-08-12,15,Primaria 1°,TopKids,275,19,256
2025-08-12,15,Primaria 1°,TopKids,153,17,136
2025-08-12,15,Primaria 1°,SuperSchool,184,9,175
2025-08-12,15,Primaria 1°,SuperSchool,191,14,177
2025-08-12,15,Primaria 2°,TopKids,64,19,45
2025-08-12,15,Primaria 2°,EduMax,57,5,52
2025-08-12,15,Primaria 2°,EduMax,228,4,224
2025-08-12,15,Primaria 2°,EduMax,193,20,173
2025-08-12,15,Primaria 2°,EduMax,168,6,162
2025-08-12,15,Primaria 2°,TopKids,256,3,253
2025-08-12,15,Primaria 2°,TopKids,180,10,170
2025-08-12,15,Primaria 2°,EduMax,146,16,130
2025-08-12,15,Primaria 2°,TopKids,187,1,186
2025-08-12,15,Primaria 2°,TopKids,246,12,234
2025-08-12,15,Primaria 2°,SuperSchool,93,13,80
2025-08-12,15,Primaria 2°,SuperSchool,145,16,129
2025-08-12,15,Primaria 2°,SuperSchool,278,24,254
2025-08-12,15,Primaria 2°,SuperSchool,160,12,148
2025-08-12,15,Primaria 2°,TopKids,70,19,51
2025-08-12,15,Primaria 2°,SuperSchool,156,21,135
2025-08-12,15,Primaria 2°,EduMax,122,1,121
2025-08-12,15,Primaria 2°,EduMax,127,6,121
2025-08-12,15,Primaria 2°,SuperSchool,135,2,133
2025-08-12,15,Primaria 3°,TopKids,52,10,42
2025-08-12,15,Primaria 3°,EduMax,55,6,49
2025-08-12,15,Primaria 3°,TopKids,197,21,176
2025-08-12,15,Primaria 3°,EduMax,267,24,243
2025-08-12,15,Primaria 3°,EduMax,136,6,130
2025-08-12,15,Primaria 3°,TopKids,269,17,252
2025-08-12,15,Primaria 3°,EduMax,177,14,163
2025-08-12,15,Primaria 3°,SuperSchool,104,17,87
2025-08-12,15,Primaria 3°,EduMax,154,12,142
2025-08-12,15,Primaria 3°,TopKids,71,7,64
2025-08-12,15,Primaria 3°,SuperSchool,198,16,182
2025-08-12,15,Primaria 3°,TopKids,221,15,206
2025-08-12,15,Primaria 4°,TopKids,97,15,82
2025-08-12,15,Primaria 4°,SuperSchool,188,15,173
2025-08-12,15,Primaria 4°,SuperSchool,291,13,278
2025-08-12,15,Primaria 4°,SuperSchool,213,16,197
2025-08-12,15,Primaria 4°,TopKids,64,14,50
2025-08-12,15,Primaria 4°,TopKids,145,10,135
2025-08-12,15,Primaria 5°,EduMax,135,14,121
2025-08-12,15,Primaria 5°,TopKids,130,21,109
2025-08-12,15,Primaria 5°,TopKids,161,15,146
2025-08-12,15,Primaria 5°,EduMax,64,1,63
2025-08-12,15,Primaria 5°,TopKids,296,12,284
2025-08-12,15,Primaria 5°,EduMax,287,10,277
2025-08-12,15,Primaria 5°,EduMax,293,11,282
2025-08-12,15,Primaria 5°,EduMax,193,9,184
2025-08-12,15,Primaria 5°,TopKids,127,19,108
2025-08-12,15,Primaria 5°,TopKids,250,4,246
2025-08-12,15,Primaria 5°,SuperSchool,280,22,258
2025-08-12,15,Primaria 5°,EduMax,57,24,33
2025-08-12,15,Primaria 6°,TopKids,160,16,144
2025-08-12,15,Primaria 6°,EduMax,107,22,85
2025-08-12,15,Primaria 6°,TopKids,250,12,238
2025-08-12,15,Primaria 6°,TopKids,97,4,93
2025-08-12,15,Primaria 6°,SuperSchool,185,1,184
2025-08-12,15,Primaria 6°,EduMax,96,4,92
2025-08-12,15,Primaria 6°,SuperSchool,252,5,247
2025-08-12,15,Primaria 6°,EduMax,73,15,58
2025-08-12,15,Primaria 6°,EduMax,133,13,120
2025-08-12,15,Primaria 6°,SuperSchool,79,1,78
2025-08-12,15,Primaria 6°,EduMax,131,14,117
2025-08-12,15,Primaria 6°,SuperSchool,80,6,74
2025-08-12,16,Preescolar,SuperSchool,142,16,126
2025-08-12,16,Preescolar,EduMax,230,12,218
2025-08-12,16,Preescolar,EduMax,211,23,188
2025-08-12,16,Preescolar,SuperSchool,241,23,218
2025-08-12,16,Preescolar,SuperSchool,204,17,187
2025-08-12,16,Preescolar,SuperSchool,225,21,204
2025-08-12,16,Preescolar,EduMax,217,3,214
2025-08-12,16,Preescolar,SuperSchool,238,18,220
2025-08-12,16,Preescolar,EduMax,139,23,116
2025-08-12,16,Preescolar,EduMax,205,8,197
2025-08-12,16,Preescolar,TopKids,235,13,222
2025-08-12,16,Preescolar,TopKids,151,23,128
2025-08-12,16,Preescolar,TopKids,209,10,199
2025-08-12,16,Preescolar,TopKids,226,1,225
2025-08-12,16,Preescolar,TopKids,78,13,65
2025-08-12,16,Kínder,TopKids,288,5,283
2025-08-12,16,Kínder,TopKids,177,11,166
2025-08-12,16,Kínder,EduMax,131,3,128
2025-08-12,16,Kínder,EduMax,116,5,111
2025-08-12,16,Kínder,SuperSchool,77,19,58
2025-08-12,16,Kínder,TopKids,254,6,248
2025-08-12,16,Kínder,TopKids,166,21,145
2025-08-12,16,Primaria 1°,EduMax,95,6,89
2025-08-12,16,Primaria 1°,EduMax,98,11,87
2025-08-12,16,Primaria 1°,TopKids,282,21,261
2025-08-12,16,Primaria 1°,SuperSchool,297,7,290
2025-08-12,16,Primaria 1°,TopKids,176,21,155
2025-08-12,16,Primaria 1°,SuperSchool,266,8,258
2025-08-12,16,Primaria 1°,SuperSchool,79,19,60
2025-08-12,16,Primaria 1°,SuperSchool,68,12,56
2025-08-12,16,Primaria 1°,TopKids,232,15,217
2025-08-12,16,Primaria 1°,TopKids,93,13,80
2025-08-12,16,Primaria 1°,EduMax,150,22,128
2025-08-12,16,Primaria 1°,EduMax,88,15,73
2025-08-12,16,Primaria 1°,SuperSchool,171,16,155
2025-08-12,16,Primaria 1°,TopKids,161,23,138
2025-08-12,16,Primaria 1°,TopKids,204,13,191
2025-08-12,16,Primaria 2°,TopKids,84,15,69
2025-08-12,16,Primaria 2°,TopKids,56,18,38
2025-08-12,16,Primaria 2°,EduMax,163,19,144
2025-08-12,16,Primaria 2°,EduMax,69,6,63
2025-08-12,16,Primaria 2°,SuperSchool,153,7,146
2025-08-12,16,Primaria 2°,EduMax,99,15,84
2025-08-12,16,Primaria 2°,EduMax,164,22,142
2025-08-12,16,Primaria 2°,SuperSchool,262,2,260
2025-08-12,16,Primaria 2°,SuperSchool,92,18,74
2025-08-12,16,Primaria 2°,TopKids,254,9,245
2025-08-12,16,Primaria 2°,SuperSchool,162,7,155
2025-08-12,16,Primaria 2°,SuperSchool,103,1,102
2025-08-12,16,Primaria 2°,EduMax,181,14,167
2025-08-12,16,Primaria 2°,EduMax,153,18,135
2025-08-12,16,Primaria 2°,TopKids,241,14,227
2025-08-12,16,Primaria 2°,SuperSchool,283,17,266
2025-08-12,16,Primaria 2°,TopKids,223,21,202
2025-08-12,16,Primaria 3°,TopKids,150,16,134
2025-08-12,16,Primaria 3°,EduMax,76,8,68
2025-08-12,16,Primaria 3°,SuperSchool,195,3,192
2025-08-12,16,Primaria 3°,SuperSchool,101,15,86
2025-08-12,16,Primaria 3°,TopKids,102,17,85
2025-08-12,16,Primaria 3°,EduMax,162,18,144
2025-08-12,16,Primaria 3°,TopKids,110,5,105
2025-08-12,16,Primaria 3°,SuperSchool,282,2,280
2025-08-12,16,Primaria 3°,EduMax,292,23,269
2025-08-12,16,Primaria 3°,TopKids,52,17,35
2025-08-12,16,Primaria 3°,EduMax,255,14,241
2025-08-12,16,Primaria 4°,TopKids,178,16,162
2025-08-12,16,Primaria 4°,SuperSchool,181,1,180
2025-08-12,16,Primaria 4°,SuperSchool,205,18,187
2025-08-12,16,Primaria 4°,EduMax,185,2,183
2025-08-12,16,Primaria 4°,TopKids,67,16,51
2025-08-12,16,Primaria 4°,EduMax,59,8,51
2025-08-12,16,Primaria 4°,EduMax,65,12,53
2025-08-12,16,Primaria 4°,TopKids,261,19,242
2025-08-12,16,Primaria 4°,SuperSchool,76,3,73
2025-08-12,16,Primaria 4°,EduMax,58,21,37
2025-08-12,16,Primaria 5°,EduMax,214,1,213
2025-08-12,16,Primaria 5°,EduMax,98,4,94
2025-08-12,16,Primaria 5°,TopKids,228,8,220
2025-08-12,16,Primaria 5°,TopKids,128,7,121
2025-08-12,16,Primaria 5°,TopKids,249,23,226
2025-08-12,16,Primaria 5°,EduMax,131,4,127
2025-08-12,16,Primaria 5°,TopKids,284,22,262
2025-08-12,16,Primaria 5°,TopKids,128,3,125
2025-08-12,16,Primaria 5°,TopKids,87,1,86
2025-08-12,16,Primaria 5°,EduMax,225,1,224
2025-08-12,16,Primaria 5°,SuperSchool,290,8,282
2025-08-12,16,Primaria 5°,EduMax,257,6,251
2025-08-12,16,Primaria 5°,EduMax,91,5,86
2025-08-12,16,Primaria 5°,EduMax,269,12,257
2025-08-12,16,Primaria 5°,SuperSchool,191,14,177
2025-08-12,16,Primaria 5°,TopKids,78,12,66
2025-08-12,16,Primaria 5°,EduMax,93,2,91
2025-08-12,16,Primaria 6°,TopKids,66,10,56
2025-08-12,16,Primaria 6°,EduMax,71,19,52
2025-08-12,16,Primaria 6°,EduMax,102,1,101
2025-08-12,16,Primaria 6°,SuperSchool,277,4,273
2025-08-12,16,Primaria 6°,EduMax,208,2,206
2025-08-12,16,Primaria 6°,TopKids,102,12,90
2025-08-13,9,Preescolar,TopKids,286,22,264
2025-08-13,9,Preescolar,TopKids,293,23,270
2025-08-13,9,Preescolar,TopKids,203,3,200
2025-08-13,9,Preescolar,TopKids,197,13,184
2025-08-13,9,Preescolar,SuperSchool,88,24,64
2025-08-13,9,Preescolar,EduMax,218,6,212
2025-08-13,9,Preescolar,TopKids,277,15,262
2025-08-13,9,Preescolar,SuperSchool,235,5,230
2025-08-13,9,Preescolar,TopKids,122,7,115
2025-08-13,9,Preescolar,SuperSchool,261,10,251
2025-08-13,9,Preescolar,EduMax,203,4,199
2025-08-13,9,Preescolar,EduMax,73,14,59
2025-08-13,9,Preescolar,SuperSchool,242,17,225
2025-08-13,9,Preescolar,SuperSchool,73,7,66
2025-08-13,9,Kínder,TopKids,148,12,136
2025-08-13,9,Kínder,SuperSchool,52,15,37
2025-08-13,9,Kínder,SuperSchool,59,1,58
2025-08-13,9,Kínder,EduMax,108,20,88
2025-08-13,9,Kínder,EduMax,179,23,156
2025-08-13,9,Kínder,SuperSchool,238,4,234
2025-08-13,9,Kínder,TopKids,117,5,112
2025-08-13,9,Kínder,EduMax,109,20,89
2025-08-13,9,Kínder,SuperSchool,264,13,251
2025-08-13,9,Kínder,EduMax,162,1,161
2025-08-13,9,Kínder,EduMax,241,15,226
2025-08-13,9,Kínder,TopKids,275,16,259
2025-08-13,9,Kínder,EduMax,86,22,64
2025-08-13,9,Primaria 1°,SuperSchool,83,7,76
2025-08-13,9,Primaria 1°,TopKids,258,24,234
2025-08-13,9,Primaria 1°,TopKids,158,7,151
2025-08-13,9,Primaria 1°,SuperSchool,297,3,294
2025-08-13,9,Primaria 1°,TopKids,270,18,252
2025-08-13,9,Primaria 1°,SuperSchool,123,23,100
2025-08-13,9,Primaria 1°,TopKids,186,5,181
2025-08-13,9,Primaria 2°,EduMax,117,20,97
2025-08-13,9,Primaria 2°,EduMax,221,2,219
2025-08-13,9,Primaria 2°,SuperSchool,272,1,271
2025-08-13,9,Primaria 2°,TopKids,77,9,68
2025-08-13,9,Primaria 2°,EduMax,144,17,127
2025-08-13,9,Primaria 2°,SuperSchool,264,13,251
2025-08-13,9,Primaria 2°,TopKids,59,16,43
2025-08-13,9,Primaria 2°,EduMax,225,11,214
2025-08-13,9,Primaria 3°,TopKids,269,9,260
2025-08-13,9,Primaria 3°,TopKids,109,13,96
2025-08-13,9,Primaria 3°,EduMax,165,24,141
2025-08-13,9,Primaria 3°,SuperSchool,258,7,251
2025-08-13,9,Primaria 3°,EduMax,62,17,45
2025-08-13,9,Primaria 3°,TopKids,85,15,70
2025-08-13,9,Primaria 3°,EduMax,166,11,155
2025-08-13,9,Primaria 3°,TopKids,181,3,178
2025-08-13,9,Primaria 3°,EduMax,101,10,91
2025-08-13,9,Primaria 3°,EduMax,222,20,202
2025-08-13,9,Primaria 3°,SuperSchool,299,21,278
2025-08-13,9,Primaria 3°,SuperSchool,200,18,182
2025-08-13,9,Primaria 3°,SuperSchool,161,11,150
2025-08-13,9,Primaria 3°,EduMax,282,12,270
2025-08-13,9,Primaria 4°,SuperSchool,100,1,99
2025-08-13,9,Primaria 4°,EduMax,127,22,105
2025-08-13,9,Primaria 4°,SuperSchool,178,17,161
2025-08-13,9,Primaria 4°,TopKids,165,15,150
2025-08-13,9,Primaria 4°,TopKids,231,22,209
2025-08-13,9,Primaria 4°,EduMax,223,22,201
2025-08-13,9,Primaria 4°,SuperSchool,299,9,290
2025-08-13,9,Primaria 4°,TopKids,216,23,193
2025-08-13,9,Primaria 4°,TopKids,232,2,230
2025-08-13,9,Primaria 4°,EduMax,215,23,192
2025-08-13,9,Primaria 4°,TopKids,206,20,186
2025-08-13,9,Primaria 4°,EduMax,173,3,170
2025-08-13,9,Primaria 4°,TopKids,120,4,116
2025-08-13,9,Primaria 4°,SuperSchool,168,5,163
2025-08-13,9,Primaria 4°,SuperSchool,299,4,295
2025-08-13,9,Primaria 4°,TopKids,94,16,78
2025-08-13,9,Primaria 4°,TopKids,211,18,193
2025-08-13,9,Primaria 4°,SuperSchool,259,8,251
2025-08-13,9,Primaria 5°,TopKids,225,17,208
2025-08-13,9,Primaria 5°,SuperSchool,221,10,211
2025-08-13,9,Primaria 5°,EduMax,57,13,44
2025-08-13,9,Primaria 5°,EduMax,273,19,254
2025-08-13,9,Primaria 5°,EduMax,283,4,279
2025-08-13,9,Primaria 5°,EduMax,216,20,196
2025-08-13,9,Primaria 5°,TopKids,75,4,71
2025-08-13,9,Primaria 5°,TopKids,251,15,236
2025-08-13,9,Primaria 5°,SuperSchool,165,18,147
2025-08-13,9,Primaria 5°,SuperSchool,257,5,252
2025-08-13,9,Primaria 5°,TopKids,245,6,239
2025-08-13,9,Primaria 5°,EduMax,162,7,155
2025-08-13,9,Primaria 5°,TopKids,216,9,207
2025-08-13,9,Primaria 5°,SuperSchool,293,14,279
2025-08-13,9,Primaria 5°,TopKids,186,15,171
2025-08-13,9,Primaria 6°,EduMax,176,21,155
2025-08-13,9,Primaria 6°,TopKids,198,9,189
2025-08-13,9,Primaria 6°,TopKids,270,22,248
2025-08-13,9,Primaria 6°,EduMax,53,11,42
2025-08-13,9,Primaria 6°,SuperSchool,91,3,88
2025-08-13,9,Primaria 6°,SuperSchool,285,23,262
2025-08-13,9,Primaria 6°,TopKids,96,21,75
2025-08-13,9,Primaria 6°,EduMax,107,7,100
2025-08-13,9,Primaria 6°,SuperSchool,297,19,278
2025-08-13,10,Preescolar,TopKids,207,3,204
2025-08-13,10,Preescolar,EduMax,234,18,216
2025-08-13,10,Preescolar,EduMax,101,22,79
2025-08-13,10,Preescolar,EduMax,212,7,205
2025-08-13,10,Preescolar,TopKids,144,5,139
2025-08-13,10,Preescolar,TopKids,291,15,276
2025-08-13,10,Preescolar,TopKids,101,14,87
2025-08-13,10,Preescolar,TopKids,85,24,61
2025-08-13,10,Preescolar,SuperSchool,102,13,89
2025-08-13,10,Preescolar,EduMax,121,15,106
2025-08-13,10,Preescolar,SuperSchool,118,20,98
2025-08-13,10,Kínder,TopKids,195,10,185
2025-08-13,10,Kínder,SuperSchool,79,15,64
2025-08-13,10,Kínder,EduMax,232,21,211
2025-08-13,10,Kínder,TopKids,153,9,144
2025-08-13,10,Kínder,TopKids,172,2,170
2025-08-13,10,Kínder,TopKids,62,4,58
2025-08-13,10,Kínder,TopKids,122,5,117
2025-08-13,10,Kínder,TopKids,135,3,132
2025-08-13,10,Primaria 1°,SuperSchool,148,6,142
2025-08-13,10,Primaria 1°,EduMax,278,3,275
2025-08-13,10,Primaria 1°,EduMax,265,7,258
2025-08-13,10,Primaria 1°,EduMax,207,18,189
2025-08-13,10,Primaria 1°,TopKids,136,8,128
2025-08-13,10,Primaria 1°,SuperSchool,240,4,236
2025-08-13,10,Primaria 1°,TopKids,235,7,228
2025-08-13,10,Primaria 1°,EduMax,254,10,244
2025-08-13,10,Primaria 1°,TopKids,259,1,258
2025-08-13,10,Primaria 1°,EduMax,185,10,175
2025-08-13,10,Primaria 1°,TopKids,297,11,286
2025-08-13,10,Primaria 1°,EduMax,50,12,38
2025-08-13,10,Primaria 1°,SuperSchool,87,13,74
2025-08-13,10,Primaria 1°,EduMax,130,1,129
2025-08-13,10,Primaria 1°,EduMax,89,24,65
2025-08-13,10,Primaria 1°,TopKids,284,14,270
2025-08-13,10,Primaria 1°,EduMax,160,7,153
2025-08-13,10,Primaria 1°,TopKids,123,4,119
2025-08-13,10,Primaria 2°,EduMax,172,10,162
2025-08-13,10,Primaria 2°,TopKids,287,13,274
2025-08-13,10,Primaria 2°,TopKids,257,2,255
2025-08-13,10,Primaria 2°,SuperSchool,245,21,224
2025-08-13,10,Primaria 2°,EduMax,78,17,61
2025-08-13,10,Primaria 2°,EduMax,204,21,183
2025-08-13,10,Primaria 2°,SuperSchool,192,12,180
2025-08-13,10,Primaria 2°,TopKids,198,9,189
2025-08-13,10,Primaria 2°,EduMax,94,6,88
2025-08-13,10,Primaria 2°,TopKids,213,20,193
2025-08-13,10,Primaria 2°,SuperSchool,100,3,97
2025-08-13,10,Primaria 2°,SuperSchool,63,17,46
2025-08-13,10,Primaria 2°,SuperSchool,282,1,281
2025-08-13,10,Primaria 3°,SuperSchool,289,18,271
2025-08-13,10,Primaria 3°,EduMax,63,22,41
2025-08-13,10,Primaria 3°,TopKids,236,17,219
2025-08-13,10,Primaria 3°,TopKids,147,8,139
2025-08-13,10,Primaria 3°,SuperSchool,174,2,172
2025-08-13,10,Primaria 3°,EduMax,267,9,258
2025-08-13,10,Primaria 3°,EduMax,133,21,112
2025-08-13,10,Primaria 3°,SuperSchool,74,6,68
2025-08-13,10,Primaria 3°,EduMax,221,9,212
2025-08-13,10,Primaria 3°,TopKids,239,12,227
2025-08-13,10,Primaria 3°,EduMax,106,5,101
2025-08-13,10,Primaria 3°,SuperSchool,125,24,101
2025-08-13,10,Primaria 3°,EduMax,69,9,60
2025-08-13,10,Primaria 4°,TopKids,78,19,59
2025-08-13,10,Primaria 4°,TopKids,284,21,263
2025-08-13,10,Primaria 4°,TopKids,162,7,155
2025-08-13,10,Primaria 4°,EduMax,123,23,100
2025-08-13,10,Primaria 4°,TopKids,143,2,141
2025-08-13,10,Primaria 4°,SuperSchool,181,18,163
2025-08-13,10,Primaria 4°,TopKids,146,2,144
2025-08-13,10,Primaria 4°,EduMax,149,3,146
2025-08-13,10,Primaria 4°,SuperSchool,205,14,191
2025-08-13,10,Primaria 4°,EduMax,161,11,150
2025-08-13,10,Primaria 4°,SuperSchool,254,1,253
2025-08-13,10,Primaria 5°,TopKids,243,2,241
2025-08-13,10,Primaria 5°,SuperSchool,142,5,137
2025-08-13,10,Primaria 5°,EduMax,299,3,296
2025-08-13,10,Primaria 5°,EduMax,229,18,211
2025-08-13,10,Primaria 5°,SuperSchool,240,21,219
2025-08-13,10,Primaria 5°,SuperSchool,76,10,66
2025-08-13,10,Primaria 5°,SuperSchool,55,11,44
2025-08-13,10,Primaria 5°,EduMax,280,20,260
2025-08-13,10,Primaria 5°,TopKids,230,21,209
2025-08-13,10,Primaria 5°,SuperSchool,67,21,46
2025-08-13,10,Primaria 5°,TopKids,53,13,40
2025-08-13,10,Primaria 5°,EduMax,165,24,141
2025-08-13,10,Primaria 5°,SuperSchool,240,19,221
2025-08-13,10,Primaria 6°,SuperSchool,215,19,196
2025-08-13,10,Primaria 6°,SuperSchool,217,17,200
2025-08-13,10,Primaria 6°,SuperSchool,135,15,120
2025-08-13,10,Primaria 6°,EduMax,280,16,264
2025-08-13,10,Primaria 6°,TopKids,209,17,192
2025-08-13,11,Preescolar,SuperSchool,81,4,77
2025-08-13,11,Preescolar,SuperSchool,242,1,241
2025-08-13,11,Preescolar,TopKids,250,1,249
2025-08-13,11,Preescolar,EduMax,103,15,88
2025-08-13,11,Preescolar,EduMax,115,9,106
2025-08-13,11,Preescolar,SuperSchool,72,22,50
2025-08-13,11,Preescolar,TopKids,286,11,275
2025-08-13,11,Preescolar,TopKids,121,7,114
2025-08-13,11,Kínder,TopKids,194,18,176
2025-08-13,11,Kínder,TopKids,192,17,175
2025-08-13,11,Kínder,TopKids,118,16,102
2025-08-13,11,Kínder,TopKids,91,14,77
2025-08-13,11,Kínder,EduMax,97,19,78
2025-08-13,11,Kínder,TopKids,187,5,182
2025-08-13,11,Kínder,SuperSchool,203,22,181
2025-08-13,11,Kínder,TopKids,111,13,98
2025-08-13,11,Kínder,SuperSchool,290,20,270
2025-08-13,11,Kínder,SuperSchool,278,24,254
2025-08-13,11,Kínder,SuperSchool,197,16,181
2025-08-13,11,Kínder,EduMax,157,9,148
2025-08-13,11,Kínder,SuperSchool,290,17,273
2025-08-13,11,Primaria 1°,EduMax,68,7,61
2025-08-13,11,Primaria 1°,TopKids,244,1,243
2025-08-13,11,Primaria 1°,TopKids,60,10,50
2025-08-13,11,Primaria 1°,EduMax,267,4,263
2025-08-13,11,Primaria 1°,SuperSchool,258,8,250
2025-08-13,11,Primaria 1°,TopKids,223,24,199
2025-08-13,11,Primaria 1°,SuperSchool,53,6,47
2025-08-13,11,Primaria 1°,TopKids,78,19,59
2025-08-13,11,Primaria 2°,SuperSchool,297,4,293
2025-08-13,11,Primaria 2°,TopKids,165,6,159
2025-08-13,11,Primaria 2°,TopKids,72,7,65
2025-08-13,11,Primaria 2°,EduMax,221,16,205
2025-08-13,11,Primaria 2°,TopKids,115,13,102
2025-08-13,11,Primaria 2°,SuperSchool,262,20,242
2025-08-13,11,Primaria 2°,SuperSchool,161,20,141
2025-08-13,11,Primaria 2°,EduMax,268,4,264
2025-08-13,11,Primaria 2°,TopKids,232,21,211
2025-08-13,11,Primaria 2°,SuperSchool,214,15,199
2025-08-13,11,Primaria 2°,EduMax,281,7,274
2025-08-13,11,Primaria 2°,EduMax,280,22,258
2025-08-13,11,Primaria 2°,TopKids,264,18,246
2025-08-13,11,Primaria 2°,EduMax,155,18,137
2025-08-13,11,Primaria 2°,EduMax,123,7,116
2025-08-13,11,Primaria 3°,EduMax,120,7,113
2025-08-13,11,Primaria 3°,SuperSchool,114,14,100
2025-08-13,11,Primaria 3°,EduMax,190,8,182
2025-08-13,11,Primaria 3°,EduMax,209,17,192
2025-08-13,11,Primaria 3°,EduMax,128,15,113
2025-08-13,11,Primaria 3°,SuperSchool,225,8,217
2025-08-13,11,Primaria 3°,TopKids,133,15,118
2025-08-13,11,Primaria 3°,TopKids,183,8,175
2025-08-13,11,Primaria 3°,TopKids,177,16,161
2025-08-13,11,Primaria 3°,TopKids,81,13,68
2025-08-13,11,Primaria 3°,EduMax,229,15,214
2025-08-13,11,Primaria 3°,EduMax,62,24,38
2025-08-13,11,Primaria 3°,EduMax,269,11,258
2025-08-13,11,Primaria 3°,EduMax,111,24,87
2025-08-13,11,Primaria 3°,SuperSchool,238,1,237
2025-08-13,11,Primaria 3°,SuperSchool,243,13,230
2025-08-13,11,Primaria 3°,SuperSchool,81,24,57
2025-08-13,11,Primaria 3°,TopKids,53,24,29
2025-08-13,11,Primaria 4°,SuperSchool,147,21,126
2025-08-13,11,Primaria 4°,EduMax,139,20,119
2025-08-13,11,Primaria 4°,TopKids,226,5,221
2025-08-13,11,Primaria 4°,EduMax,281,12,269
2025-08-13,11,Primaria 4°,SuperSchool,72,12,60
2025-08-13,11,Primaria 4°,TopKids,178,1,177
2025-08-13,11,Primaria 4°,TopKids,177,17,160
2025-08-13,11,Primaria 4°,EduMax,258,20,238
2025-08-13,11,Primaria 4°,EduMax,218,12,206
2025-08-13,11,Primaria 4°,SuperSchool,245,7,238
2025-08-13,11,Primaria 4°,EduMax,58,23,35
2025-08-13,11,Primaria 5°,SuperSchool,133,4,129
2025-08-13,11,Primaria 5°,SuperSchool,295,10,285
2025-08-13,11,Primaria 5°,EduMax,268,21,247
2025-08-13,11,Primaria 5°,TopKids,276,23,253
2025-08-13,11,Primaria 5°,SuperSchool,66,21,45
2025-08-13,11,Primaria 6°,SuperSchool,180,4,176
2025-08-13,11,Primaria 6°,TopKids,269,7,262
2025-08-13,11,Primaria 6°,EduMax,252,24,228
2025-08-13,11,Primaria 6°,TopKids,59,5,54
2025-08-13,11,Primaria 6°,SuperSchool,174,12,162
2025-08-13,11,Primaria 6°,EduMax,88,19,69
2025-08-13,11,Primaria 6°,TopKids,68,12,56
2025-08-13,11,Primaria 6°,EduMax,224,5,219
2025-08-13,11,Primaria 6°,EduMax,95,12,83
2025-08-13,11,Primaria 6°,SuperSchool,198,11,187
2025-08-13,11,Primaria 6°,SuperSchool,97,18,79
2025-08-13,11,Primaria 6°,TopKids,268,5,263
2025-08-13,11,Primaria 6°,TopKids,61,23,38
2025-08-13,11,Primaria 6°,EduMax,238,6,232
2025-08-13,11,Primaria 6°,TopKids,230,4,226
2025-08-13,11,Primaria 6°,EduMax,271,13,258
2025-08-13,12,Preescolar,TopKids,98,14,84
2025-08-13,12,Preescolar,TopKids,185,23,162
2025-08-13,12,Preescolar,EduMax,84,17,67
2025-08-13,12,Preescolar,TopKids,62,16,46
2025-08-13,12,Preescolar,SuperSchool,149,10,139
2025-08-13,12,Preescolar,SuperSchool,208,10,198
2025-08-13,12,Preescolar,EduMax,75,22,53
2025-08-13,12,Preescolar,TopKids,274,21,253
2025-08-13,12,Preescolar,EduMax,101,20,81
2025-08-13,12,Preescolar,TopKids,154,8,146
2025-08-13,12,Preescolar,TopKids,254,14,240
2025-08-13,12,Preescolar,SuperSchool,263,18,245
2025-08-13,12,Preescolar,SuperSchool,220,16,204
2025-08-13,12,Preescolar,EduMax,212,21,191
2025-08-13,12,Kínder,TopKids,117,22,95
2025-08-13,12,Kínder,SuperSchool,187,20,167
2025-08-13,12,Kínder,SuperSchool,145,2,143
2025-08-13,12,Kínder,TopKids,118,5,113
2025-08-13,12,Kínder,TopKids,136,1,135
2025-08-13,12,Kínder,TopKids,241,21,220
2025-08-13,12,Primaria 1°,TopKids,157,16,141
2025-08-13,12,Primaria 1°,SuperSchool,102,10,92
2025-08-13,12,Primaria 1°,SuperSchool,162,18,144
2025-08-13,12,Primaria 1°,EduMax,144,4,140
2025-08-13,12,Primaria 1°,TopKids,188,17,171
2025-08-13,12,Primaria 1°,EduMax,247,9,238
2025-08-13,12,Primaria 1°,SuperSchool,133,21,112
2025-08-13,12,Primaria 1°,SuperSchool,269,23,246
2025-08-13,12,Primaria 1°,TopKids,69,8,61
2025-08-13,12,Primaria 1°,EduMax,134,23,111
2025-08-13,12,Primaria 1°,EduMax,52,5,47
2025-08-13,12,Primaria 1°,SuperSchool,56,4,52
2025-08-13,12,Primaria 2°,SuperSchool,188,15,173
2025-08-13,12,Primaria 2°,EduMax,62,22,40
2025-08-13,12,Primaria 2°,TopKids,153,6,147
2025-08-13,12,Primaria 2°,TopKids,227,22,205
2025-08-13,12,Primaria 2°,SuperSchool,205,22,183
2025-08-13,12,Primaria 2°,TopKids,244,5,239
2025-08-13,12,Primaria 2°,SuperSchool,192,3,189
2025-08-13,12,Primaria 2°,SuperSchool,282,15,267
2025-08-13,12,Primaria 2°,EduMax,275,20,255
2025-08-13,12,Primaria 2°,SuperSchool,144,19,125
2025-08-13,12,Primaria 2°,SuperSchool,220,1,219
2025-08-13,12,Primaria 3°,EduMax,256,18,238
2025-08-13,12,Primaria 3°,SuperSchool,50,11,39
2025-08-13,12,Primaria 3°,SuperSchool,200,11,189
2025-08-13,12,Primaria 3°,SuperSchool,299,2,297
2025-08-13,12,Primaria 3°,EduMax,87,8,79
2025-08-13,12,Primaria 3°,TopKids,131,16,115
2025-08-13,12,Primaria 3°,TopKids,166,12,154
2025-08-13,12,Primaria 3°,TopKids,183,3,180
2025-08-13,12,Primaria 3°,EduMax,115,11,104
2025-08-13,12,Primaria 3°,EduMax,244,18,226
2025-08-13,12,Primaria 4°,SuperSchool,265,1,264
2025-08-13,12,Primaria 4°,TopKids,86,6,80
2025-08-13,12,Primaria 4°,TopKids,285,12,273
2025-08-13,12,Primaria 4°,TopKids,79,23,56
2025-08-13,12,Primaria 4°,EduMax,184,2,182
2025-08-13,12,Primaria 4°,SuperSchool,88,11,77
2025-08-13,12,Primaria 4°,TopKids,255,3,252
2025-08-13,12,Primaria 4°,EduMax,209,11,198
2025-08-13,12,Primaria 4°,SuperSchool,289,3,286
2025-08-13,12,Primaria 4°,SuperSchool,123,21,102
2025-08-13,12,Primaria 4°,TopKids,160,8,152
2025-08-13,12,Primaria 4°,EduMax,116,7,109
2025-08-13,12,Primaria 4°,EduMax,187,20,167
2025-08-13,12,Primaria 4°,SuperSchool,95,23,72
2025-08-13,12,Primaria 4°,EduMax,124,1,123
2025-08-13,12,Primaria 4°,EduMax,204,6,198
2025-08-13,12,Primaria 4°,EduMax,75,22,53
2025-08-13,12,Primaria 4°,SuperSchool,212,2,210
2025-08-13,12,Primaria 4°,TopKids,122,19,103
2025-08-13,12,Primaria 5°,SuperSchool,195,11,184
2025-08-13,12,Primaria 5°,TopKids,259,24,235
2025-08-13,12,Primaria 5°,EduMax,184,1,183
2025-08-13,12,Primaria 5°,EduMax,131,13,118
2025-08-13,12,Primaria 5°,TopKids,135,19,116
2025-08-13,12,Primaria 5°,TopKids,228,9,219
2025-08-13,12,Primaria 5°,TopKids,200,12,188
2025-08-13,12,Primaria 6°,EduMax,291,8,283
2025-08-13,12,Primaria 6°,SuperSchool,126,8,118
2025-08-13,12,Primaria 6°,EduMax,283,17,266
2025-08-13,12,Primaria 6°,TopKids,66,23,43
2025-08-13,12,Primaria 6°,EduMax,227,24,203
2025-08-13,12,Primaria 6°,EduMax,276,19,257
2025-08-13,12,Primaria 6°,SuperSchool,198,21,177
2025-08-13,12,Primaria 6°,EduMax,102,14,88
2025-08-13,13,Preescolar,SuperSchool,279,6,273
2025-08-13,13,Preescolar,TopKids,294,10,284
2025-08-13,13,Preescolar,TopKids,84,18,66
2025-08-13,13,Preescolar,SuperSchool,196,5,191
2025-08-13,13,Preescolar,SuperSchool,188,10,178
2025-08-13,13,Preescolar,SuperSchool,85,21,64
2025-08-13,13,Preescolar,EduMax,237,18,219
2025-08-13,13,Preescolar,SuperSchool,191,8,183
2025-08-13,13,Preescolar,EduMax,100,15,85
2025-08-13,13,Preescolar,EduMax,85,1,84
2025-08-13,13,Preescolar,TopKids,134,10,124
2025-08-13,13,Preescolar,SuperSchool,273,20,253
2025-08-13,13,Preescolar,EduMax,224,4,220
2025-08-13,13,Preescolar,TopKids,207,7,200
2025-08-13,13,Preescolar,EduMax,170,18,152
2025-08-13,13,Preescolar,SuperSchool,123,24,99
2025-08-13,13,Preescolar,TopKids,187,14,173
2025-08-13,13,Kínder,TopKids,293,22,271
2025-08-13,13,Kínder,TopKids,55,21,34
2025-08-13,13,Kínder,EduMax,274,19,255
2025-08-13,13,Kínder,TopKids,137,18,119
2025-08-13,13,Kínder,TopKids,293,11,282
2025-08-13,13,Kínder,SuperSchool,132,21,111
2025-08-13,13,Kínder,EduMax,211,22,189
2025-08-13,13,Kínder,SuperSchool,59,2,57
2025-08-13,13,Kínder,SuperSchool,172,6,166
2025-08-13,13,Kínder,TopKids,172,10,162
2025-08-13,13,Kínder,SuperSchool,114,2,112
2025-08-13,13,Kínder,TopKids,186,5,181
2025-08-13,13,Kínder,EduMax,187,12,175
2025-08-13,13,Kínder,EduMax,107,21,86
2025-08-13,13,Kínder,SuperSchool,242,3,239
2025-08-13,13,Kínder,SuperSchool,138,17,121
2025-08-13,13,Kínder,SuperSchool,122,6,116
2025-08-13,13,Kínder,SuperSchool,281,21,260
2025-08-13,13,Primaria 1°,TopKids,160,7,153
2025-08-13,13,Primaria 1°,EduMax,76,8,68
2025-08-13,13,Primaria 1°,SuperSchool,77,15,62
2025-08-13,13,Primaria 1°,EduMax,248,15,233
2025-08-13,13,Primaria 1°,EduMax,135,18,117
2025-08-13,13,Primaria 1°,EduMax,295,18,277
2025-08-13,13,Primaria 1°,SuperSchool,184,3,181
2025-08-13,13,Primaria 1°,EduMax,221,14,207
2025-08-13,13,Primaria 1°,SuperSchool,213,13,200
2025-08-13,13,Primaria 1°,EduMax,182,20,162
2025-08-13,13,Primaria 1°,SuperSchool,87,6,81
2025-08-13,13,Primaria 2°,EduMax,152,24,128
2025-08-13,13,Primaria 2°,TopKids,169,16,153
2025-08-13,13,Primaria 2°,SuperSchool,267,13,254
2025-08-13,13,Primaria 2°,TopKids,267,23,244
2025-08-13,13,Primaria 2°,TopKids,178,8,170
2025-08-13,13,Primaria 2°,TopKids,181,21,160
2025-08-13,13,Primaria 3°,EduMax,164,21,143
2025-08-13,13,Primaria 3°,EduMax,86,17,69
2025-08-13,13,Primaria 3°,TopKids,68,1,67
2025-08-13,13,Primaria 3°,SuperSchool,136,1,135
2025-08-13,13,Primaria 3°,TopKids,229,9,220
2025-08-13,13,Primaria 3°,TopKids,182,7,175
2025-08-13,13,Primaria 3°,SuperSchool,299,6,293
2025-08-13,13,Primaria 3°,SuperSchool,71,17,54
2025-08-13,13,Primaria 3°,SuperSchool,253,4,249
2025-08-13,13,Primaria 3°,EduMax,121,5,116
2025-08-13,13,Primaria 3°,TopKids,214,13,201
2025-08-13,13,Primaria 3°,EduMax,284,8,276
2025-08-13,13,Primaria 3°,SuperSchool,286,5,281
2025-08-13,13,Primaria 3°,SuperSchool,153,17,136
2025-08-13,13,Primaria 3°,TopKids,136,13,123
2025-08-13,13,Primaria 3°,SuperSchool,179,19,160
2025-08-13,13,Primaria 3°,SuperSchool,80,7,73
2025-08-13,13,Primaria 3°,EduMax,235,3,232
2025-08-13,13,Primaria 4°,TopKids,105,9,96
2025-08-13,13,Primaria 4°,EduMax,110,14,96
2025-08-13,13,Primaria 4°,EduMax,171,15,156
2025-08-13,13,Primaria 4°,EduMax,50,6,44
2025-08-13,13,Primaria 4°,EduMax,128,6,122
2025-08-13,13,Primaria 4°,EduMax,242,24,218
2025-08-13,13,Primaria 4°,TopKids,66,16,50
2025-08-13,13,Primaria 5°,SuperSchool,89,17,72
2025-08-13,13,Primaria 5°,SuperSchool,239,9,230
2025-08-13,13,Primaria 5°,SuperSchool,266,19,247
2025-08-13,13,Primaria 5°,SuperSchool,231,11,220
2025-08-13,13,Primaria 5°,EduMax,95,6,89
2025-08-13,13,Primaria 5°,SuperSchool,66,2,64
2025-08-13,13,Primaria 5°,EduMax,56,4,52
2025-08-13,13,Primaria 5°,EduMax,129,9,120
2025-08-13,13,Primaria 5°,SuperSchool,176,24,152
2025-08-13,13,Primaria 5°,EduMax,178,7,171
2025-08-13,13,Primaria 5°,SuperSchool,164,8,156
2025-08-13,13,Primaria 5°,TopKids,106,3,103
2025-08-13,13,Primaria 6°,SuperSchool,152,21,131
2025-08-13,13,Primaria 6°,SuperSchool,207,1,206
2025-08-13,13,Primaria 6°,EduMax,271,22,249
2025-08-13,13,Primaria 6°,EduMax,53,23,30
2025-08-13,13,Primaria 6°,TopKids,221,12,209
2025-08-13,14,Preescolar,SuperSchool,256,10,246
2025-08-13,14,Preescolar,TopKids,168,20,148
2025-08-13,14,Preescolar,SuperSchool,253,1,252
2025-08-13,14,Preescolar,SuperSchool,59,18,41
2025-08-13,14,Preescolar,TopKids,115,17,98
2025-08-13,14,Kínder,EduMax,135,9,126
2025-08-13,14,Kínder,SuperSchool,144,20,124
2025-08-13,14,Kínder,TopKids,156,6,150
2025-08-13,14,Kínder,EduMax,210,7,203
2025-08-13,14,Kínder,SuperSchool,124,24,100
2025-08-13,14,Kínder,TopKids,161,19,142
2025-08-13,14,Kínder,EduMax,192,3,189
2025-08-13,14,Kínder,EduMax,269,7,262
2025-08-13,14,Kínder,EduMax,55,22,33
2025-08-13,14,Kínder,EduMax,148,17,131
2025-08-13,14,Kínder,TopKids,251,21,230
2025-08-13,14,Kínder,EduMax,283,3,280
2025-08-13,14,Primaria 1°,EduMax,64,17,47
2025-08-13,14,Primaria 1°,TopKids,67,19,48
2025-08-13,14,Primaria 1°,TopKids,125,24,101
2025-08-13,14,Primaria 1°,SuperSchool,201,16,185
2025-08-13,14,Primaria 1°,EduMax,64,15,49
2025-08-13,14,Primaria 1°,TopKids,279,12,267
2025-08-13,14,Primaria 1°,EduMax,204,20,184
2025-08-13,14,Primaria 1°,SuperSchool,145,4,141
2025-08-13,14,Primaria 1°,SuperSchool,102,8,94
2025-08-13,14,Primaria 1°,EduMax,155,7,148
2025-08-13,14,Primaria 1°,EduMax,95,5,90
2025-08-13,14,Primaria 1°,TopKids,182,3,179
2025-08-13,14,Primaria 2°,SuperSchool,123,5,118
2025-08-13,14,Primaria 2°,TopKids,256,18,238
2025-08-13,14,Primaria 2°,SuperSchool,57,21,36
2025-08-13,14,Primaria 2°,EduMax,71,8,63
2025-08-13,14,Primaria 2°,TopKids,273,8,265
2025-08-13,14,Primaria 2°,EduMax,68,23,45
2025-08-13,14,Primaria 2°,EduMax,230,23,207
2025-08-13,14,Primaria 2°,SuperSchool,101,15,86
2025-08-13,14,Primaria 2°,EduMax,231,12,219
2025-08-13,14,Primaria 2°,SuperSchool,184,19,165
2025-08-13,14,Primaria 2°,SuperSchool,112,24,88
2025-08-13,14,Primaria 3°,EduMax,216,19,197
2025-08-13,14,Primaria 3°,TopKids,126,24,102
2025-08-13,14,Primaria 3°,SuperSchool,264,19,245
2025-08-13,14,Primaria 3°,SuperSchool,210,18,192
2025-08-13,14,Primaria 3°,SuperSchool,209,5,204
2025-08-13,14,Primaria 3°,SuperSchool,61,9,52
2025-08-13,14,Primaria 3°,EduMax,168,11,157
2025-08-13,14,Primaria 3°,SuperSchool,196,22,174
2025-08-13,14,Primaria 3°,SuperSchool,91,2,89
2025-08-13,14,Primaria 3°,TopKids,80,20,60
2025-08-13,14,Primaria 3°,EduMax,260,6,254
2025-08-13,14,Primaria 4°,SuperSchool,185,11,174
2025-08-13,14,Primaria 4°,SuperSchool,197,20,177
2025-08-13,14,Primaria 4°,TopKids,58,8,50
2025-08-13,14,Primaria 4°,TopKids,275,24,251
2025-08-13,14,Primaria 4°,SuperSchool,154,9,145
2025-08-13,14,Primaria 4°,SuperSchool,112,8,104
2025-08-13,14,Primaria 4°,TopKids,70,5,65
2025-08-13,14,Primaria 4°,SuperSchool,212,21,191
2025-08-13,14,Primaria 4°,SuperSchool,225,16,209
2025-08-13,14,Primaria 4°,SuperSchool,272,20,252
2025-08-13,14,Primaria 4°,TopKids,247,1,246
2025-08-13,14,Primaria 4°,SuperSchool,129,15,114
2025-08-13,14,Primaria 4°,TopKids,211,10,201
2025-08-13,14,Primaria 4°,SuperSchool,173,15,158
2025-08-13,14,Primaria 5°,EduMax,265,24,241
2025-08-13,14,Primaria 5°,SuperSchool,141,1,140
2025-08-13,14,Primaria 5°,SuperSchool,77,4,73
2025-08-13,14,Primaria 5°,SuperSchool,267,19,248
2025-08-13,14,Primaria 5°,TopKids,98,10,88
2025-08-13,14,Primaria 5°,SuperSchool,248,12,236
2025-08-13,14,Primaria 5°,TopKids,153,17,136
2025-08-13,14,Primaria 5°,SuperSchool,176,14,162
2025-08-13,14,Primaria 5°,EduMax,97,17,80
2025-08-13,14,Primaria 5°,TopKids,168,1,167
2025-08-13,14,Primaria 6°,EduMax,291,4,287
2025-08-13,14,Primaria 6°,TopKids,196,19,177
2025-08-13,14,Primaria 6°,EduMax,118,19,99
2025-08-13,14,Primaria 6°,TopKids,88,5,83
2025-08-13,14,Primaria 6°,TopKids,224,12,212
2025-08-13,14,Primaria 6°,EduMax,112,12,100
2025-08-13,14,Primaria 6°,EduMax,290,19,271
2025-08-13,14,Primaria 6°,TopKids,83,16,67
2025-08-13,14,Primaria 6°,SuperSchool,98,18,80
2025-08-13,14,Primaria 6°,SuperSchool,238,13,225
2025-08-13,14,Primaria 6°,SuperSchool,266,24,242
2025-08-13,14,Primaria 6°,SuperSchool,241,6,235
2025-08-13,14,Primaria 6°,SuperSchool,59,5,54
2025-08-13,14,Primaria 6°,SuperSchool,264,11,253
2025-08-13,14,Primaria 6°,TopKids,163,21,142
2025-08-13,15,Preescolar,SuperSchool,59,15,44
2025-08-13,15,Preescolar,TopKids,192,12,180
2025-08-13,15,Preescolar,EduMax,239,6,233
2025-08-13,15,Preescolar,SuperSchool,115,12,103
2025-08-13,15,Preescolar,EduMax,181,23,158
2025-08-13,15,Preescolar,SuperSchool,258,16,242
2025-08-13,15,Preescolar,SuperSchool,267,1,266
2025-08-13,15,Preescolar,TopKids,61,5,56
2025-08-13,15,Kínder,EduMax,69,2,67
2025-08-13,15,Kínder,TopKids,215,22,193
2025-08-13,15,Kínder,SuperSchool,227,20,207
2025-08-13,15,Kínder,EduMax,146,15,131
2025-08-13,15,Kínder,EduMax,291,14,277
2025-08-13,15,Kínder,TopKids,142,15,127
2025-08-13,15,Kínder,TopKids,182,24,158
2025-08-13,15,Kínder,TopKids,135,3,132
2025-08-13,15,Kínder,EduMax,248,6,242
2025-08-13,15,Kínder,EduMax,167,1,166
2025-08-13,15,Kínder,TopKids,56,4,52
2025-08-13,15,Primaria 1°,TopKids,202,18,184
2025-08-13,15,Primaria 1°,SuperSchool,196,22,174
2025-08-13,15,Primaria 1°,SuperSchool,90,15,75
2025-08-13,15,Primaria 1°,EduMax,241,8,233
2025-08-13,15,Primaria 1°,TopKids,256,18,238
2025-08-13,15,Primaria 1°,TopKids,71,18,53
2025-08-13,15,Primaria 1°,EduMax,85,20,65
2025-08-13,15,Primaria 1°,TopKids,169,23,146
2025-08-13,15,Primaria 1°,EduMax,276,5,271
2025-08-13,15,Primaria 1°,EduMax,292,24,268
2025-08-13,15,Primaria 1°,EduMax,83,2,81
2025-08-13,15,Primaria 1°,EduMax,105,23,82
2025-08-13,15,Primaria 1°,EduMax,202,20,182
2025-08-13,15,Primaria 1°,SuperSchool,102,14,88
2025-08-13,15,Primaria 1°,TopKids,285,11,274
2025-08-13,15,Primaria 1°,TopKids,239,7,232
2025-08-13,15,Primaria 2°,SuperSchool,240,2,238
2025-08-13,15,Primaria 2°,EduMax,65,23,42
2025-08-13,15,Primaria 2°,EduMax,288,11,277
2025-08-13,15,Primaria 2°,SuperSchool,215,13,202
2025-08-13,15,Primaria 2°,EduMax,228,10,218
2025-08-13,15,Primaria 2°,TopKids,207,5,202
2025-08-13,15,Primaria 2°,SuperSchool,172,21,151
2025-08-13,15,Primaria 2°,TopKids,280,11,269
2025-08-13,15,Primaria 2°,EduMax,200,21,179
2025-08-13,15,Primaria 2°,EduMax,134,23,111
2025-08-13,15,Primaria 2°,TopKids,53,1,52
2025-08-13,15,Primaria 2°,EduMax,110,15,95
2025-08-13,15,Primaria 2°,EduMax,132,5,127
2025-08-13,15,Primaria 2°,TopKids,286,18,268
2025-08-13,15,Primaria 2°,TopKids,168,21,147
2025-08-13,15,Primaria 2°,TopKids,79,23,56
2025-08-13,15,Primaria 3°,SuperSchool,90,13,77
2025-08-13,15,Primaria 3°,EduMax,268,16,252
2025-08-13,15,Primaria 3°,EduMax,126,4,122
2025-08-13,15,Primaria 3°,SuperSchool,222,21,201
2025-08-13,15,Primaria 3°,TopKids,222,15,207
2025-08-13,15,Primaria 3°,SuperSchool,232,5,227
2025-08-13,15,Primaria 3°,EduMax,295,6,289
2025-08-13,15,Primaria 3°,EduMax,75,5,70
2025-08-13,15,Primaria 3°,SuperSchool,142,5,137
2025-08-13,15,Primaria 3°,SuperSchool,190,24,166
2025-08-13,15,Primaria 3°,TopKids,69,23,46
2025-08-13,15,Primaria 3°,SuperSchool,198,19,179
2025-08-13,15,Primaria 3°,TopKids,238,20,218
2025-08-13,15,Primaria 4°,EduMax,103,10,93
2025-08-13,15,Primaria 4°,TopKids,214,9,205
2025-08-13,15,Primaria 4°,SuperSchool,60,19,41
2025-08-13,15,Primaria 4°,EduMax,87,23,64
2025-08-13,15,Primaria 4°,SuperSchool,114,3,111
2025-08-13,15,Primaria 4°,TopKids,205,14,191
2025-08-13,15,Primaria 4°,EduMax,235,22,213
2025-08-13,15,Primaria 4°,SuperSchool,162,15,147
2025-08-13,15,Primaria 4°,EduMax,255,14,241
2025-08-13,15,Primaria 4°,SuperSchool,236,17,219
2025-08-13,15,Primaria 4°,TopKids,81,9,72
2025-08-13,15,Primaria 4°,TopKids,94,13,81
2025-08-13,15,Primaria 4°,TopKids,297,19,278
2025-08-13,15,Primaria 4°,EduMax,102,19,83
2025-08-13,15,Primaria 4°,SuperSchool,289,9,280
2025-08-13,15,Primaria 4°,TopKids,269,20,249
2025-08-13,15,Primaria 4°,EduMax,52,19,33
2025-08-13,15,Primaria 4°,SuperSchool,185,14,171
2025-08-13,15,Primaria 4°,TopKids,201,13,188
2025-08-13,15,Primaria 5°,SuperSchool,121,19,102
2025-08-13,15,Primaria 5°,EduMax,208,18,190
2025-08-13,15,Primaria 5°,EduMax,131,7,124
2025-08-13,15,Primaria 5°,EduMax,97,16,81
2025-08-13,15,Primaria 5°,TopKids,169,1,168
2025-08-13,15,Primaria 5°,TopKids,177,3,174
2025-08-13,15,Primaria 5°,EduMax,53,4,49
2025-08-13,15,Primaria 5°,EduMax,58,8,50
2025-08-13,15,Primaria 5°,TopKids,194,17,177
2025-08-13,15,Primaria 5°,SuperSchool,69,14,55
2025-08-13,15,Primaria 5°,EduMax,229,11,218
2025-08-13,15,Primaria 5°,TopKids,265,8,257
2025-08-13,15,Primaria 5°,EduMax,138,10,128
2025-08-13,15,Primaria 5°,SuperSchool,206,8,198
2025-08-13,15,Primaria 5°,EduMax,242,20,222
2025-08-13,15,Primaria 6°,TopKids,201,9,192
2025-08-13,15,Primaria 6°,EduMax,203,9,194
2025-08-13,15,Primaria 6°,TopKids,85,10,75
2025-08-13,15,Primaria 6°,EduMax,122,22,100
2025-08-13,15,Primaria 6°,SuperSchool,118,9,109
2025-08-13,15,Primaria 6°,SuperSchool,279,19,260
2025-08-13,15,Primaria 6°,EduMax,156,13,143
2025-08-13,15,Primaria 6°,TopKids,285,5,280
2025-08-13,15,Primaria 6°,EduMax,251,24,227
2025-08-13,16,Preescolar,SuperSchool,218,9,209
2025-08-13,16,Preescolar,EduMax,91,2,89
2025-08-13,16,Preescolar,SuperSchool,63,17,46
2025-08-13,16,Preescolar,SuperSchool,70,24,46
2025-08-13,16,Preescolar,EduMax,259,13,246
2025-08-13,16,Preescolar,EduMax,209,12,197
2025-08-13,16,Preescolar,SuperSchool,168,24,144
2025-08-13,16,Preescolar,SuperSchool,210,20,190
2025-08-13,16,Preescolar,TopKids,195,3,192
2025-08-13,16,Preescolar,TopKids,138,13,125
2025-08-13,16,Preescolar,TopKids,59,15,44
2025-08-13,16,Kínder,EduMax,164,3,161
2025-08-13,16,Kínder,EduMax,216,8,208
2025-08-13,16,Kínder,SuperSchool,273,11,262
2025-08-13,16,Kínder,SuperSchool,199,20,179
2025-08-13,16,Kínder,EduMax,238,11,227
2025-08-13,16,Kínder,SuperSchool,78,10,68
2025-08-13,16,Kínder,SuperSchool,80,21,59
2025-08-13,16,Kínder,EduMax,177,6,171
2025-08-13,16,Primaria 1°,SuperSchool,181,2,179
2025-08-13,16,Primaria 1°,TopKids,247,24,223
2025-08-13,16,Primaria 1°,EduMax,121,21,100
2025-08-13,16,Primaria 1°,SuperSchool,299,14,285
2025-08-13,16,Primaria 1°,SuperSchool,212,16,196
2025-08-13,16,Primaria 1°,TopKids,120,15,105
2025-08-13,16,Primaria 1°,SuperSchool,183,15,168
2025-08-13,16,Primaria 1°,SuperSchool,117,22,95
2025-08-13,16,Primaria 1°,TopKids,71,14,57
2025-08-13,16,Primaria 1°,TopKids,173,12,161
2025-08-13,16,Primaria 1°,TopKids,263,10,253
2025-08-13,16,Primaria 1°,EduMax,298,9,289
2025-08-13,16,Primaria 1°,EduMax,277,9,268
2025-08-13,16,Primaria 2°,EduMax,94,20,74
2025-08-13,16,Primaria 2°,EduMax,269,19,250
2025-08-13,16,Primaria 2°,TopKids,298,16,282
2025-08-13,16,Primaria 2°,TopKids,155,8,147
2025-08-13,16,Primaria 2°,SuperSchool,123,18,105
2025-08-13,16,Primaria 2°,TopKids,92,18,74
2025-08-13,16,Primaria 2°,TopKids,281,14,267
2025-08-13,16,Primaria 2°,EduMax,96,14,82
2025-08-13,16,Primaria 2°,TopKids,251,15,236
2025-08-13,16,Primaria 2°,TopKids,270,10,260
2025-08-13,16,Primaria 2°,EduMax,130,19,111
2025-08-13,16,Primaria 2°,SuperSchool,162,12,150
2025-08-13,16,Primaria 2°,TopKids,177,12,165
2025-08-13,16,Primaria 2°,SuperSchool,238,9,229
2025-08-13,16,Primaria 2°,SuperSchool,53,12,41
2025-08-13,16,Primaria 2°,SuperSchool,234,3,231
2025-08-13,16,Primaria 2°,SuperSchool,244,18,226
2025-08-13,16,Primaria 2°,SuperSchool,237,10,227
2025-08-13,16,Primaria 2°,EduMax,137,11,126
2025-08-13,16,Primaria 3°,TopKids,264,23,241
2025-08-13,16,Primaria 3°,EduMax,154,19,135
2025-08-13,16,Primaria 3°,EduMax,109,19,90
2025-08-13,16,Primaria 3°,EduMax,64,24,40
2025-08-13,16,Primaria 3°,SuperSchool,212,5,207
2025-08-13,16,Primaria 3°,TopKids,204,24,180
2025-08-13,16,Primaria 3°,TopKids,55,14,41
2025-08-13,16,Primaria 3°,SuperSchool,82,17,65
2025-08-13,16,Primaria 3°,SuperSchool,159,10,149
2025-08-13,16,Primaria 3°,EduMax,249,8,241
2025-08-13,16,Primaria 3°,EduMax,248,6,242
2025-08-13,16,Primaria 3°,SuperSchool,128,15,113
2025-08-13,16,Primaria 4°,TopKids,168,5,163
2025-08-13,16,Primaria 4°,SuperSchool,277,17,260
2025-08-13,16,Primaria 4°,SuperSchool,101,14,87
2025-08-13,16,Primaria 4°,EduMax,78,8,70
2025-08-13,16,Primaria 4°,EduMax,153,1,152
2025-08-13,16,Primaria 5°,TopKids,214,5,209
2025-08-13,16,Primaria 5°,SuperSchool,273,20,253
2025-08-13,16,Primaria 5°,TopKids,61,20,41
2025-08-13,16,Primaria 5°,SuperSchool,184,17,167
2025-08-13,16,Primaria 5°,TopKids,275,11,264
2025-08-13,16,Primaria 5°,TopKids,66,3,63
2025-08-13,16,Primaria 5°,SuperSchool,71,6,65
2025-08-13,16,Primaria 5°,EduMax,156,18,138
2025-08-13,16,Primaria 5°,EduMax,295,10,285
2025-08-13,16,Primaria 5°,SuperSchool,207,23,184
2025-08-13,16,Primaria 5°,TopKids,262,24,238
2025-08-13,16,Primaria 5°,EduMax,295,15,280
2025-08-13,16,Primaria 5°,SuperSchool,69,23,46
2025-08-13,16,Primaria 5°,SuperSchool,70,1,69
2025-08-13,16,Primaria 5°,TopKids,66,19,47
2025-08-13,16,Primaria 5°,TopKids,63,19,44
2025-08-13,16,Primaria 5°,EduMax,173,2,171
2025-08-13,16,Primaria 6°,SuperSchool,98,6,92
2025-08-13,16,Primaria 6°,SuperSchool,167,5,162
2025-08-13,16,Primaria 6°,TopKids,146,13,133
2025-08-13,16,Primaria 6°,TopKids,167,1,166
2025-08-13,16,Primaria 6°,SuperSchool,220,7,213
2025-08-13,16,Primaria 6°,TopKids,107,1,106
2025-08-13,16,Primaria 6°,SuperSchool,222,14,208
2025-08-13,16,Primaria 6°,SuperSchool,235,24,211
2025-08-13,16,Primaria 6°,EduMax,264,24,240
2025-08-13,16,Primaria 6°,SuperSchool,151,22,129
2025-08-14,9,Preescolar,EduMax,166,8,158
2025-08-14,9,Preescolar,SuperSchool,163,23,140
2025-08-14,9,Preescolar,TopKids,213,17,196
2025-08-14,9,Preescolar,SuperSchool,86,3,83
2025-08-14,9,Preescolar,TopKids,54,14,40
2025-08-14,9,Preescolar,TopKids,101,17,84
2025-08-14,9,Preescolar,EduMax,172,10,162
2025-08-14,9,Preescolar,EduMax,273,23,250
2025-08-14,9,Preescolar,SuperSchool,159,20,139
2025-08-14,9,Preescolar,SuperSchool,192,12,180
2025-08-14,9,Preescolar,EduMax,235,22,213
2025-08-14,9,Preescolar,EduMax,101,6,95
2025-08-14,9,Preescolar,TopKids,235,23,212
2025-08-14,9,Preescolar,SuperSchool,260,22,238
2025-08-14,9,Preescolar,SuperSchool,144,12,132
2025-08-14,9,Kínder,TopKids,205,3,202
2025-08-14,9,Kínder,EduMax,67,19,48
2025-08-14,9,Kínder,SuperSchool,109,10,99
2025-08-14,9,Kínder,SuperSchool,64,19,45
2025-08-14,9,Kínder,SuperSchool,245,15,230
2025-08-14,9,Kínder,TopKids,97,8,89
2025-08-14,9,Kínder,SuperSchool,294,1,293
2025-08-14,9,Kínder,TopKids,102,18,84
2025-08-14,9,Primaria 1°,EduMax,146,15,131
2025-08-14,9,Primaria 1°,TopKids,141,17,124
2025-08-14,9,Primaria 1°,TopKids,156,6,150
2025-08-14,9,Primaria 1°,TopKids,151,15,136
2025-08-14,9,Primaria 1°,TopKids,220,17,203
2025-08-14,9,Primaria 1°,TopKids,195,22,173
2025-08-14,9,Primaria 1°,SuperSchool,169,21,148
2025-08-14,9,Primaria 1°,EduMax,164,8,156
2025-08-14,9,Primaria 1°,SuperSchool,270,11,259
2025-08-14,9,Primaria 1°,SuperSchool,180,23,157
2025-08-14,9,Primaria 1°,TopKids,287,9,278
2025-08-14,9,Primaria 1°,SuperSchool,146,1,145
2025-08-14,9,Primaria 1°,EduMax,269,12,257
2025-08-14,9,Primaria 1°,TopKids,80,21,59
2025-08-14,9,Primaria 1°,SuperSchool,261,12,249
2025-08-14,9,Primaria 1°,SuperSchool,192,2,190
2025-08-14,9,Primaria 2°,EduMax,159,15,144
2025-08-14,9,Primaria 2°,SuperSchool,179,17,162
2025-08-14,9,Primaria 2°,EduMax,176,10,166
2025-08-14,9,Primaria 2°,SuperSchool,80,2,78
2025-08-14,9,Primaria 2°,EduMax,68,17,51
2025-08-14,9,Primaria 2°,TopKids,290,10,280
2025-08-14,9,Primaria 3°,TopKids,205,6,199
2025-08-14,9,Primaria 3°,TopKids,291,20,271
2025-08-14,9,Primaria 3°,EduMax,114,3,111
2025-08-14,9,Primaria 3°,TopKids,229,10,219
2025-08-14,9,Primaria 3°,SuperSchool,86,15,71
2025-08-14,9,Primaria 3°,TopKids,255,15,240
2025-08-14,9,Primaria 4°,SuperSchool,93,7,86
2025-08-14,9,Primaria 4°,SuperSchool,74,24,50
2025-08-14,9,Primaria 4°,EduMax,170,8,162
2025-08-14,9,Primaria 4°,EduMax,229,16,213
2025-08-14,9,Primaria 4°,SuperSchool,187,16,171
2025-08-14,9,Primaria 4°,EduMax,250,3,247
2025-08-14,9,Primaria 4°,TopKids,109,19,90
2025-08-14,9,Primaria 4°,TopKids,87,6,81
2025-08-14,9,Primaria 4°,TopKids,270,15,255
2025-08-14,9,Primaria 4°,SuperSchool,295,5,290
2025-08-14,9,Primaria 4°,EduMax,102,2,100
2025-08-14,9,Primaria 4°,EduMax,72,12,60
2025-08-14,9,Primaria 4°,EduMax,196,24,172
2025-08-14,9,Primaria 4°,TopKids,140,20,120
2025-08-14,9,Primaria 5°,SuperSchool,138,14,124
2025-08-14,9,Primaria 5°,TopKids,272,18,254
2025-08-14,9,Primaria 5°,TopKids,113,22,91
2025-08-14,9,Primaria 5°,TopKids,182,22,160
2025-08-14,9,Primaria 5°,EduMax,249,6,243
2025-08-14,9,Primaria 5°,SuperSchool,96,12,84
2025-08-14,9,Primaria 5°,SuperSchool,202,6,196
2025-08-14,9,Primaria 5°,TopKids,285,9,276
2025-08-14,9,Primaria 5°,TopKids,102,2,100
2025-08-14,9,Primaria 5°,SuperSchool,126,8,118
2025-08-14,9,Primaria 5°,TopKids,254,4,250
2025-08-14,9,Primaria 5°,EduMax,279,21,258
2025-08-14,9,Primaria 6°,SuperSchool,184,15,169
2025-08-14,9,Primaria 6°,SuperSchool,91,23,68
2025-08-14,9,Primaria 6°,EduMax,154,15,139
2025-08-14,9,Primaria 6°,SuperSchool,153,16,137
2025-08-14,9,Primaria 6°,SuperSchool,195,20,175
2025-08-14,9,Primaria 6°,EduMax,51,23,28
2025-08-14,9,Primaria 6°,TopKids,143,3,140
2025-08-14,9,Primaria 6°,EduMax,280,15,265
2025-08-14,9,Primaria 6°,SuperSchool,50,9,41
2025-08-14,9,Primaria 6°,EduMax,270,14,256
2025-08-14,9,Primaria 6°,SuperSchool,222,6,216
2025-08-14,9,Primaria 6°,EduMax,114,21,93
2025-08-14,9,Primaria 6°,SuperSchool,53,3,50
2025-08-14,9,Primaria 6°,SuperSchool,79,2,77
2025-08-14,9,Primaria 6°,TopKids,69,23,46
2025-08-14,9,Primaria 6°,EduMax,281,15,266
2025-08-14,10,Preescolar,TopKids,229,2,227
2025-08-14,10,Preescolar,SuperSchool,106,15,91
2025-08-14,10,Preescolar,TopKids,251,14,237
2025-08-14,10,Preescolar,TopKids,295,14,281
2025-08-14,10,Preescolar,TopKids,82,20,62
2025-08-14,10,Preescolar,SuperSchool,83,19,64
2025-08-14,10,Preescolar,EduMax,53,4,49
2025-08-14,10,Preescolar,SuperSchool,107,9,98
2025-08-14,10,Preescolar,TopKids,257,18,239
2025-08-14,10,Preescolar,TopKids,165,20,145
2025-08-14,10,Kínder,EduMax,239,22,217
2025-08-14,10,Kínder,TopKids,124,10,114
2025-08-14,10,Kínder,SuperSchool,192,21,171
2025-08-14,10,Kínder,TopKids,53,13,40
2025-08-14,10,Kínder,SuperSchool,90,14,76
2025-08-14,10,Kínder,TopKids,280,16,264
2025-08-14,10,Kínder,EduMax,112,20,92
2025-08-14,10,Kínder,SuperSchool,80,10,70
2025-08-14,10,Kínder,EduMax,156,7,149
2025-08-14,10,Kínder,EduMax,69,18,51
2025-08-14,10,Kínder,TopKids,135,12,123
2025-08-14,10,Kínder,EduMax,113,2,111
2025-08-14,10,Kínder,TopKids,114,23,91
2025-08-14,10,Kínder,EduMax,166,1,165
2025-08-14,10,Primaria 1°,TopKids,290,9,281
2025-08-14,10,Primaria 1°,TopKids,248,17,231
2025-08-14,10,Primaria 1°,TopKids,161,5,156
2025-08-14,10,Primaria 1°,EduMax,240,1,239
2025-08-14,10,Primaria 1°,TopKids,124,20,104
2025-08-14,10,Primaria 1°,SuperSchool,113,8,105
2025-08-14,10,Primaria 1°,SuperSchool,125,1,124
2025-08-14,10,Primaria 1°,TopKids,138,18,120
2025-08-14,10,Primaria 1°,EduMax,219,14,205
2025-08-14,10,Primaria 1°,SuperSchool,75,8,67
2025-08-14,10,Primaria 2°,TopKids,231,22,209
2025-08-14,10,Primaria 2°,EduMax,132,12,120
2025-08-14,10,Primaria 2°,TopKids,109,7,102
2025-08-14,10,Primaria 2°,TopKids,85,21,64
2025-08-14,10,Primaria 2°,SuperSchool,167,16,151
2025-08-14,10,Primaria 2°,EduMax,240,13,227
2025-08-14,10,Primaria 2°,SuperSchool,267,21,246
2025-08-14,10,Primaria 2°,EduMax,64,15,49
2025-08-14,10,Primaria 2°,EduMax,220,8,212
2025-08-14,10,Primaria 2°,SuperSchool,198,17,181
2025-08-14,10,Primaria 2°,SuperSchool,290,24,266
2025-08-14,10,Primaria 2°,EduMax,237,18,219
2025-08-14,10,Primaria 2°,SuperSchool,80,15,65
2025-08-14,10,Primaria 2°,EduMax,51,10,41
2025-08-14,10,Primaria 2°,TopKids,143,8,135
2025-08-14,10,Primaria 3°,TopKids,253,19,234
2025-08-14,10,Primaria 3°,EduMax,141,15,126
2025-08-14,10,Primaria 3°,EduMax,225,14,211
2025-08-14,10,Primaria 3°,TopKids,99,22,77
2025-08-14,10,Primaria 3°,EduMax,226,23,203
2025-08-14,10,Primaria 3°,EduMax,127,20,107
2025-08-14,10,Primaria 3°,SuperSchool,140,3,137
2025-08-14,10,Primaria 3°,SuperSchool,238,24,214
2025-08-14,10,Primaria 4°,SuperSchool,222,8,214
2025-08-14,10,Primaria 4°,SuperSchool,244,13,231
2025-08-14,10,Primaria 4°,EduMax,243,20,223
2025-08-14,10,Primaria 4°,EduMax,230,15,215
2025-08-14,10,Primaria 4°,SuperSchool,81,10,71
2025-08-14,10,Primaria 4°,SuperSchool,240,6,234
2025-08-14,10,Primaria 5°,TopKids,248,13,235
2025-08-14,10,Primaria 5°,SuperSchool,162,1,161
2025-08-14,10,Primaria 5°,EduMax,142,3,139
2025-08-14,10,Primaria 5°,EduMax,73,1,72
2025-08-14,10,Primaria 5°,EduMax,62,4,58
2025-08-14,10,Primaria 5°,SuperSchool,191,4,187
2025-08-14,10,Primaria 5°,EduMax,217,23,194
2025-08-14,10,Primaria 6°,TopKids,112,7,105
2025-08-14,10,Primaria 6°,EduMax,148,2,146
2025-08-14,10,Primaria 6°,TopKids,122,15,107
2025-08-14,10,Primaria 6°,SuperSchool,175,7,168
2025-08-14,10,Primaria 6°,EduMax,256,18,238
2025-08-14,10,Primaria 6°,TopKids,189,23,166
2025-08-14,10,Primaria 6°,SuperSchool,113,8,105
2025-08-14,11,Preescolar,EduMax,179,5,174
2025-08-14,11,Preescolar,TopKids,274,22,252
2025-08-14,11,Preescolar,EduMax,264,13,251
2025-08-14,11,Preescolar,TopKids,177,11,166
2025-08-14,11,Preescolar,SuperSchool,121,7,114
2025-08-14,11,Preescolar,SuperSchool,114,6,108
2025-08-14,11,Preescolar,TopKids,161,15,146
2025-08-14,11,Preescolar,EduMax,275,23,252
2025-08-14,11,Preescolar,SuperSchool,137,15,122
2025-08-14,11,Preescolar,TopKids,117,12,105
2025-08-14,11,Preescolar,SuperSchool,66,6,60
2025-08-14,11,Preescolar,EduMax,103,18,85
2025-08-14,11,Preescolar,TopKids,283,6,277
2025-08-14,11,Preescolar,EduMax,101,15,86
2025-08-14,11,Preescolar,SuperSchool,161,22,139
2025-08-14,11,Preescolar,TopKids,100,17,83
2025-08-14,11,Preescolar,SuperSchool,241,13,228
2025-08-14,11,Preescolar,TopKids,203,2,201
2025-08-14,11,Kínder,EduMax,62,18,44
2025-08-14,11,Kínder,EduMax,168,11,157
2025-08-14,11,Kínder,SuperSchool,164,24,140
2025-08-14,11,Kínder,SuperSchool,175,24,151
2025-08-14,11,Kínder,EduMax,182,3,179
2025-08-14,11,Kínder,TopKids,232,13,219
2025-08-14,11,Kínder,SuperSchool,93,14,79
2025-08-14,11,Kínder,EduMax,111,22,89
2025-08-14,11,Kínder,SuperSchool,290,8,282
2025-08-14,11,Kínder,EduMax,286,5,281
2025-08-14,11,Kínder,SuperSchool,103,22,81
2025-08-14,11,Kínder,SuperSchool,52,6,46
2025-08-14,11,Kínder,EduMax,224,14,210
2025-08-14,11,Kínder,TopKids,252,9,243
2025-08-14,11,Kínder,EduMax,241,15,226
2025-08-14,11,Kínder,SuperSchool,119,1,118
2025-08-14,11,Primaria 1°,TopKids,275,17,258
2025-08-14,11,Primaria 1°,TopKids,244,5,239
2025-08-14,11,Primaria 1°,SuperSchool,232,17,215
2025-08-14,11,Primaria 1°,EduMax,240,1,239
2025-08-14,11,Primaria 1°,TopKids,267,15,252
2025-08-14,11,Primaria 1°,TopKids,68,20,48
2025-08-14,11,Primaria 1°,EduMax,207,11,196
2025-08-14,11,Primaria 1°,TopKids,63,13,50
2025-08-14,11,Primaria 1°,EduMax,76,9,67
2025-08-14,11,Primaria 1°,SuperSchool,97,12,85
2025-08-14,11,Primaria 1°,EduMax,55,18,37
2025-08-14,11,Primaria 1°,EduMax,229,9,220
2025-08-14,11,Primaria 1°,TopKids,55,2,53
2025-08-14,11,Primaria 2°,SuperSchool,65,21,44
2025-08-14,11,Primaria 2°,EduMax,187,18,169
2025-08-14,11,Primaria 2°,EduMax,250,24,226
2025-08-14,11,Primaria 2°,TopKids,274,4,270
2025-08-14,11,Primaria 2°,TopKids,91,12,79
2025-08-14,11,Primaria 2°,EduMax,200,20,180
2025-08-14,11,Primaria 2°,EduMax,102,2,100
2025-08-14,11,Primaria 2°,EduMax,243,9,234
2025-08-14,11,Primaria 2°,TopKids,219,2,217
2025-08-14,11,Primaria 2°,SuperSchool,194,4,190
2025-08-14,11,Primaria 2°,EduMax,125,17,108
2025-08-14,11,Primaria 2°,SuperSchool,238,19,219
2025-08-14,11,Primaria 2°,EduMax,95,17,78
2025-08-14,11,Primaria 2°,EduMax,153,5,148
2025-08-14,11,Primaria 2°,TopKids,280,22,258
2025-08-14,11,Primaria 2°,SuperSchool,161,16,145
2025-08-14,11,Primaria 2°,SuperSchool,295,7,288
2025-08-14,11,Primaria 2°,TopKids,145,11,134
2025-08-14,11,Primaria 2°,TopKids,131,6,125
2025-08-14,11,Primaria 3°,TopKids,269,23,246
2025-08-14,11,Primaria 3°,EduMax,227,24,203
2025-08-14,11,Primaria 3°,TopKids,165,9,156
2025-08-14,11,Primaria 3°,EduMax,196,19,177
2025-08-14,11,Primaria 3°,EduMax,234,4,230
2025-08-14,11,Primaria 3°,TopKids,151,3,148
2025-08-14,11,Primaria 3°,TopKids,132,11,121
2025-08-14,11,Primaria 3°,SuperSchool,59,12,47
2025-08-14,11,Primaria 3°,EduMax,79,18,61
2025-08-14,11,Primaria 3°,SuperSchool,96,24,72
2025-08-14,11,Primaria 4°,EduMax,180,23,157
2025-08-14,11,Primaria 4°,TopKids,123,18,105
2025-08-14,11,Primaria 4°,SuperSchool,175,6,169
2025-08-14,11,Primaria 4°,TopKids,294,13,281
2025-08-14,11,Primaria 4°,SuperSchool,139,20,119
2025-08-14,11,Primaria 4°,SuperSchool,197,14,183
2025-08-14,11,Primaria 4°,SuperSchool,63,8,55
2025-08-14,11,Primaria 4°,SuperSchool,73,15,58
2025-08-14,11,Primaria 4°,TopKids,242,22,220
2025-08-14,11,Primaria 4°,EduMax,291,19,272
2025-08-14,11,Primaria 4°,TopKids,177,23,154
2025-08-14,11,Primaria 4°,EduMax,255,9,246
2025-08-14,11,Primaria 4°,SuperSchool,249,17,232
2025-08-14,11,Primaria 4°,TopKids,168,24,144
2025-08-14,11,Primaria 4°,EduMax,70,10,60
2025-08-14,11,Primaria 4°,SuperSchool,202,24,178
2025-08-14,11,Primaria 4°,EduMax,135,17,118
2025-08-14,11,Primaria 4°,SuperSchool,161,15,146
2025-08-14,11,Primaria 4°,EduMax,95,4,91
2025-08-14,11,Primaria 5°,EduMax,243,11,232
2025-08-14,11,Primaria 5°,EduMax,277,21,256
2025-08-14,11,Primaria 5°,SuperSchool,173,21,152
2025-08-14,11,Primaria 5°,SuperSchool,53,1,52
2025-08-14,11,Primaria 5°,EduMax,139,24,115
2025-08-14,11,Primaria 5°,TopKids,179,9,170
2025-08-14,11,Primaria 5°,TopKids,234,13,221
2025-08-14,11,Primaria 5°,EduMax,161,16,145
2025-08-14,11,Primaria 6°,EduMax,90,11,79
2025-08-14,11,Primaria 6°,SuperSchool,267,4,263
2025-08-14,11,Primaria 6°,EduMax,84,6,78
2025-08-14,11,Primaria 6°,TopKids,90,3,87
2025-08-14,11,Primaria 6°,EduMax,153,22,131
2025-08-14,11,Primaria 6°,TopKids,94,7,87
2025-08-14,11,Primaria 6°,TopKids,281,10,271
2025-08-14,11,Primaria 6°,SuperSchool,242,13,229
2025-08-14,11,Primaria 6°,SuperSchool,171,13,158
2025-08-14,11,Primaria 6°,SuperSchool,90,10,80
2025-08-14,11,Primaria 6°,EduMax,246,2,244
2025-08-14,11,Primaria 6°,TopKids,122,6,116
2025-08-14,11,Primaria 6°,SuperSchool,58,8,50
2025-08-14,12,Preescolar,EduMax,153,3,150
2025-08-14,12,Preescolar,SuperSchool,68,2,66
2025-08-14,12,Preescolar,SuperSchool,257,4,253
2025-08-14,12,Preescolar,EduMax,255,2,253
2025-08-14,12,Preescolar,SuperSchool,140,21,119
2025-08-14,12,Preescolar,SuperSchool,208,15,193
2025-08-14,12,Preescolar,SuperSchool,197,5,192
2025-08-14,12,Preescolar,TopKids,67,24,43
2025-08-14,12,Preescolar,TopKids,145,18,127
2025-08-14,12,Preescolar,TopKids,267,5,262
2025-08-14,12,Preescolar,SuperSchool,77,18,59
2025-08-14,12,Preescolar,EduMax,261,4,257
2025-08-14,12,Preescolar,SuperSchool,73,16,57
2025-08-14,12,Preescolar,EduMax,299,8,291
2025-08-14,12,Preescolar,SuperSchool,168,4,164
2025-08-14,12,Preescolar,EduMax,176,9,167
2025-08-14,12,Kínder,SuperSchool,57,15,42
2025-08-14,12,Kínder,SuperSchool,194,23,171
2025-08-14,12,Kínder,EduMax,247,5,242
2025-08-14,12,Kínder,SuperSchool,113,2,111
2025-08-14,12,Kínder,EduMax,113,10,103
2025-08-14,12,Kínder,EduMax,151,12,139
2025-08-14,12,Primaria 1°,TopKids,190,20,170
2025-08-14,12,Primaria 1°,EduMax,268,21,247
2025-08-14,12,Primaria 1°,EduMax,83,23,60
2025-08-14,12,Primaria 1°,TopKids,151,1,150
2025-08-14,12,Primaria 1°,SuperSchool,125,19,106
2025-08-14,12,Primaria 2°,EduMax,194,18,176
2025-08-14,12,Primaria 2°,TopKids,218,10,208
2025-08-14,12,Primaria 2°,TopKids,272,15,257
2025-08-14,12,Primaria 2°,TopKids,114,12,102
2025-08-14,12,Primaria 2°,SuperSchool,147,15,132
2025-08-14,12,Primaria 2°,SuperSchool,88,6,82
2025-08-14,12,Primaria 2°,TopKids,146,21,125
2025-08-14,12,Primaria 2°,EduMax,287,4,283
2025-08-14,12,Primaria 2°,SuperSchool,146,1,145
2025-08-14,12,Primaria 2°,SuperSchool,55,5,50
2025-08-14,12,Primaria 2°,EduMax,298,21,277
2025-08-14,12,Primaria 2°,TopKids,172,5,167
2025-08-14,12,Primaria 2°,EduMax,218,19,199
2025-08-14,12,Primaria 3°,TopKids,62,12,50
2025-08-14,12,Primaria 3°,SuperSchool,115,4,111
2025-08-14,12,Primaria 3°,TopKids,268,18,250
2025-08-14,12,Primaria 3°,SuperSchool,59,13,46
2025-08-14,12,Primaria 3°,EduMax,267,15,252
2025-08-14,12,Primaria 3°,EduMax,234,10,224
2025-08-14,12,Primaria 3°,EduMax,281,15,266
2025-08-14,12,Primaria 3°,SuperSchool,185,21,164
2025-08-14,12,Primaria 3°,SuperSchool,199,14,185
2025-08-14,12,Primaria 4°,SuperSchool,140,8,132
2025-08-14,12,Primaria 4°,EduMax,199,9,190
2025-08-14,12,Primaria 4°,SuperSchool,84,18,66
2025-08-14,12,Primaria 4°,EduMax,182,6,176
2025-08-14,12,Primaria 4°,EduMax,81,8,73
2025-08-14,12,Primaria 5°,TopKids,134,18,116
2025-08-14,12,Primaria 5°,EduMax,192,10,182
2025-08-14,12,Primaria 5°,EduMax,230,12,218
2025-08-14,12,Primaria 5°,TopKids,77,7,70
2025-08-14,12,Primaria 5°,TopKids,209,13,196
2025-08-14,12,Primaria 5°,TopKids,67,7,60
2025-08-14,12,Primaria 5°,EduMax,168,11,157
2025-08-14,12,Primaria 5°,SuperSchool,217,8,209
2025-08-14,12,Primaria 5°,TopKids,84,5,79
2025-08-14,12,Primaria 5°,EduMax,148,15,133
2025-08-14,12,Primaria 5°,EduMax,198,15,183
2025-08-14,12,Primaria 5°,SuperSchool,195,2,193
2025-08-14,12,Primaria 6°,SuperSchool,211,14,197
2025-08-14,12,Primaria 6°,TopKids,254,7,247
2025-08-14,12,Primaria 6°,EduMax,73,1,72
2025-08-14,12,Primaria 6°,SuperSchool,166,4,162
2025-08-14,12,Primaria 6°,EduMax,55,2,53
2025-08-14,12,Primaria 6°,TopKids,287,8,279
2025-08-14,12,Primaria 6°,TopKids,97,19,78
2025-08-14,12,Primaria 6°,EduMax,119,14,105
2025-08-14,12,Primaria 6°,TopKids,225,1,224
2025-08-14,12,Primaria 6°,EduMax,112,14,98
2025-08-14,12,Primaria 6°,TopKids,295,19,276
2025-08-14,12,Primaria 6°,SuperSchool,120,14,106
2025-08-14,12,Primaria 6°,SuperSchool,227,9,218
2025-08-14,12,Primaria 6°,SuperSchool,56,9,47
2025-08-14,12,Primaria 6°,SuperSchool,226,12,214
2025-08-14,12,Primaria 6°,EduMax,131,8,123
2025-08-14,13,Preescolar,TopKids,177,3,174
2025-08-14,13,Preescolar,EduMax,233,23,210
2025-08-14,13,Preescolar,SuperSchool,153,4,149
2025-08-14,13,Preescolar,EduMax,159,2,157
2025-08-14,13,Preescolar,EduMax,76,22,54
2025-08-14,13,Preescolar,TopKids,93,6,87
2025-08-14,13,Preescolar,EduMax,85,19,66
2025-08-14,13,Preescolar,TopKids,94,20,74
2025-08-14,13,Preescolar,SuperSchool,200,2,198
2025-08-14,13,Kínder,TopKids,90,4,86
2025-08-14,13,Kínder,TopKids,129,19,110
2025-08-14,13,Kínder,EduMax,151,16,135
2025-08-14,13,Kínder,EduMax,286,9,277
2025-08-14,13,Kínder,TopKids,149,19,130
2025-08-14,13,Kínder,EduMax,277,19,258
2025-08-14,13,Kínder,TopKids,125,13,112
2025-08-14,13,Kínder,SuperSchool,277,10,267
2025-08-14,13,Kínder,SuperSchool,88,5,83
2025-08-14,13,Kínder,SuperSchool,195,11,184
2025-08-14,13,Kínder,TopKids,70,22,48
2025-08-14,13,Kínder,TopKids,99,6,93
2025-08-14,13,Primaria 1°,EduMax,164,1,163
2025-08-14,13,Primaria 1°,SuperSchool,79,11,68
2025-08-14,13,Primaria 1°,SuperSchool,97,23,74
2025-08-14,13,Primaria 1°,SuperSchool,68,14,54
2025-08-14,13,Primaria 1°,TopKids,179,24,155
2025-08-14,13,Primaria 1°,SuperSchool,194,18,176
2025-08-14,13,Primaria 2°,TopKids,199,9,190
2025-08-14,13,Primaria 2°,TopKids,104,5,99
2025-08-14,13,Primaria 2°,SuperSchool,260,24,236
2025-08-14,13,Primaria 2°,EduMax,261,21,240
2025-08-14,13,Primaria 2°,EduMax,135,21,114
2025-08-14,13,Primaria 3°,TopKids,168,7,161
2025-08-14,13,Primaria 3°,SuperSchool,259,7,252
2025-08-14,13,Primaria 3°,EduMax,124,12,112
2025-08-14,13,Primaria 3°,EduMax,65,19,46
2025-08-14,13,Primaria 3°,TopKids,76,19,57
2025-08-14,13,Primaria 3°,TopKids,193,23,170
2025-08-14,13,Primaria 3°,TopKids,125,8,117
2025-08-14,13,Primaria 3°,TopKids,179,6,173
2025-08-14,13,Primaria 3°,SuperSchool,288,14,274
2025-08-14,13,Primaria 3°,EduMax,261,18,243
2025-08-14,13,Primaria 3°,EduMax,259,2,257
2025-08-14,13,Primaria 3°,SuperSchool,69,2,67
2025-08-14,13,Primaria 3°,SuperSchool,218,16,202
2025-08-14,13,Primaria 3°,TopKids,268,23,245
2025-08-14,13,Primaria 4°,TopKids,111,12,99
2025-08-14,13,Primaria 4°,EduMax,272,23,249
2025-08-14,13,Primaria 4°,SuperSchool,218,20,198
2025-08-14,13,Primaria 4°,EduMax,55,11,44
2025-08-14,13,Primaria 4°,TopKids,181,10,171
2025-08-14,13,Primaria 4°,TopKids,142,6,136
2025-08-14,13,Primaria 4°,SuperSchool,281,8,273
2025-08-14,13,Primaria 4°,SuperSchool,151,17,134
2025-08-14,13,Primaria 4°,TopKids,240,1,239
2025-08-14,13,Primaria 4°,TopKids,286,21,265
2025-08-14,13,Primaria 5°,EduMax,243,3,240
2025-08-14,13,Primaria 5°,SuperSchool,236,16,220
2025-08-14,13,Primaria 5°,SuperSchool,292,18,274
2025-08-14,13,Primaria 5°,SuperSchool,61,12,49
2025-08-14,13,Primaria 5°,SuperSchool,261,8,253
2025-08-14,13,Primaria 5°,SuperSchool,70,20,50
2025-08-14,13,Primaria 5°,EduMax,216,9,207
2025-08-14,13,Primaria 6°,TopKids,155,4,151
2025-08-14,13,Primaria 6°,EduMax,203,7,196
2025-08-14,13,Primaria 6°,TopKids,249,24,225
2025-08-14,13,Primaria 6°,TopKids,185,22,163
2025-08-14,13,Primaria 6°,SuperSchool,52,22,30
2025-08-14,14,Preescolar,TopKids,225,15,210
2025-08-14,14,Preescolar,SuperSchool,240,16,224
2025-08-14,14,Preescolar,EduMax,156,5,151
2025-08-14,14,Preescolar,TopKids,206,13,193
2025-08-14,14,Preescolar,TopKids,119,16,103
2025-08-14,14,Preescolar,TopKids,284,20,264
2025-08-14,14,Preescolar,EduMax,109,2,107
2025-08-14,14,Preescolar,TopKids,275,17,258
2025-08-14,14,Preescolar,EduMax,265,16,249
2025-08-14,14,Kínder,EduMax,226,13,213
2025-08-14,14,Kínder,SuperSchool,265,4,261
2025-08-14,14,Kínder,SuperSchool,237,16,221
2025-08-14,14,Kínder,TopKids,76,11,65
2025-08-14,14,Kínder,TopKids,98,22,76
2025-08-14,14,Kínder,SuperSchool,117,14,103
2025-08-14,14,Kínder,EduMax,219,10,209
2025-08-14,14,Kínder,TopKids,221,2,219
2025-08-14,14,Kínder,EduMax,200,9,191
2025-08-14,14,Primaria 1°,SuperSchool,57,21,36
2025-08-14,14,Primaria 1°,EduMax,248,7,241
2025-08-14,14,Primaria 1°,SuperSchool,52,14,38
2025-08-14,14,Primaria 1°,SuperSchool,291,12,279
2025-08-14,14,Primaria 1°,EduMax,95,13,82
2025-08-14,14,Primaria 1°,EduMax,58,19,39
2025-08-14,14,Primaria 1°,EduMax,179,11,168
2025-08-14,14,Primaria 1°,SuperSchool,177,2,175
2025-08-14,14,Primaria 1°,TopKids,88,18,70
2025-08-14,14,Primaria 1°,SuperSchool,182,18,164
2025-08-14,14,Primaria 1°,TopKids,171,24,147
2025-08-14,14,Primaria 1°,SuperSchool,161,15,146
2025-08-14,14,Primaria 1°,EduMax,256,1,255
2025-08-14,14,Primaria 1°,SuperSchool,111,15,96
2025-08-14,14,Primaria 1°,EduMax,127,10,117
2025-08-14,14,Primaria 1°,EduMax,236,6,230
2025-08-14,14,Primaria 1°,EduMax,226,5,221
2025-08-14,14,Primaria 2°,SuperSchool,128,15,113
2025-08-14,14,Primaria 2°,TopKids,246,1,245
2025-08-14,14,Primaria 2°,TopKids,92,6,86
2025-08-14,14,Primaria 2°,TopKids,89,2,87
2025-08-14,14,Primaria 2°,TopKids,256,23,233
2025-08-14,14,Primaria 2°,EduMax,122,15,107
2025-08-14,14,Primaria 2°,EduMax,65,14,51
2025-08-14,14,Primaria 2°,TopKids,165,13,152
2025-08-14,14,Primaria 2°,SuperSchool,114,6,108
2025-08-14,14,Primaria 2°,TopKids,172,20,152
2025-08-14,14,Primaria 2°,EduMax,140,18,122
2025-08-14,14,Primaria 2°,EduMax,226,21,205
2025-08-14,14,Primaria 2°,SuperSchool,231,4,227
2025-08-14,14,Primaria 2°,SuperSchool,95,5,90
2025-08-14,14,Primaria 2°,EduMax,175,14,161
2025-08-14,14,Primaria 2°,EduMax,170,24,146
2025-08-14,14,Primaria 2°,SuperSchool,110,14,96
2025-08-14,14,Primaria 2°,TopKids,239,3,236
2025-08-14,14,Primaria 2°,SuperSchool,287,10,277
2025-08-14,14,Primaria 3°,EduMax,245,11,234
2025-08-14,14,Primaria 3°,TopKids,256,24,232
2025-08-14,14,Primaria 3°,EduMax,220,2,218
2025-08-14,14,Primaria 3°,TopKids,110,5,105
2025-08-14,14,Primaria 3°,SuperSchool,274,7,267
2025-08-14,14,Primaria 3°,TopKids,219,6,213
2025-08-14,14,Primaria 3°,SuperSchool,265,11,254
2025-08-14,14,Primaria 3°,EduMax,147,16,131
2025-08-14,14,Primaria 3°,EduMax,292,6,286
2025-08-14,14,Primaria 3°,SuperSchool,92,18,74
2025-08-14,14,Primaria 3°,EduMax,144,18,126
2025-08-14,14,Primaria 3°,EduMax,237,1,236
2025-08-14,14,Primaria 3°,TopKids,193,7,186
2025-08-14,14,Primaria 3°,TopKids,174,1,173
2025-08-14,14,Primaria 3°,TopKids,102,9,93
2025-08-14,14,Primaria 3°,EduMax,194,24,170
2025-08-14,14,Primaria 3°,EduMax,55,5,50
2025-08-14,14,Primaria 4°,EduMax,118,12,106
2025-08-14,14,Primaria 4°,TopKids,286,13,273
2025-08-14,14,Primaria 4°,SuperSchool,53,18,35
2025-08-14,14,Primaria 4°,EduMax,52,12,40
2025-08-14,14,Primaria 4°,SuperSchool,76,11,65
2025-08-14,14,Primaria 4°,EduMax,254,17,237
2025-08-14,14,Primaria 4°,TopKids,66,2,64
2025-08-14,14,Primaria 4°,TopKids,276,6,270
2025-08-14,14,Primaria 4°,EduMax,201,22,179
2025-08-14,14,Primaria 4°,EduMax,99,14,85
2025-08-14,14,Primaria 4°,TopKids,82,17,65
2025-08-14,14,Primaria 4°,TopKids,138,5,133
2025-08-14,14,Primaria 5°,SuperSchool,134,17,117
2025-08-14,14,Primaria 5°,EduMax,272,12,260
2025-08-14,14,Primaria 5°,SuperSchool,261,2,259
2025-08-14,14,Primaria 5°,TopKids,161,15,146
2025-08-14,14,Primaria 5°,SuperSchool,163,20,143
2025-08-14,14,Primaria 5°,EduMax,191,18,173
2025-08-14,14,Primaria 5°,EduMax,83,3,80
2025-08-14,14,Primaria 5°,SuperSchool,74,16,58
2025-08-14,14,Primaria 5°,EduMax,256,12,244
2025-08-14,14,Primaria 5°,EduMax,186,14,172
2025-08-14,14,Primaria 5°,SuperSchool,102,16,86
2025-08-14,14,Primaria 5°,TopKids,215,10,205
2025-08-14,14,Primaria 5°,TopKids,115,16,99
2025-08-14,14,Primaria 5°,TopKids,143,9,134
2025-08-14,14,Primaria 5°,TopKids,167,4,163
2025-08-14,14,Primaria 6°,TopKids,286,18,268
2025-08-14,14,Primaria 6°,TopKids,209,4,205
2025-08-14,14,Primaria 6°,SuperSchool,213,16,197
2025-08-14,14,Primaria 6°,SuperSchool,113,15,98
2025-08-14,14,Primaria 6°,EduMax,173,14,159
2025-08-14,14,Primaria 6°,TopKids,167,23,144
2025-08-14,14,Primaria 6°,EduMax,80,1,79
2025-08-14,14,Primaria 6°,TopKids,237,9,228
2025-08-14,14,Primaria 6°,SuperSchool,95,17,78
2025-08-14,14,Primaria 6°,SuperSchool,91,23,68
2025-08-14,14,Primaria 6°,TopKids,266,19,247
2025-08-14,14,Primaria 6°,SuperSchool,52,12,40
2025-08-14,14,Primaria 6°,TopKids,128,17,111
2025-08-14,14,Primaria 6°,EduMax,81,7,74
2025-08-14,15,Preescolar,TopKids,177,5,172
2025-08-14,15,Preescolar,EduMax,217,21,196
2025-08-14,15,Preescolar,TopKids,234,15,219
2025-08-14,15,Preescolar,TopKids,214,23,191
2025-08-14,15,Preescolar,TopKids,123,21,102
2025-08-14,15,Preescolar,TopKids,90,1,89
2025-08-14,15,Preescolar,SuperSchool,217,3,214
2025-08-14,15,Kínder,EduMax,277,19,258
2025-08-14,15,Kínder,TopKids,246,24,222
2025-08-14,15,Kínder,EduMax,169,23,146
2025-08-14,15,Kínder,SuperSchool,270,5,265
2025-08-14,15,Kínder,EduMax,107,12,95
2025-08-14,15,Kínder,TopKids,254,22,232
2025-08-14,15,Primaria 1°,TopKids,254,1,253
2025-08-14,15,Primaria 1°,EduMax,87,11,76
2025-08-14,15,Primaria 1°,SuperSchool,102,20,82
2025-08-14,15,Primaria 1°,SuperSchool,60,11,49
2025-08-14,15,Primaria 1°,EduMax,276,19,257
2025-08-14,15,Primaria 1°,EduMax,205,23,182
2025-08-14,15,Primaria 1°,SuperSchool,155,22,133
2025-08-14,15,Primaria 1°,SuperSchool,215,9,206
2025-08-14,15,Primaria 1°,EduMax,261,14,247
2025-08-14,15,Primaria 1°,EduMax,203,17,186
2025-08-14,15,Primaria 1°,EduMax,140,16,124
2025-08-14,15,Primaria 1°,EduMax,257,1,256
2025-08-14,15,Primaria 2°,TopKids,188,16,172
2025-08-14,15,Primaria 2°,EduMax,241,18,223
2025-08-14,15,Primaria 2°,TopKids,282,12,270
2025-08-14,15,Primaria 2°,SuperSchool,236,18,218
2025-08-14,15,Primaria 2°,SuperSchool,265,8,257
2025-08-14,15,Primaria 2°,TopKids,51,19,32
2025-08-14,15,Primaria 2°,EduMax,260,1,259
2025-08-14,15,Primaria 3°,TopKids,231,13,218
2025-08-14,15,Primaria 3°,TopKids,165,17,148
2025-08-14,15,Primaria 3°,TopKids,282,5,277
2025-08-14,15,Primaria 3°,EduMax,181,17,164
2025-08-14,15,Primaria 3°,EduMax,230,21,209
2025-08-14,15,Primaria 3°,SuperSchool,161,16,145
2025-08-14,15,Primaria 3°,EduMax,188,2,186
2025-08-14,15,Primaria 3°,SuperSchool,192,18,174
2025-08-14,15,Primaria 3°,SuperSchool,187,6,181
2025-08-14,15,Primaria 3°,SuperSchool,97,5,92
2025-08-14,15,Primaria 3°,TopKids,119,14,105
2025-08-14,15,Primaria 3°,EduMax,264,16,248
2025-08-14,15,Primaria 3°,SuperSchool,216,2,214
2025-08-14,15,Primaria 3°,EduMax,218,7,211
2025-08-14,15,Primaria 3°,EduMax,164,8,156
2025-08-14,15,Primaria 3°,TopKids,113,4,109
2025-08-14,15,Primaria 3°,SuperSchool,131,13,118
2025-08-14,15,Primaria 3°,TopKids,278,2,276
2025-08-14,15,Primaria 4°,SuperSchool,62,5,57
2025-08-14,15,Primaria 4°,EduMax,127,13,114
2025-08-14,15,Primaria 4°,TopKids,249,18,231
2025-08-14,15,Primaria 4°,TopKids,165,17,148
2025-08-14,15,Primaria 4°,TopKids,80,19,61
2025-08-14,15,Primaria 4°,TopKids,109,1,108
2025-08-14,15,Primaria 4°,SuperSchool,176,8,168
2025-08-14,15,Primaria 4°,SuperSchool,175,9,166
2025-08-14,15,Primaria 4°,TopKids,262,9,253
2025-08-14,15,Primaria 4°,SuperSchool,138,10,128
2025-08-14,15,Primaria 4°,TopKids,252,1,251
2025-08-14,15,Primaria 4°,SuperSchool,139,8,131
2025-08-14,15,Primaria 4°,SuperSchool,251,4,247
2025-08-14,15,Primaria 4°,TopKids,100,6,94
2025-08-14,15,Primaria 4°,TopKids,246,5,241
2025-08-14,15,Primaria 5°,TopKids,172,22,150
2025-08-14,15,Primaria 5°,EduMax,240,4,236
2025-08-14,15,Primaria 5°,EduMax,282,19,263
2025-08-14,15,Primaria 5°,EduMax,283,22,261
2025-08-14,15,Primaria 5°,TopKids,274,11,263
2025-08-14,15,Primaria 5°,EduMax,144,10,134
2025-08-14,15,Primaria 6°,SuperSchool,97,8,89
2025-08-14,15,Primaria 6°,TopKids,83,23,60
2025-08-14,15,Primaria 6°,SuperSchool,184,19,165
2025-08-14,15,Primaria 6°,TopKids,96,8,88
2025-08-14,15,Primaria 6°,EduMax,178,13,165
2025-08-14,15,Primaria 6°,TopKids,230,6,224
2025-08-14,15,Primaria 6°,TopKids,192,4,188
2025-08-14,16,Preescolar,TopKids,244,4,240
2025-08-14,16,Preescolar,SuperSchool,291,10,281
2025-08-14,16,Preescolar,EduMax,299,3,296
2025-08-14,16,Preescolar,TopKids,99,23,76
2025-08-14,16,Preescolar,EduMax,146,14,132
2025-08-14,16,Preescolar,TopKids,295,23,272
2025-08-14,16,Preescolar,TopKids,126,12,114
2025-08-14,16,Preescolar,TopKids,195,21,174
2025-08-14,16,Preescolar,SuperSchool,160,10,150
2025-08-14,16,Kínder,SuperSchool,215,9,206
2025-08-14,16,Kínder,EduMax,288,9,279
2025-08-14,16,Kínder,TopKids,127,11,116
2025-08-14,16,Kínder,TopKids,208,24,184
2025-08-14,16,Kínder,EduMax,79,2,77
2025-08-14,16,Primaria 1°,EduMax,118,5,113
2025-08-14,16,Primaria 1°,SuperSchool,260,19,241
2025-08-14,16,Primaria 1°,EduMax,205,10,195
2025-08-14,16,Primaria 1°,TopKids,223,17,206
2025-08-14,16,Primaria 1°,EduMax,116,1,115
2025-08-14,16,Primaria 1°,EduMax,180,5,175
2025-08-14,16,Primaria 1°,SuperSchool,132,10,122
2025-08-14,16,Primaria 1°,EduMax,235,16,219
2025-08-14,16,Primaria 1°,SuperSchool,151,9,142
2025-08-14,16,Primaria 1°,SuperSchool,108,14,94
2025-08-14,16,Primaria 1°,EduMax,83,5,78
2025-08-14,16,Primaria 1°,SuperSchool,202,10,192
2025-08-14,16,Primaria 1°,SuperSchool,299,22,277
2025-08-14,16,Primaria 1°,TopKids,122,3,119
2025-08-14,16,Primaria 1°,TopKids,53,13,40
2025-08-14,16,Primaria 1°,EduMax,69,17,52
2025-08-14,16,Primaria 1°,TopKids,214,15,199
2025-08-14,16,Primaria 1°,SuperSchool,214,24,190
2025-08-14,16,Primaria 2°,SuperSchool,82,7,75
2025-08-14,16,Primaria 2°,TopKids,71,5,66
2025-08-14,16,Primaria 2°,EduMax,64,21,43
2025-08-14,16,Primaria 2°,EduMax,138,17,121
2025-08-14,16,Primaria 2°,EduMax,184,22,162
2025-08-14,16,Primaria 2°,EduMax,99,19,80
2025-08-14,16,Primaria 2°,TopKids,217,13,204
2025-08-14,16,Primaria 2°,TopKids,291,24,267
2025-08-14,16,Primaria 2°,TopKids,154,23,131
2025-08-14,16,Primaria 2°,SuperSchool,231,8,223
2025-08-14,16,Primaria 2°,SuperSchool,93,2,91
2025-08-14,16,Primaria 2°,TopKids,198,24,174
2025-08-14,16,Primaria 2°,EduMax,258,15,243
2025-08-14,16,Primaria 2°,SuperSchool,148,20,128
2025-08-14,16,Primaria 2°,TopKids,195,20,175
2025-08-14,16,Primaria 2°,EduMax,281,1,280
2025-08-14,16,Primaria 2°,TopKids,260,10,250
2025-08-14,16,Primaria 3°,EduMax,206,13,193
2025-08-14,16,Primaria 3°,SuperSchool,194,1,193
2025-08-14,16,Primaria 3°,SuperSchool,141,24,117
2025-08-14,16,Primaria 3°,SuperSchool,99,7,92
2025-08-14,16,Primaria 3°,EduMax,228,11,217
2025-08-14,16,Primaria 3°,SuperSchool,113,8,105
2025-08-14,16,Primaria 3°,SuperSchool,58,2,56
2025-08-14,16,Primaria 3°,EduMax,190,16,174
2025-08-14,16,Primaria 3°,EduMax,245,12,233
2025-08-14,16,Primaria 3°,EduMax,180,4,176
2025-08-14,16,Primaria 3°,EduMax,136,5,131
2025-08-14,16,Primaria 3°,EduMax,180,10,170
2025-08-14,16,Primaria 3°,TopKids,196,14,182
2025-08-14,16,Primaria 3°,SuperSchool,173,11,162
2025-08-14,16,Primaria 3°,SuperSchool,213,24,189
2025-08-14,16,Primaria 3°,EduMax,215,17,198
2025-08-14,16,Primaria 4°,TopKids,94,22,72
2025-08-14,16,Primaria 4°,EduMax,238,11,227
2025-08-14,16,Primaria 4°,SuperSchool,87,2,85
2025-08-14,16,Primaria 4°,SuperSchool,92,16,76
2025-08-14,16,Primaria 4°,TopKids,86,15,71
2025-08-14,16,Primaria 4°,TopKids,149,23,126
2025-08-14,16,Primaria 4°,TopKids,267,17,250
2025-08-14,16,Primaria 4°,TopKids,214,13,201
2025-08-14,16,Primaria 4°,EduMax,258,22,236
2025-08-14,16,Primaria 4°,SuperSchool,255,14,241
2025-08-14,16,Primaria 5°,EduMax,139,13,126
2025-08-14,16,Primaria 5°,EduMax,263,16,247
2025-08-14,16,Primaria 5°,EduMax,129,6,123
2025-08-14,16,Primaria 5°,EduMax,201,4,197
2025-08-14,16,Primaria 5°,TopKids,183,4,179
2025-08-14,16,Primaria 6°,EduMax,75,5,70
2025-08-14,16,Primaria 6°,TopKids,218,11,207
2025-08-14,16,Primaria 6°,EduMax,257,19,238
2025-08-14,16,Primaria 6°,TopKids,230,15,215
2025-08-14,16,Primaria 6°,EduMax,105,9,96
2025-08-14,16,Primaria 6°,TopKids,260,19,241
2025-08-15,9,Preescolar,EduMax,122,23,99
2025-08-15,9,Preescolar,EduMax,240,9,231
2025-08-15,9,Preescolar,TopKids,64,19,45
2025-08-15,9,Preescolar,EduMax,283,19,264
2025-08-15,9,Preescolar,SuperSchool,112,20,92
2025-08-15,9,Preescolar,SuperSchool,211,19,192
2025-08-15,9,Preescolar,SuperSchool,195,17,178
2025-08-15,9,Preescolar,EduMax,228,1,227
2025-08-15,9,Preescolar,TopKids,106,10,96
2025-08-15,9,Preescolar,SuperSchool,225,24,201
2025-08-15,9,Preescolar,SuperSchool,105,23,82
2025-08-15,9,Preescolar,TopKids,104,6,98
2025-08-15,9,Kínder,SuperSchool,285,15,270
2025-08-15,9,Kínder,SuperSchool,266,21,245
2025-08-15,9,Kínder,TopKids,234,23,211
2025-08-15,9,Kínder,TopKids,89,6,83
2025-08-15,9,Kínder,SuperSchool,79,10,69
2025-08-15,9,Kínder,EduMax,152,7,145
2025-08-15,9,Kínder,TopKids,265,7,258
2025-08-15,9,Primaria 1°,SuperSchool,69,17,52
2025-08-15,9,Primaria 1°,TopKids,280,17,263
2025-08-15,9,Primaria 1°,EduMax,75,4,71
2025-08-15,9,Primaria 1°,TopKids,175,3,172
2025-08-15,9,Primaria 1°,TopKids,148,12,136
2025-08-15,9,Primaria 1°,SuperSchool,149,14,135
2025-08-15,9,Primaria 1°,SuperSchool,287,13,274
2025-08-15,9,Primaria 1°,SuperSchool,137,15,122
2025-08-15,9,Primaria 2°,SuperSchool,189,22,167
2025-08-15,9,Primaria 2°,TopKids,139,14,125
2025-08-15,9,Primaria 2°,EduMax,117,14,103
2025-08-15,9,Primaria 2°,TopKids,174,13,161
2025-08-15,9,Primaria 2°,SuperSchool,104,18,86
2025-08-15,9,Primaria 2°,TopKids,205,6,199
2025-08-15,9,Primaria 2°,SuperSchool,221,19,202
2025-08-15,9,Primaria 2°,EduMax,160,11,149
2025-08-15,9,Primaria 2°,EduMax,287,3,284
2025-08-15,9,Primaria 2°,TopKids,197,11,186
2025-08-15,9,Primaria 2°,SuperSchool,233,17,216
2025-08-15,9,Primaria 2°,SuperSchool,172,17,155
2025-08-15,9,Primaria 2°,TopKids,212,14,198
2025-08-15,9,Primaria 2°,TopKids,88,19,69
2025-08-15,9,Primaria 2°,TopKids,83,17,66
2025-08-15,9,Primaria 2°,SuperSchool,199,6,193
2025-08-15,9,Primaria 2°,TopKids,198,9,189
2025-08-15,9,Primaria 2°,TopKids,204,5,199
2025-08-15,9,Primaria 2°,EduMax,231,15,216
2025-08-15,9,Primaria 3°,TopKids,219,4,215
2025-08-15,9,Primaria 3°,EduMax,236,8,228
2025-08-15,9,Primaria 3°,EduMax,286,7,279
2025-08-15,9,Primaria 3°,TopKids,53,15,38
2025-08-15,9,Primaria 3°,EduMax,122,3,119
2025-08-15,9,Primaria 3°,TopKids,245,13,232
2025-08-15,9,Primaria 3°,TopKids,111,7,104
2025-08-15,9,Primaria 3°,EduMax,74,12,62
2025-08-15,9,Primaria 3°,EduMax,276,24,252
2025-08-15,9,Primaria 3°,TopKids,160,8,152
2025-08-15,9,Primaria 3°,EduMax,187,2,185
2025-08-15,9,Primaria 3°,SuperSchool,202,7,195
2025-08-15,9,Primaria 3°,TopKids,289,11,278
2025-08-15,9,Primaria 4°,SuperSchool,97,19,78
2025-08-15,9,Primaria 4°,TopKids,284,7,277
2025-08-15,9,Primaria 4°,TopKids,126,19,107
2025-08-15,9,Primaria 4°,SuperSchool,209,22,187
2025-08-15,9,Primaria 4°,SuperSchool,174,12,162
2025-08-15,9,Primaria 4°,TopKids,50,1,49
2025-08-15,9,Primaria 4°,TopKids,191,15,176
2025-08-15,9,Primaria 4°,TopKids,297,9,288
2025-08-15,9,Primaria 4°,SuperSchool,245,20,225
2025-08-15,9,Primaria 4°,TopKids,88,1,87
2025-08-15,9,Primaria 4°,SuperSchool,222,24,198
2025-08-15,9,Primaria 4°,EduMax,147,24,123
2025-08-15,9,Primaria 4°,TopKids,128,17,111
2025-08-15,9,Primaria 4°,SuperSchool,120,9,111
2025-08-15,9,Primaria 5°,TopKids,148,23,125
2025-08-15,9,Primaria 5°,EduMax,224,7,217
2025-08-15,9,Primaria 5°,TopKids,203,1,202
2025-08-15,9,Primaria 5°,EduMax,273,19,254
2025-08-15,9,Primaria 5°,EduMax,114,5,109
2025-08-15,9,Primaria 5°,TopKids,226,18,208
2025-08-15,9,Primaria 5°,EduMax,102,19,83
2025-08-15,9,Primaria 5°,EduMax,106,22,84
2025-08-15,9,Primaria 5°,EduMax,65,2,63
2025-08-15,9,Primaria 5°,TopKids,62,13,49
2025-08-15,9,Primaria 5°,TopKids,249,22,227
2025-08-15,9,Primaria 5°,EduMax,296,1,295
2025-08-15,9,Primaria 5°,TopKids,253,9,244
2025-08-15,9,Primaria 5°,SuperSchool,122,16,106
2025-08-15,9,Primaria 5°,EduMax,271,8,263
2025-08-15,9,Primaria 5°,TopKids,60,20,40
2025-08-15,9,Primaria 6°,EduMax,123,24,99
2025-08-15,9,Primaria 6°,SuperSchool,174,20,154
2025-08-15,9,Primaria 6°,EduMax,230,2,228
2025-08-15,9,Primaria 6°,SuperSchool,213,7,206
2025-08-15,9,Primaria 6°,TopKids,271,17,254
2025-08-15,9,Primaria 6°,SuperSchool,297,24,273
2025-08-15,9,Primaria 6°,EduMax,168,18,150
2025-08-15,10,Preescolar,TopKids,176,1,175
2025-08-15,10,Preescolar,TopKids,244,6,238
2025-08-15,10,Preescolar,EduMax,232,6,226
2025-08-15,10,Preescolar,SuperSchool,165,6,159
2025-08-15,10,Preescolar,EduMax,256,14,242
2025-08-15,10,Preescolar,TopKids,97,19,78
2025-08-15,10,Preescolar,SuperSchool,277,24,253
2025-08-15,10,Preescolar,EduMax,101,18,83
2025-08-15,10,Preescolar,EduMax,213,15,198
2025-08-15,10,Kínder,TopKids,67,7,60
2025-08-15,10,Kínder,TopKids,135,11,124
2025-08-15,10,Kínder,TopKids,217,24,193
2025-08-15,10,Kínder,SuperSchool,212,5,207
2025-08-15,10,Kínder,EduMax,61,12,49
2025-08-15,10,Kínder,SuperSchool,172,19,153
2025-08-15,10,Kínder,TopKids,250,11,239
2025-08-15,10,Kínder,SuperSchool,161,4,157
2025-08-15,10,Kínder,EduMax,103,15,88
2025-08-15,10,Kínder,SuperSchool,164,3,161
2025-08-15,10,Kínder,TopKids,173,21,152
2025-08-15,10,Kínder,TopKids,209,5,204
2025-08-15,10,Kínder,TopKids,169,5,164
2025-08-15,10,Kínder,TopKids,215,13,202
2025-08-15,10,Kínder,EduMax,228,11,217
2025-08-15,10,Kínder,TopKids,197,5,192
2025-08-15,10,Kínder,SuperSchool,151,17,134
2025-08-15,10,Primaria 1°,TopKids,217,7,210
2025-08-15,10,Primaria 1°,SuperSchool,288,10,278
2025-08-15,10,Primaria 1°,SuperSchool,184,11,173
2025-08-15,10,Primaria 1°,SuperSchool,226,9,217
2025-08-15,10,Primaria 1°,TopKids,263,8,255
2025-08-15,10,Primaria 1°,TopKids,261,16,245
2025-08-15,10,Primaria 1°,TopKids,248,20,228
2025-08-15,10,Primaria 2°,SuperSchool,84,12,72
2025-08-15,10,Primaria 2°,SuperSchool,101,16,85
2025-08-15,10,Primaria 2°,TopKids,117,12,105
2025-08-15,10,Primaria 2°,SuperSchool,114,17,97
2025-08-15,10,Primaria 2°,EduMax,183,12,171
2025-08-15,10,Primaria 2°,EduMax,124,21,103
2025-08-15,10,Primaria 2°,TopKids,259,8,251
2025-08-15,10,Primaria 2°,SuperSchool,216,14,202
2025-08-15,10,Primaria 2°,TopKids,241,12,229
2025-08-15,10,Primaria 2°,SuperSchool,293,23,270
2025-08-15,10,Primaria 2°,SuperSchool,129,21,108
2025-08-15,10,Primaria 2°,TopKids,161,9,152
2025-08-15,10,Primaria 2°,SuperSchool,139,5,134
2025-08-15,10,Primaria 3°,TopKids,187,7,180
2025-08-15,10,Primaria 3°,SuperSchool,138,14,124
2025-08-15,10,Primaria 3°,TopKids,126,10,116
2025-08-15,10,Primaria 3°,EduMax,139,21,118
2025-08-15,10,Primaria 3°,TopKids,110,12,98
2025-08-15,10,Primaria 3°,SuperSchool,100,6,94
2025-08-15,10,Primaria 3°,SuperSchool,281,16,265
2025-08-15,10,Primaria 3°,EduMax,231,7,224
2025-08-15,10,Primaria 3°,TopKids,164,14,150
2025-08-15,10,Primaria 3°,EduMax,154,18,136
2025-08-15,10,Primaria 4°,TopKids,80,11,69
2025-08-15,10,Primaria 4°,EduMax,284,4,280
2025-08-15,10,Primaria 4°,EduMax,228,13,215
2025-08-15,10,Primaria 4°,TopKids,177,10,167
2025-08-15,10,Primaria 4°,SuperSchool,231,5,226
2025-08-15,10,Primaria 4°,TopKids,129,8,121
2025-08-15,10,Primaria 4°,TopKids,68,14,54
2025-08-15,10,Primaria 4°,TopKids,81,17,64
2025-08-15,10,Primaria 4°,SuperSchool,114,6,108
2025-08-15,10,Primaria 4°,TopKids,200,15,185
2025-08-15,10,Primaria 4°,TopKids,61,21,40
2025-08-15,10,Primaria 4°,EduMax,182,9,173
2025-08-15,10,Primaria 4°,EduMax,131,22,109
2025-08-15,10,Primaria 4°,EduMax,122,7,115
2025-08-15,10,Primaria 4°,EduMax,174,18,156
2025-08-15,10,Primaria 5°,SuperSchool,182,23,159
2025-08-15,10,Primaria 5°,SuperSchool,96,5,91
2025-08-15,10,Primaria 5°,TopKids,175,22,153
2025-08-15,10,Primaria 5°,EduMax,234,19,215
2025-08-15,10,Primaria 5°,TopKids,265,10,255
2025-08-15,10,Primaria 5°,EduMax,237,3,234
2025-08-15,10,Primaria 5°,EduMax,94,18,76
2025-08-15,10,Primaria 5°,EduMax,64,5,59
2025-08-15,10,Primaria 5°,TopKids,237,21,216
2025-08-15,10,Primaria 5°,SuperSchool,275,18,257
2025-08-15,10,Primaria 5°,TopKids,229,23,206
2025-08-15,10,Primaria 5°,TopKids,86,11,75
2025-08-15,10,Primaria 5°,SuperSchool,278,1,277
2025-08-15,10,Primaria 5°,SuperSchool,159,5,154
2025-08-15,10,Primaria 5°,SuperSchool,95,16,79
2025-08-15,10,Primaria 6°,EduMax,68,9,59
2025-08-15,10,Primaria 6°,SuperSchool,54,19,35
2025-08-15,10,Primaria 6°,EduMax,277,16,261
2025-08-15,10,Primaria 6°,TopKids,67,24,43
2025-08-15,10,Primaria 6°,SuperSchool,80,1,79
2025-08-15,10,Primaria 6°,TopKids,272,21,251
2025-08-15,10,Primaria 6°,SuperSchool,111,7,104
2025-08-15,10,Primaria 6°,TopKids,185,19,166
2025-08-15,10,Primaria 6°,SuperSchool,188,15,173
2025-08-15,10,Primaria 6°,SuperSchool,226,11,215
2025-08-15,11,Preescolar,SuperSchool,239,18,221
2025-08-15,11,Preescolar,EduMax,245,18,227
2025-08-15,11,Preescolar,SuperSchool,124,3,121
2025-08-15,11,Preescolar,SuperSchool,165,21,144
2025-08-15,11,Preescolar,EduMax,167,5,162
2025-08-15,11,Preescolar,TopKids,93,22,71
2025-08-15,11,Preescolar,SuperSchool,230,13,217
2025-08-15,11,Preescolar,EduMax,165,3,162
2025-08-15,11,Preescolar,SuperSchool,141,22,119
2025-08-15,11,Preescolar,TopKids,188,21,167
2025-08-15,11,Kínder,SuperSchool,184,17,167
2025-08-15,11,Kínder,EduMax,240,1,239
2025-08-15,11,Kínder,TopKids,254,1,253
2025-08-15,11,Kínder,EduMax,186,13,173
2025-08-15,11,Kínder,SuperSchool,79,9,70
2025-08-15,11,Kínder,SuperSchool,278,15,263
2025-08-15,11,Kínder,EduMax,184,14,170
2025-08-15,11,Kínder,EduMax,97,6,91
2025-08-15,11,Primaria 1°,TopKids,150,4,146
2025-08-15,11,Primaria 1°,EduMax,236,6,230
2025-08-15,11,Primaria 1°,TopKids,53,1,52
2025-08-15,11,Primaria 1°,EduMax,158,9,149
2025-08-15,11,Primaria 1°,TopKids,253,10,243
2025-08-15,11,Primaria 1°,EduMax,227,12,215
2025-08-15,11,Primaria 2°,EduMax,225,23,202
2025-08-15,11,Primaria 2°,EduMax,265,24,241
2025-08-15,11,Primaria 2°,SuperSchool,297,10,287
2025-08-15,11,Primaria 2°,TopKids,160,9,151
2025-08-15,11,Primaria 2°,EduMax,233,2,231
2025-08-15,11,Primaria 2°,EduMax,189,3,186
2025-08-15,11,Primaria 2°,TopKids,282,8,274
2025-08-15,11,Primaria 2°,SuperSchool,55,1,54
2025-08-15,11,Primaria 2°,EduMax,257,16,241
2025-08-15,11,Primaria 2°,SuperSchool,215,15,200
2025-08-15,11,Primaria 3°,EduMax,176,8,168
2025-08-15,11,Primaria 3°,TopKids,273,1,272
2025-08-15,11,Primaria 3°,SuperSchool,204,18,186
2025-08-15,11,Primaria 3°,EduMax,126,22,104
2025-08-15,11,Primaria 3°,EduMax,191,11,180
2025-08-15,11,Primaria 3°,TopKids,291,21,270
2025-08-15,11,Primaria 3°,EduMax,277,17,260
2025-08-15,11,Primaria 3°,TopKids,273,14,259
2025-08-15,11,Primaria 3°,EduMax,106,6,100
2025-08-15,11,Primaria 3°,EduMax,234,4,230
2025-08-15,11,Primaria 3°,TopKids,158,8,150
2025-08-15,11,Primaria 3°,EduMax,168,11,157
2025-08-15,11,Primaria 3°,TopKids,256,8,248
2025-08-15,11,Primaria 3°,EduMax,236,21,215
2025-08-15,11,Primaria 3°,SuperSchool,142,24,118
2025-08-15,11,Primaria 3°,EduMax,153,3,150
2025-08-15,11,Primaria 4°,SuperSchool,257,9,248
2025-08-15,11,Primaria 4°,TopKids,194,16,178
2025-08-15,11,Primaria 4°,TopKids,247,23,224
2025-08-15,11,Primaria 4°,TopKids,297,16,281
2025-08-15,11,Primaria 4°,EduMax,287,11,276
2025-08-15,11,Primaria 5°,SuperSchool,288,12,276
2025-08-15,11,Primaria 5°,SuperSchool,121,16,105
2025-08-15,11,Primaria 5°,EduMax,174,3,171
2025-08-15,11,Primaria 5°,SuperSchool,80,13,67
2025-08-15,11,Primaria 5°,TopKids,110,2,108
2025-08-15,11,Primaria 5°,SuperSchool,249,9,240
2025-08-15,11,Primaria 6°,TopKids,89,21,68
2025-08-15,11,Primaria 6°,SuperSchool,282,6,276
2025-08-15,11,Primaria 6°,TopKids,264,24,240
2025-08-15,11,Primaria 6°,SuperSchool,134,22,112
2025-08-15,11,Primaria 6°,SuperSchool,88,23,65
2025-08-15,11,Primaria 6°,EduMax,159,11,148
2025-08-15,11,Primaria 6°,EduMax,194,24,170
2025-08-15,11,Primaria 6°,SuperSchool,235,2,233
2025-08-15,11,Primaria 6°,TopKids,161,22,139
2025-08-15,11,Primaria 6°,EduMax,167,8,159
2025-08-15,11,Primaria 6°,SuperSchool,214,7,207
2025-08-15,11,Primaria 6°,EduMax,62,16,46
2025-08-15,11,Primaria 6°,EduMax,208,5,203
2025-08-15,12,Preescolar,SuperSchool,199,23,176
2025-08-15,12,Preescolar,SuperSchool,86,14,72
2025-08-15,12,Preescolar,TopKids,261,12,249
2025-08-15,12,Preescolar,TopKids,297,12,285
2025-08-15,12,Preescolar,EduMax,186,1,185
2025-08-15,12,Preescolar,TopKids,93,20,73
2025-08-15,12,Preescolar,SuperSchool,168,6,162
2025-08-15,12,Preescolar,EduMax,251,16,235
2025-08-15,12,Preescolar,TopKids,210,16,194
2025-08-15,12,Preescolar,EduMax,132,2,130
2025-08-15,12,Preescolar,EduMax,283,4,279
2025-08-15,12,Preescolar,SuperSchool,242,15,227
2025-08-15,12,Preescolar,EduMax,163,16,147
2025-08-15,12,Preescolar,SuperSchool,107,15,92
2025-08-15,12,Preescolar,EduMax,229,4,225
2025-08-15,12,Preescolar,SuperSchool,88,23,65
2025-08-15,12,Preescolar,EduMax,252,10,242
2025-08-15,12,Preescolar,SuperSchool,124,24,100
2025-08-15,12,Preescolar,EduMax,191,14,177
2025-08-15,12,Kínder,TopKids,220,22,198
2025-08-15,12,Kínder,TopKids,233,2,231
2025-08-15,12,Kínder,TopKids,228,14,214
2025-08-15,12,Kínder,TopKids,111,7,104
2025-08-15,12,Kínder,TopKids,240,15,225
2025-08-15,12,Kínder,SuperSchool,121,14,107
2025-08-15,12,Kínder,SuperSchool,149,7,142
2025-08-15,12,Kínder,TopKids,99,14,85
2025-08-15,12,Kínder,EduMax,125,10,115
2025-08-15,12,Kínder,TopKids,191,9,182
2025-08-15,12,Kínder,EduMax,143,5,138
2025-08-15,12,Primaria 1°,SuperSchool,234,20,214
2025-08-15,12,Primaria 1°,SuperSchool,252,12,240
2025-08-15,12,Primaria 1°,TopKids,247,11,236
2025-08-15,12,Primaria 1°,SuperSchool,94,11,83
2025-08-15,12,Primaria 1°,SuperSchool,251,2,249
2025-08-15,12,Primaria 2°,EduMax,161,17,144
2025-08-15,12,Primaria 2°,TopKids,147,24,123
2025-08-15,12,Primaria 2°,TopKids,54,16,38
2025-08-15,12,Primaria 2°,EduMax,275,16,259
2025-08-15,12,Primaria 2°,SuperSchool,278,8,270
2025-08-15,12,Primaria 2°,SuperSchool,229,14,215
2025-08-15,12,Primaria 2°,SuperSchool,283,23,260
2025-08-15,12,Primaria 2°,EduMax,244,18,226
2025-08-15,12,Primaria 2°,SuperSchool,83,21,62
2025-08-15,12,Primaria 2°,SuperSchool,58,2,56
2025-08-15,12,Primaria 2°,SuperSchool,88,7,81
2025-08-15,12,Primaria 2°,EduMax,118,8,110
2025-08-15,12,Primaria 3°,EduMax,67,6,61
2025-08-15,12,Primaria 3°,EduMax,131,17,114
2025-08-15,12,Primaria 3°,SuperSchool,286,16,270
2025-08-15,12,Primaria 3°,SuperSchool,187,10,177
2025-08-15,12,Primaria 3°,TopKids,185,15,170
2025-08-15,12,Primaria 3°,SuperSchool,175,23,152
2025-08-15,12,Primaria 3°,TopKids,288,8,280
2025-08-15,12,Primaria 3°,TopKids,186,24,162
2025-08-15,12,Primaria 3°,SuperSchool,281,12,269
2025-08-15,12,Primaria 3°,TopKids,192,4,188
2025-08-15,12,Primaria 3°,EduMax,177,16,161
2025-08-15,12,Primaria 4°,SuperSchool,150,23,127
2025-08-15,12,Primaria 4°,SuperSchool,224,17,207
2025-08-15,12,Primaria 4°,SuperSchool,175,22,153
2025-08-15,12,Primaria 4°,TopKids,229,22,207
2025-08-15,12,Primaria 4°,SuperSchool,132,7,125
2025-08-15,12,Primaria 4°,TopKids,190,14,176
2025-08-15,12,Primaria 4°,TopKids,158,2,156
2025-08-15,12,Primaria 4°,EduMax,101,7,94
2025-08-15,12,Primaria 4°,SuperSchool,191,9,182
2025-08-15,12,Primaria 4°,EduMax,112,7,105
2025-08-15,12,Primaria 4°,EduMax,266,14,252
2025-08-15,12,Primaria 4°,SuperSchool,77,2,75
2025-08-15,12,Primaria 4°,TopKids,66,20,46
2025-08-15,12,Primaria 4°,SuperSchool,259,3,256
2025-08-15,12,Primaria 5°,SuperSchool,146,9,137
2025-08-15,12,Primaria 5°,TopKids,51,1,50
2025-08-15,12,Primaria 5°,EduMax,254,10,244
2025-08-15,12,Primaria 5°,SuperSchool,111,11,100
2025-08-15,12,Primaria 5°,SuperSchool,170,9,161
2025-08-15,12,Primaria 5°,SuperSchool,237,20,217
2025-08-15,12,Primaria 5°,TopKids,79,11,68
2025-08-15,12,Primaria 6°,SuperSchool,92,9,83
2025-08-15,12,Primaria 6°,TopKids,65,23,42
2025-08-15,12,Primaria 6°,EduMax,136,5,131
2025-08-15,12,Primaria 6°,EduMax,164,1,163
2025-08-15,12,Primaria 6°,TopKids,289,18,271
2025-08-15,12,Primaria 6°,SuperSchool,274,10,264
2025-08-15,12,Primaria 6°,TopKids,86,13,73
2025-08-15,12,Primaria 6°,EduMax,65,24,41
2025-08-15,12,Primaria 6°,EduMax,63,11,52
2025-08-15,12,Primaria 6°,TopKids,136,2,134
2025-08-15,12,Primaria 6°,SuperSchool,216,12,204
2025-08-15,13,Preescolar,EduMax,164,4,160
2025-08-15,13,Preescolar,SuperSchool,237,12,225
2025-08-15,13,Preescolar,SuperSchool,231,17,214
2025-08-15,13,Preescolar,EduMax,133,24,109
2025-08-15,13,Preescolar,EduMax,199,24,175
2025-08-15,13,Preescolar,SuperSchool,118,17,101
2025-08-15,13,Preescolar,SuperSchool,147,2,145
2025-08-15,13,Preescolar,SuperSchool,168,7,161
2025-08-15,13,Preescolar,TopKids,277,13,264
2025-08-15,13,Preescolar,EduMax,207,11,196
2025-08-15,13,Preescolar,TopKids,299,3,296
2025-08-15,13,Preescolar,TopKids,243,16,227
2025-08-15,13,Preescolar,TopKids,233,15,218
2025-08-15,13,Preescolar,SuperSchool,161,20,141
2025-08-15,13,Preescolar,TopKids,161,5,156
2025-08-15,13,Preescolar,EduMax,274,22,252
2025-08-15,13,Kínder,SuperSchool,65,5,60
2025-08-15,13,Kínder,TopKids,236,15,221
2025-08-15,13,Kínder,TopKids,170,19,151
2025-08-15,13,Kínder,EduMax,262,9,253
2025-08-15,13,Kínder,EduMax,164,22,142
2025-08-15,13,Kínder,SuperSchool,194,5,189
2025-08-15,13,Kínder,EduMax,280,9,271
2025-08-15,13,Kínder,TopKids,258,3,255
2025-08-15,13,Kínder,EduMax,286,16,270
2025-08-15,13,Kínder,SuperSchool,142,10,132
2025-08-15,13,Kínder,EduMax,276,12,264
2025-08-15,13,Kínder,EduMax,98,7,91
2025-08-15,13,Kínder,EduMax,68,23,45
2025-08-15,13,Kínder,TopKids,249,17,232
2025-08-15,13,Kínder,SuperSchool,75,7,68
2025-08-15,13,Kínder,SuperSchool,89,19,70
2025-08-15,13,Kínder,SuperSchool,69,20,49
2025-08-15,13,Primaria 1°,EduMax,189,24,165
2025-08-15,13,Primaria 1°,SuperSchool,169,21,148
2025-08-15,13,Primaria 1°,SuperSchool,192,24,168
2025-08-15,13,Primaria 1°,EduMax,128,7,121
2025-08-15,13,Primaria 1°,TopKids,229,9,220
2025-08-15,13,Primaria 1°,EduMax,62,24,38
2025-08-15,13,Primaria 1°,SuperSchool,145,19,126
2025-08-15,13,Primaria 1°,EduMax,193,12,181
2025-08-15,13,Primaria 1°,EduMax,243,18,225
2025-08-15,13,Primaria 1°,SuperSchool,142,24,118
2025-08-15,13,Primaria 1°,EduMax,189,22,167
2025-08-15,13,Primaria 1°,SuperSchool,92,23,69
2025-08-15,13,Primaria 1°,EduMax,83,16,67
2025-08-15,13,Primaria 1°,SuperSchool,245,6,239
2025-08-15,13,Primaria 1°,EduMax,294,20,274
2025-08-15,13,Primaria 1°,EduMax,133,15,118
2025-08-15,13,Primaria 1°,TopKids,120,18,102
2025-08-15,13,Primaria 1°,SuperSchool,200,2,198
2025-08-15,13,Primaria 1°,TopKids,146,21,125
2025-08-15,13,Primaria 2°,SuperSchool,234,13,221
2025-08-15,13,Primaria 2°,EduMax,288,24,264
2025-08-15,13,Primaria 2°,SuperSchool,184,8,176
2025-08-15,13,Primaria 2°,TopKids,127,4,123
2025-08-15,13,Primaria 2°,SuperSchool,238,14,224
2025-08-15,13,Primaria 3°,EduMax,143,16,127
2025-08-15,13,Primaria 3°,TopKids,263,14,249
2025-08-15,13,Primaria 3°,EduMax,115,22,93
2025-08-15,13,Primaria 3°,SuperSchool,244,18,226
2025-08-15,13,Primaria 3°,EduMax,149,21,128
2025-08-15,13,Primaria 3°,SuperSchool,132,16,116
2025-08-15,13,Primaria 3°,TopKids,104,15,89
2025-08-15,13,Primaria 3°,SuperSchool,161,15,146
2025-08-15,13,Primaria 3°,EduMax,69,1,68
2025-08-15,13,Primaria 3°,SuperSchool,246,5,241
2025-08-15,13,Primaria 3°,EduMax,216,13,203
2025-08-15,13,Primaria 3°,EduMax,298,4,294
2025-08-15,13,Primaria 3°,TopKids,70,21,49
2025-08-15,13,Primaria 3°,EduMax,73,15,58
2025-08-15,13,Primaria 4°,TopKids,132,6,126
2025-08-15,13,Primaria 4°,EduMax,253,14,239
2025-08-15,13,Primaria 4°,EduMax,173,12,161
2025-08-15,13,Primaria 4°,TopKids,132,8,124
2025-08-15,13,Primaria 4°,SuperSchool,246,5,241
2025-08-15,13,Primaria 4°,EduMax,264,3,261
2025-08-15,13,Primaria 4°,SuperSchool,210,11,199
2025-08-15,13,Primaria 4°,EduMax,198,20,178
2025-08-15,13,Primaria 4°,SuperSchool,280,15,265
2025-08-15,13,Primaria 5°,SuperSchool,185,2,183
2025-08-15,13,Primaria 5°,EduMax,190,12,178
2025-08-15,13,Primaria 5°,SuperSchool,62,6,56
2025-08-15,13,Primaria 5°,SuperSchool,288,23,265
2025-08-15,13,Primaria 5°,EduMax,70,22,48
2025-08-15,13,Primaria 6°,EduMax,252,4,248
2025-08-15,13,Primaria 6°,SuperSchool,160,12,148
2025-08-15,13,Primaria 6°,SuperSchool,209,11,198
2025-08-15,13,Primaria 6°,SuperSchool,201,7,194
2025-08-15,13,Primaria 6°,SuperSchool,266,1,265
2025-08-15,13,Primaria 6°,TopKids,153,11,142
2025-08-15,13,Primaria 6°,SuperSchool,95,1,94
2025-08-15,13,Primaria 6°,EduMax,294,6,288
2025-08-15,13,Primaria 6°,TopKids,251,12,239
2025-08-15,13,Primaria 6°,EduMax,103,2,101
2025-08-15,13,Primaria 6°,TopKids,205,22,183
2025-08-15,13,Primaria 6°,SuperSchool,65,13,52
2025-08-15,13,Primaria 6°,EduMax,220,23,197
2025-08-15,13,Primaria 6°,EduMax,209,3,206
2025-08-15,13,Primaria 6°,TopKids,260,22,238
2025-08-15,13,Primaria 6°,SuperSchool,242,5,237
2025-08-15,13,Primaria 6°,SuperSchool,82,19,63
2025-08-15,13,Primaria 6°,TopKids,213,19,194
2025-08-15,13,Primaria 6°,EduMax,173,15,158
2025-08-15,14,Preescolar,SuperSchool,73,17,56
2025-08-15,14,Preescolar,TopKids,290,23,267
2025-08-15,14,Preescolar,SuperSchool,90,14,76
2025-08-15,14,Preescolar,TopKids,105,1,104
2025-08-15,14,Preescolar,EduMax,195,18,177
2025-08-15,14,Preescolar,EduMax,229,8,221
2025-08-15,14,Preescolar,SuperSchool,288,10,278
2025-08-15,14,Preescolar,EduMax,245,10,235
2025-08-15,14,Kínder,SuperSchool,58,5,53
2025-08-15,14,Kínder,SuperSchool,188,3,185
2025-08-15,14,Kínder,TopKids,245,10,235
2025-08-15,14,Kínder,TopKids,274,6,268
2025-08-15,14,Kínder,SuperSchool,201,7,194
2025-08-15,14,Kínder,SuperSchool,282,11,271
2025-08-15,14,Kínder,TopKids,51,23,28
2025-08-15,14,Kínder,TopKids,276,17,259
2025-08-15,14,Kínder,EduMax,110,3,107
2025-08-15,14,Kínder,EduMax,84,21,63
2025-08-15,14,Kínder,SuperSchool,152,2,150
2025-08-15,14,Kínder,SuperSchool,184,20,164
2025-08-15,14,Kínder,TopKids,168,6,162
2025-08-15,14,Kínder,TopKids,149,19,130
2025-08-15,14,Kínder,SuperSchool,100,14,86
2025-08-15,14,Primaria 1°,EduMax,117,11,106
2025-08-15,14,Primaria 1°,TopKids,248,2,246
2025-08-15,14,Primaria 1°,SuperSchool,235,1,234
2025-08-15,14,Primaria 1°,EduMax,164,7,157
2025-08-15,14,Primaria 1°,SuperSchool,262,18,244
2025-08-15,14,Primaria 1°,EduMax,209,13,196
2025-08-15,14,Primaria 1°,SuperSchool,251,9,242
2025-08-15,14,Primaria 2°,SuperSchool,274,7,267
2025-08-15,14,Primaria 2°,TopKids,102,12,90
2025-08-15,14,Primaria 2°,EduMax,232,10,222
2025-08-15,14,Primaria 2°,EduMax,152,4,148
2025-08-15,14,Primaria 2°,EduMax,137,18,119
2025-08-15,14,Primaria 3°,SuperSchool,90,8,82
2025-08-15,14,Primaria 3°,EduMax,133,18,115
2025-08-15,14,Primaria 3°,EduMax,116,18,98
2025-08-15,14,Primaria 3°,TopKids,281,18,263
2025-08-15,14,Primaria 3°,TopKids,84,6,78
2025-08-15,14,Primaria 3°,EduMax,75,21,54
2025-08-15,14,Primaria 3°,SuperSchool,137,15,122
2025-08-15,14,Primaria 3°,TopKids,81,12,69
2025-08-15,14,Primaria 3°,SuperSchool,113,7,106
2025-08-15,14,Primaria 3°,EduMax,204,15,189
2025-08-15,14,Primaria 3°,TopKids,94,3,91
2025-08-15,14,Primaria 3°,EduMax,72,13,59
2025-08-15,14,Primaria 3°,EduMax,180,2,178
2025-08-15,14,Primaria 4°,TopKids,213,17,196
2025-08-15,14,Primaria 4°,EduMax,188,6,182
2025-08-15,14,Primaria 4°,EduMax,211,17,194
2025-08-15,14,Primaria 4°,TopKids,157,14,143
2025-08-15,14,Primaria 4°,EduMax,135,22,113
2025-08-15,14,Primaria 4°,SuperSchool,118,10,108
2025-08-15,14,Primaria 4°,EduMax,166,9,157
2025-08-15,14,Primaria 4°,EduMax,262,13,249
2025-08-15,14,Primaria 4°,EduMax,151,11,140
2025-08-15,14,Primaria 4°,EduMax,287,17,270
2025-08-15,14,Primaria 4°,EduMax,155,3,152
2025-08-15,14,Primaria 4°,TopKids,152,1,151
2025-08-15,14,Primaria 4°,TopKids,146,8,138
2025-08-15,14,Primaria 4°,EduMax,191,2,189
2025-08-15,14,Primaria 4°,TopKids,155,7,148
2025-08-15,14,Primaria 4°,SuperSchool,103,21,82
2025-08-15,14,Primaria 5°,TopKids,299,14,285
2025-08-15,14,Primaria 5°,TopKids,51,2,49
2025-08-15,14,Primaria 5°,SuperSchool,157,15,142
2025-08-15,14,Primaria 5°,SuperSchool,127,16,111
2025-08-15,14,Primaria 5°,TopKids,185,24,161
2025-08-15,14,Primaria 5°,SuperSchool,246,12,234
2025-08-15,14,Primaria 5°,EduMax,195,5,190
2025-08-15,14,Primaria 5°,EduMax,218,15,203
2025-08-15,14,Primaria 5°,EduMax,290,19,271
2025-08-15,14,Primaria 5°,SuperSchool,224,14,210
2025-08-15,14,Primaria 5°,SuperSchool,66,1,65
2025-08-15,14,Primaria 5°,TopKids,270,21,249
2025-08-15,14,Primaria 5°,EduMax,158,8,150
2025-08-15,14,Primaria 5°,EduMax,126,16,110
2025-08-15,14,Primaria 5°,EduMax,94,18,76
2025-08-15,14,Primaria 5°,TopKids,222,19,203
2025-08-15,14,Primaria 5°,SuperSchool,292,4,288
2025-08-15,14,Primaria 5°,TopKids,99,6,93
2025-08-15,14,Primaria 5°,TopKids,170,4,166
2025-08-15,14,Primaria 6°,TopKids,112,7,105
2025-08-15,14,Primaria 6°,EduMax,296,16,280
2025-08-15,14,Primaria 6°,TopKids,97,5,92
2025-08-15,14,Primaria 6°,TopKids,264,4,260
2025-08-15,14,Primaria 6°,SuperSchool,222,19,203
2025-08-15,14,Primaria 6°,TopKids,285,9,276
2025-08-15,14,Primaria 6°,SuperSchool,115,16,99
2025-08-15,14,Primaria 6°,TopKids,174,18,156
2025-08-15,15,Preescolar,SuperSchool,240,3,237
2025-08-15,15,Preescolar,TopKids,70,11,59
2025-08-15,15,Preescolar,EduMax,160,3,157
2025-08-15,15,Preescolar,EduMax,265,13,252
2025-08-15,15,Preescolar,TopKids,167,8,159
2025-08-15,15,Preescolar,EduMax,117,18,99
2025-08-15,15,Preescolar,TopKids,284,4,280
2025-08-15,15,Preescolar,SuperSchool,154,9,145
2025-08-15,15,Preescolar,TopKids,134,19,115
2025-08-15,15,Preescolar,TopKids,138,12,126
2025-08-15,15,Preescolar,SuperSchool,188,20,168
2025-08-15,15,Kínder,SuperSchool,203,21,182
2025-08-15,15,Kínder,EduMax,113,16,97
2025-08-15,15,Kínder,EduMax,80,4,76
2025-08-15,15,Kínder,EduMax,75,20,55
2025-08-15,15,Kínder,SuperSchool,93,9,84
2025-08-15,15,Kínder,TopKids,58,7,51
2025-08-15,15,Kínder,EduMax,73,12,61
2025-08-15,15,Kínder,EduMax,263,16,247
2025-08-15,15,Kínder,SuperSchool,209,19,190
2025-08-15,15,Kínder,TopKids,84,11,73
2025-08-15,15,Kínder,TopKids,102,20,82
2025-08-15,15,Kínder,TopKids,281,20,261
2025-08-15,15,Kínder,EduMax,276,10,266
2025-08-15,15,Kínder,SuperSchool,282,6,276
2025-08-15,15,Kínder,TopKids,65,5,60
2025-08-15,15,Primaria 1°,SuperSchool,228,2,226
2025-08-15,15,Primaria 1°,EduMax,172,1,171
2025-08-15,15,Primaria 1°,TopKids,64,14,50
2025-08-15,15,Primaria 1°,TopKids,112,5,107
2025-08-15,15,Primaria 1°,SuperSchool,139,16,123
2025-08-15,15,Primaria 1°,SuperSchool,156,15,141
2025-08-15,15,Primaria 1°,TopKids,215,21,194
2025-08-15,15,Primaria 1°,TopKids,126,1,125
2025-08-15,15,Primaria 1°,SuperSchool,230,14,216
2025-08-15,15,Primaria 2°,EduMax,268,15,253
2025-08-15,15,Primaria 2°,TopKids,227,9,218
2025-08-15,15,Primaria 2°,EduMax,52,4,48
2025-08-15,15,Primaria 2°,TopKids,54,20,34
2025-08-15,15,Primaria 2°,SuperSchool,187,16,171
2025-08-15,15,Primaria 2°,TopKids,74,12,62
2025-08-15,15,Primaria 3°,EduMax,63,22,41
2025-08-15,15,Primaria 3°,TopKids,205,19,186
2025-08-15,15,Primaria 3°,EduMax,219,20,199
2025-08-15,15,Primaria 3°,TopKids,263,15,248
2025-08-15,15,Primaria 3°,TopKids,231,2,229
2025-08-15,15,Primaria 3°,SuperSchool,201,6,195
2025-08-15,15,Primaria 3°,SuperSchool,205,18,187
2025-08-15,15,Primaria 3°,TopKids,277,23,254
2025-08-15,15,Primaria 3°,SuperSchool,59,21,38
2025-08-15,15,Primaria 3°,EduMax,211,11,200
2025-08-15,15,Primaria 3°,TopKids,188,1,187
2025-08-15,15,Primaria 3°,EduMax,95,1,94
2025-08-15,15,Primaria 3°,SuperSchool,111,23,88
2025-08-15,15,Primaria 4°,SuperSchool,233,1,232
2025-08-15,15,Primaria 4°,SuperSchool,71,22,49
2025-08-15,15,Primaria 4°,SuperSchool,228,10,218
2025-08-15,15,Primaria 4°,TopKids,192,20,172
2025-08-15,15,Primaria 4°,SuperSchool,229,14,215
2025-08-15,15,Primaria 4°,SuperSchool,206,15,191
2025-08-15,15,Primaria 4°,TopKids,268,16,252
2025-08-15,15,Primaria 4°,SuperSchool,90,1,89
2025-08-15,15,Primaria 4°,SuperSchool,282,20,262
2025-08-15,15,Primaria 4°,SuperSchool,213,16,197
2025-08-15,15,Primaria 4°,EduMax,235,16,219
2025-08-15,15,Primaria 4°,EduMax,179,16,163
2025-08-15,15,Primaria 4°,SuperSchool,274,16,258
2025-08-15,15,Primaria 5°,TopKids,111,11,100
2025-08-15,15,Primaria 5°,EduMax,258,4,254
2025-08-15,15,Primaria 5°,SuperSchool,117,19,98
2025-08-15,15,Primaria 5°,SuperSchool,210,14,196
2025-08-15,15,Primaria 5°,TopKids,74,7,67
2025-08-15,15,Primaria 5°,SuperSchool,85,10,75
2025-08-15,15,Primaria 5°,SuperSchool,85,19,66
2025-08-15,15,Primaria 6°,SuperSchool,183,7,176
2025-08-15,15,Primaria 6°,EduMax,298,12,286
2025-08-15,15,Primaria 6°,SuperSchool,291,2,289
2025-08-15,15,Primaria 6°,SuperSchool,258,21,237
2025-08-15,15,Primaria 6°,SuperSchool,136,9,127
2025-08-15,15,Primaria 6°,EduMax,239,2,237
2025-08-15,16,Preescolar,SuperSchool,116,16,100
2025-08-15,16,Preescolar,SuperSchool,265,15,250
2025-08-15,16,Preescolar,SuperSchool,157,23,134
2025-08-15,16,Preescolar,EduMax,87,3,84
2025-08-15,16,Preescolar,TopKids,245,10,235
2025-08-15,16,Preescolar,EduMax,294,24,270
2025-08-15,16,Preescolar,TopKids,152,7,145
2025-08-15,16,Preescolar,EduMax,228,19,209
2025-08-15,16,Preescolar,EduMax,224,1,223
2025-08-15,16,Preescolar,EduMax,87,22,65
2025-08-15,16,Kínder,EduMax,221,24,197
2025-08-15,16,Kínder,EduMax,119,6,113
2025-08-15,16,Kínder,SuperSchool,157,23,134
2025-08-15,16,Kínder,TopKids,123,14,109
2025-08-15,16,Kínder,TopKids,200,24,176
2025-08-15,16,Kínder,SuperSchool,178,8,170
2025-08-15,16,Kínder,TopKids,63,17,46
2025-08-15,16,Kínder,EduMax,288,6,282
2025-08-15,16,Kínder,SuperSchool,287,19,268
2025-08-15,16,Kínder,SuperSchool,153,3,150
2025-08-15,16,Kínder,EduMax,281,16,265
2025-08-15,16,Kínder,EduMax,128,21,107
2025-08-15,16,Kínder,TopKids,193,1,192
2025-08-15,16,Kínder,EduMax,196,5,191
2025-08-15,16,Kínder,EduMax,116,4,112
2025-08-15,16,Kínder,TopKids,282,1,281
2025-08-15,16,Kínder,SuperSchool,257,9,248
2025-08-15,16,Primaria 1°,EduMax,172,17,155
2025-08-15,16,Primaria 1°,TopKids,174,12,162
2025-08-15,16,Primaria 1°,EduMax,153,16,137
2025-08-15,16,Primaria 1°,SuperSchool,198,1,197
2025-08-15,16,Primaria 1°,SuperSchool,233,21,212
2025-08-15,16,Primaria 1°,EduMax,67,15,52
2025-08-15,16,Primaria 1°,SuperSchool,204,10,194
2025-08-15,16,Primaria 1°,SuperSchool,222,3,219
2025-08-15,16,Primaria 1°,EduMax,204,23,181
2025-08-15,16,Primaria 1°,TopKids,82,2,80
2025-08-15,16,Primaria 1°,TopKids,223,10,213
2025-08-15,16,Primaria 1°,TopKids,296,1,295
2025-08-15,16,Primaria 1°,EduMax,184,15,169
2025-08-15,16,Primaria 1°,EduMax,188,6,182
2025-08-15,16,Primaria 1°,TopKids,295,7,288
2025-08-15,16,Primaria 2°,SuperSchool,251,21,230
2025-08-15,16,Primaria 2°,TopKids,207,8,199
2025-08-15,16,Primaria 2°,TopKids,52,23,29
2025-08-15,16,Primaria 2°,TopKids,85,6,79
2025-08-15,16,Primaria 2°,SuperSchool,91,18,73
2025-08-15,16,Primaria 2°,EduMax,279,19,260
2025-08-15,16,Primaria 2°,SuperSchool,99,13,86
2025-08-15,16,Primaria 2°,TopKids,165,12,153
2025-08-15,16,Primaria 2°,EduMax,108,12,96
2025-08-15,16,Primaria 2°,EduMax,97,14,83
2025-08-15,16,Primaria 2°,SuperSchool,98,3,95
2025-08-15,16,Primaria 3°,TopKids,126,9,117
2025-08-15,16,Primaria 3°,SuperSchool,154,8,146
2025-08-15,16,Primaria 3°,SuperSchool,65,16,49
2025-08-15,16,Primaria 3°,TopKids,77,19,58
2025-08-15,16,Primaria 3°,SuperSchool,159,20,139
2025-08-15,16,Primaria 3°,EduMax,255,14,241
2025-08-15,16,Primaria 3°,EduMax,133,13,120
2025-08-15,16,Primaria 3°,TopKids,218,2,216
2025-08-15,16,Primaria 3°,EduMax,236,3,233
2025-08-15,16,Primaria 3°,EduMax,133,2,131
2025-08-15,16,Primaria 4°,EduMax,217,17,200
2025-08-15,16,Primaria 4°,EduMax,167,1,166
2025-08-15,16,Primaria 4°,EduMax,216,15,201
2025-08-15,16,Primaria 4°,EduMax,250,8,242
2025-08-15,16,Primaria 4°,SuperSchool,272,10,262
2025-08-15,16,Primaria 4°,SuperSchool,53,20,33
2025-08-15,16,Primaria 4°,SuperSchool,153,23,130
2025-08-15,16,Primaria 4°,TopKids,234,15,219
2025-08-15,16,Primaria 4°,SuperSchool,193,23,170
2025-08-15,16,Primaria 4°,TopKids,291,1,290
2025-08-15,16,Primaria 4°,SuperSchool,65,23,42
2025-08-15,16,Primaria 4°,SuperSchool,229,21,208
2025-08-15,16,Primaria 4°,EduMax,171,6,165
2025-08-15,16,Primaria 4°,TopKids,123,22,101
2025-08-15,16,Primaria 4°,SuperSchool,275,19,256
2025-08-15,16,Primaria 5°,EduMax,141,13,128
2025-08-15,16,Primaria 5°,SuperSchool,61,18,43
2025-08-15,16,Primaria 5°,SuperSchool,227,23,204
2025-08-15,16,Primaria 5°,SuperSchool,231,2,229
2025-08-15,16,Primaria 5°,EduMax,240,9,231
2025-08-15,16,Primaria 5°,EduMax,112,8,104
2025-08-15,16,Primaria 5°,TopKids,180,9,171
2025-08-15,16,Primaria 5°,SuperSchool,186,20,166
2025-08-15,16,Primaria 6°,EduMax,168,13,155
2025-08-15,16,Primaria 6°,TopKids,144,13,131
2025-08-15,16,Primaria 6°,SuperSchool,286,17,269
2025-08-15,16,Primaria 6°,TopKids,106,22,84
2025-08-15,16,Primaria 6°,TopKids,116,14,102
2025-08-15,16,Primaria 6°,EduMax,187,17,170
2025-08-15,16,Primaria 6°,SuperSchool,281,18,263
2025-08-15,16,Primaria 6°,SuperSchool,72,11,61
2025-08-15,16,Primaria 6°,SuperSchool,167,24,143
2025-08-15,16,Primaria 6°,SuperSchool,104,15,89
2025-08-15,16,Primaria 6°,SuperSchool,61,11,50
2025-08-15,16,Primaria 6°,SuperSchool,215,8,207
2025-08-15,16,Primaria 6°,EduMax,266,15,251
2025-08-15,16,Primaria 6°,SuperSchool,99,11,88
2025-08-15,16,Primaria 6°,SuperSchool,282,8,274
2025-08-15,16,Primaria 6°,TopKids,102,18,84
2025-08-18,9,Preescolar,TopKids,194,4,190
2025-08-18,9,Preescolar,SuperSchool,205,18,187
2025-08-18,9,Preescolar,TopKids,192,19,173
2025-08-18,9,Preescolar,EduMax,119,15,104
2025-08-18,9,Preescolar,TopKids,157,16,141
2025-08-18,9,Preescolar,SuperSchool,69,5,64
2025-08-18,9,Preescolar,TopKids,179,22,157
2025-08-18,9,Preescolar,SuperSchool,113,7,106
2025-08-18,9,Preescolar,EduMax,169,22,147
2025-08-18,9,Preescolar,EduMax,95,8,87
2025-08-18,9,Preescolar,SuperSchool,159,14,145
2025-08-18,9,Preescolar,TopKids,84,1,83
2025-08-18,9,Preescolar,SuperSchool,58,9,49
2025-08-18,9,Preescolar,EduMax,240,2,238
2025-08-18,9,Preescolar,EduMax,119,23,96
2025-08-18,9,Preescolar,SuperSchool,274,19,255
2025-08-18,9,Preescolar,TopKids,210,10,200
2025-08-18,9,Preescolar,SuperSchool,237,12,225
2025-08-18,9,Kínder,SuperSchool,66,4,62
2025-08-18,9,Kínder,SuperSchool,232,7,225
2025-08-18,9,Kínder,SuperSchool,182,6,176
2025-08-18,9,Kínder,EduMax,294,7,287
2025-08-18,9,Kínder,EduMax,234,22,212
2025-08-18,9,Kínder,EduMax,187,4,183
2025-08-18,9,Kínder,TopKids,202,23,179
2025-08-18,9,Kínder,TopKids,255,6,249
2025-08-18,9,Kínder,TopKids,160,8,152
2025-08-18,9,Kínder,SuperSchool,52,3,49
2025-08-18,9,Kínder,SuperSchool,211,24,187
2025-08-18,9,Kínder,SuperSchool,125,8,117
2025-08-18,9,Kínder,TopKids,58,14,44
2025-08-18,9,Kínder,TopKids,195,10,185
2025-08-18,9,Kínder,SuperSchool,247,1,246
2025-08-18,9,Primaria 1°,EduMax,138,13,125
2025-08-18,9,Primaria 1°,EduMax,264,4,260
2025-08-18,9,Primaria 1°,SuperSchool,262,2,260
2025-08-18,9,Primaria 1°,SuperSchool,59,23,36
2025-08-18,9,Primaria 1°,TopKids,179,3,176
2025-08-18,9,Primaria 1°,EduMax,298,15,283
2025-08-18,9,Primaria 1°,SuperSchool,218,2,216
2025-08-18,9,Primaria 1°,TopKids,129,11,118
2025-08-18,9,Primaria 1°,SuperSchool,50,2,48
2025-08-18,9,Primaria 2°,EduMax,299,19,280
2025-08-18,9,Primaria 2°,EduMax,68,10,58
2025-08-18,9,Primaria 2°,SuperSchool,225,18,207
2025-08-18,9,Primaria 2°,EduMax,144,13,131
2025-08-18,9,Primaria 2°,SuperSchool,236,7,229
2025-08-18,9,Primaria 2°,SuperSchool,232,24,208
2025-08-18,9,Primaria 2°,SuperSchool,291,6,285
2025-08-18,9,Primaria 2°,SuperSchool,270,6,264
2025-08-18,9,Primaria 2°,EduMax,98,12,86
2025-08-18,9,Primaria 2°,TopKids,140,5,135
2025-08-18,9,Primaria 2°,TopKids,251,10,241
2025-08-18,9,Primaria 2°,TopKids,106,4,102
2025-08-18,9,Primaria 2°,EduMax,227,3,224
2025-08-18,9,Primaria 2°,SuperSchool,276,5,271
2025-08-18,9,Primaria 2°,SuperSchool,252,13,239
2025-08-18,9,Primaria 3°,EduMax,105,13,92
2025-08-18,9,Primaria 3°,SuperSchool,103,5,98
2025-08-18,9,Primaria 3°,TopKids,86,21,65
2025-08-18,9,Primaria 3°,EduMax,144,4,140
2025-08-18,9,Primaria 3°,EduMax,260,10,250
2025-08-18,9,Primaria 3°,SuperSchool,72,23,49
2025-08-18,9,Primaria 3°,SuperSchool,237,18,219
2025-08-18,9,Primaria 4°,SuperSchool,98,15,83
2025-08-18,9,Primaria 4°,TopKids,88,18,70
2025-08-18,9,Primaria 4°,EduMax,260,21,239
2025-08-18,9,Primaria 4°,SuperSchool,148,1,147
2025-08-18,9,Primaria 4°,SuperSchool,242,8,234
2025-08-18,9,Primaria 4°,TopKids,160,11,149
2025-08-18,9,Primaria 4°,EduMax,287,9,278
2025-08-18,9,Primaria 4°,SuperSchool,296,4,292
2025-08-18,9,Primaria 4°,SuperSchool,178,24,154
2025-08-18,9,Primaria 4°,SuperSchool,242,3,239
2025-08-18,9,Primaria 4°,EduMax,249,24,225
2025-08-18,9,Primaria 4°,EduMax,202,16,186
2025-08-18,9,Primaria 4°,TopKids,79,16,63
2025-08-18,9,Primaria 4°,EduMax,258,10,248
2025-08-18,9,Primaria 4°,TopKids,108,10,98
2025-08-18,9,Primaria 4°,TopKids,293,9,284
2025-08-18,9,Primaria 4°,EduMax,239,17,222
2025-08-18,9,Primaria 4°,SuperSchool,58,5,53
2025-08-18,9,Primaria 4°,TopKids,252,8,244
2025-08-18,9,Primaria 5°,EduMax,115,10,105
2025-08-18,9,Primaria 5°,SuperSchool,201,16,185
2025-08-18,9,Primaria 5°,TopKids,236,11,225
2025-08-18,9,Primaria 5°,EduMax,119,7,112
2025-08-18,9,Primaria 5°,SuperSchool,108,3,105
2025-08-18,9,Primaria 5°,SuperSchool,233,3,230
2025-08-18,9,Primaria 5°,EduMax,298,17,281
2025-08-18,9,Primaria 5°,TopKids,83,12,71
2025-08-18,9,Primaria 5°,EduMax,283,11,272
2025-08-18,9,Primaria 5°,TopKids,97,24,73
2025-08-18,9,Primaria 5°,EduMax,76,22,54
2025-08-18,9,Primaria 5°,TopKids,169,9,160
2025-08-18,9,Primaria 5°,SuperSchool,236,19,217
2025-08-18,9,Primaria 6°,SuperSchool,107,16,91
2025-08-18,9,Primaria 6°,EduMax,195,3,192
2025-08-18,9,Primaria 6°,SuperSchool,55,19,36
2025-08-18,9,Primaria 6°,EduMax,164,11,153
2025-08-18,9,Primaria 6°,TopKids,185,5,180
2025-08-18,9,Primaria 6°,SuperSchool,96,21,75
2025-08-18,10,Preescolar,EduMax,181,24,157
2025-08-18,10,Preescolar,SuperSchool,66,2,64
2025-08-18,10,Preescolar,EduMax,211,11,200
2025-08-18,10,Preescolar,EduMax,143,19,124
2025-08-18,10,Preescolar,SuperSchool,176,14,162
2025-08-18,10,Preescolar,TopKids,156,9,147
2025-08-18,10,Preescolar,TopKids,224,20,204
2025-08-18,10,Preescolar,SuperSchool,52,15,37
2025-08-18,10,Preescolar,EduMax,281,4,277
2025-08-18,10,Preescolar,EduMax,187,2,185
2025-08-18,10,Preescolar,EduMax,57,23,34
2025-08-18,10,Preescolar,TopKids,187,18,169
2025-08-18,10,Preescolar,TopKids,150,22,128
2025-08-18,10,Preescolar,SuperSchool,99,2,97
2025-08-18,10,Preescolar,SuperSchool,144,14,130
2025-08-18,10,Preescolar,EduMax,271,4,267
2025-08-18,10,Kínder,TopKids,63,21,42
2025-08-18,10,Kínder,SuperSchool,69,3,66
2025-08-18,10,Kínder,EduMax,128,24,104
2025-08-18,10,Kínder,SuperSchool,106,16,90
2025-08-18,10,Kínder,TopKids,298,8,290
2025-08-18,10,Kínder,TopKids,68,14,54
2025-08-18,10,Kínder,SuperSchool,244,4,240
2025-08-18,10,Kínder,SuperSchool,237,4,233
2025-08-18,10,Kínder,TopKids,100,16,84
2025-08-18,10,Kínder,TopKids,103,17,86
2025-08-18,10,Kínder,EduMax,219,24,195
2025-08-18,10,Kínder,SuperSchool,97,20,77
2025-08-18,10,Kínder,EduMax,247,7,240
2025-08-18,10,Kínder,EduMax,60,12,48
2025-08-18,10,Kínder,EduMax,182,5,177
2025-08-18,10,Kínder,EduMax,104,15,89
2025-08-18,10,Kínder,EduMax,146,24,122
2025-08-18,10,Kínder,TopKids,250,3,247
2025-08-18,10,Kínder,EduMax,149,16,133
2025-08-18,10,Primaria 1°,EduMax,63,16,47
2025-08-18,10,Primaria 1°,SuperSchool,99,16,83
2025-08-18,10,Primaria 1°,EduMax,187,7,180
2025-08-18,10,Primaria 1°,SuperSchool,76,15,61
2025-08-18,10,Primaria 1°,SuperSchool,120,24,96
2025-08-18,10,Primaria 1°,EduMax,276,17,259
2025-08-18,10,Primaria 1°,TopKids,57,2,55
2025-08-18,10,Primaria 1°,TopKids,234,20,214
2025-08-18,10,Primaria 1°,EduMax,172,3,169
2025-08-18,10,Primaria 1°,TopKids,51,19,32
2025-08-18,10,Primaria 1°,SuperSchool,150,20,130
2025-08-18,10,Primaria 2°,SuperSchool,123,9,114
2025-08-18,10,Primaria 2°,EduMax,55,11,44
2025-08-18,10,Primaria 2°,EduMax,80,23,57
2025-08-18,10,Primaria 2°,TopKids,193,22,171
2025-08-18,10,Primaria 2°,TopKids,137,12,125
2025-08-18,10,Primaria 2°,SuperSchool,67,13,54
2025-08-18,10,Primaria 2°,TopKids,129,4,125
2025-08-18,10,Primaria 2°,SuperSchool,210,22,188
2025-08-18,10,Primaria 2°,TopKids,67,22,45
2025-08-18,10,Primaria 2°,SuperSchool,76,10,66
2025-08-18,10,Primaria 2°,TopKids,289,14,275
2025-08-18,10,Primaria 2°,SuperSchool,211,24,187
2025-08-18,10,Primaria 2°,EduMax,237,22,215
2025-08-18,10,Primaria 2°,TopKids,54,12,42
2025-08-18,10,Primaria 2°,TopKids,213,22,191
2025-08-18,10,Primaria 2°,SuperSchool,88,6,82
2025-08-18,10,Primaria 2°,SuperSchool,277,13,264
2025-08-18,10,Primaria 3°,EduMax,293,1,292
2025-08-18,10,Primaria 3°,SuperSchool,217,7,210
2025-08-18,10,Primaria 3°,SuperSchool,116,15,101
2025-08-18,10,Primaria 3°,TopKids,268,17,251
2025-08-18,10,Primaria 3°,SuperSchool,136,13,123
2025-08-18,10,Primaria 3°,TopKids,204,19,185
2025-08-18,10,Primaria 3°,EduMax,294,13,281
2025-08-18,10,Primaria 3°,TopKids,93,24,69
2025-08-18,10,Primaria 4°,TopKids,282,3,279
2025-08-18,10,Primaria 4°,EduMax,284,10,274
2025-08-18,10,Primaria 4°,SuperSchool,98,13,85
2025-08-18,10,Primaria 4°,EduMax,274,2,272
2025-08-18,10,Primaria 4°,EduMax,152,9,143
2025-08-18,10,Primaria 4°,TopKids,117,2,115
2025-08-18,10,Primaria 4°,TopKids,299,5,294
2025-08-18,10,Primaria 4°,SuperSchool,73,13,60
2025-08-18,10,Primaria 4°,EduMax,132,9,123
2025-08-18,10,Primaria 4°,EduMax,228,10,218
2025-08-18,10,Primaria 4°,EduMax,89,16,73
2025-08-18,10,Primaria 4°,SuperSchool,133,4,129
2025-08-18,10,Primaria 4°,EduMax,157,18,139
2025-08-18,10,Primaria 4°,TopKids,54,10,44
2025-08-18,10,Primaria 4°,EduMax,63,6,57
2025-08-18,10,Primaria 4°,EduMax,255,12,243
2025-08-18,10,Primaria 4°,EduMax,76,22,54
2025-08-18,10,Primaria 5°,EduMax,193,20,173
2025-08-18,10,Primaria 5°,EduMax,185,9,176
2025-08-18,10,Primaria 5°,SuperSchool,270,20,250
2025-08-18,10,Primaria 5°,SuperSchool,196,17,179
2025-08-18,10,Primaria 5°,TopKids,173,1,172
2025-08-18,10,Primaria 5°,TopKids,165,14,151
2025-08-18,10,Primaria 5°,SuperSchool,62,2,60
2025-08-18,10,Primaria 5°,TopKids,112,14,98
2025-08-18,10,Primaria 5°,SuperSchool,78,5,73
2025-08-18,10,Primaria 5°,TopKids,260,14,246
2025-08-18,10,Primaria 5°,EduMax,288,5,283
2025-08-18,10,Primaria 5°,SuperSchool,174,21,153
2025-08-18,10,Primaria 5°,EduMax,163,24,139
2025-08-18,10,Primaria 5°,SuperSchool,268,10,258
2025-08-18,10,Primaria 6°,EduMax,213,8,205
2025-08-18,10,Primaria 6°,EduMax,261,17,244
2025-08-18,10,Primaria 6°,EduMax,120,1,119
2025-08-18,10,Primaria 6°,SuperSchool,99,4,95
2025-08-18,10,Primaria 6°,TopKids,133,21,112
2025-08-18,10,Primaria 6°,SuperSchool,272,6,266
2025-08-18,10,Primaria 6°,TopKids,55,13,42
2025-08-18,10,Primaria 6°,TopKids,184,24,160
2025-08-18,10,Primaria 6°,SuperSchool,149,1,148
2025-08-18,10,Primaria 6°,EduMax,73,5,68
2025-08-18,10,Primaria 6°,SuperSchool,228,4,224
2025-08-18,10,Primaria 6°,EduMax,222,5,217
2025-08-18,10,Primaria 6°,SuperSchool,145,10,135
2025-08-18,10,Primaria 6°,TopKids,104,13,91
2025-08-18,11,Preescolar,EduMax,139,3,136
2025-08-18,11,Preescolar,SuperSchool,250,1,249
2025-08-18,11,Preescolar,EduMax,154,21,133
2025-08-18,11,Preescolar,SuperSchool,154,2,152
2025-08-18,11,Preescolar,TopKids,77,16,61
2025-08-18,11,Preescolar,TopKids,65,21,44
2025-08-18,11,Preescolar,SuperSchool,276,10,266
2025-08-18,11,Preescolar,EduMax,81,18,63
2025-08-18,11,Preescolar,EduMax,247,18,229
2025-08-18,11,Preescolar,EduMax,215,22,193
2025-08-18,11,Preescolar,SuperSchool,159,21,138
2025-08-18,11,Preescolar,TopKids,126,15,111
2025-08-18,11,Preescolar,SuperSchool,210,3,207
2025-08-18,11,Preescolar,EduMax,203,22,181
2025-08-18,11,Preescolar,EduMax,117,18,99
2025-08-18,11,Kínder,SuperSchool,267,13,254
2025-08-18,11,Kínder,TopKids,179,10,169
2025-08-18,11,Kínder,EduMax,143,21,122
2025-08-18,11,Kínder,SuperSchool,221,23,198
2025-08-18,11,Kínder,SuperSchool,173,2,171
2025-08-18,11,Kínder,TopKids,289,22,267
2025-08-18,11,Kínder,EduMax,65,20,45
2025-08-18,11,Kínder,EduMax,65,6,59
2025-08-18,11,Kínder,SuperSchool,157,23,134
2025-08-18,11,Kínder,EduMax,86,8,78
2025-08-18,11,Kínder,EduMax,214,20,194
2025-08-18,11,Kínder,EduMax,55,22,33
2025-08-18,11,Kínder,SuperSchool,87,17,70
2025-08-18,11,Kínder,SuperSchool,200,17,183
2025-08-18,11,Kínder,SuperSchool,226,13,213
2025-08-18,11,Kínder,TopKids,135,7,128
2025-08-18,11,Primaria 1°,SuperSchool,55,14,41
2025-08-18,11,Primaria 1°,TopKids,186,15,171
2025-08-18,11,Primaria 1°,SuperSchool,291,10,281
2025-08-18,11,Primaria 1°,EduMax,273,23,250
2025-08-18,11,Primaria 1°,TopKids,178,3,175
2025-08-18,11,Primaria 1°,SuperSchool,278,7,271
2025-08-18,11,Primaria 1°,TopKids,277,17,260
2025-08-18,11,Primaria 1°,TopKids,104,4,100
2025-08-18,11,Primaria 1°,TopKids,115,14,101
2025-08-18,11,Primaria 1°,SuperSchool,113,21,92
2025-08-18,11,Primaria 2°,EduMax,208,15,193
2025-08-18,11,Primaria 2°,TopKids,71,10,61
2025-08-18,11,Primaria 2°,EduMax,274,19,255
2025-08-18,11,Primaria 2°,EduMax,138,23,115
2025-08-18,11,Primaria 2°,SuperSchool,295,14,281
2025-08-18,11,Primaria 2°,SuperSchool,145,9,136
2025-08-18,11,Primaria 2°,SuperSchool,63,13,50
2025-08-18,11,Primaria 2°,SuperSchool,279,7,272
2025-08-18,11,Primaria 2°,EduMax,81,8,73
2025-08-18,11,Primaria 2°,EduMax,266,3,263
2025-08-18,11,Primaria 2°,EduMax,227,22,205
2025-08-18,11,Primaria 2°,TopKids,87,11,76
2025-08-18,11,Primaria 2°,TopKids,161,5,156
2025-08-18,11,Primaria 2°,EduMax,83,15,68
2025-08-18,11,Primaria 2°,TopKids,161,24,137
2025-08-18,11,Primaria 2°,SuperSchool,83,16,67
2025-08-18,11,Primaria 2°,TopKids,67,6,61
2025-08-18,11,Primaria 2°,EduMax,269,7,262
2025-08-18,11,Primaria 2°,EduMax,100,9,91
2025-08-18,11,Primaria 3°,TopKids,245,14,231
2025-08-18,11,Primaria 3°,SuperSchool,138,7,131
2025-08-18,11,Primaria 3°,TopKids,132,11,121
2025-08-18,11,Primaria 3°,TopKids,85,18,67
2025-08-18,11,Primaria 3°,EduMax,235,6,229
2025-08-18,11,Primaria 3°,SuperSchool,257,18,239
2025-08-18,11,Primaria 3°,SuperSchool,153,1,152
2025-08-18,11,Primaria 3°,SuperSchool,292,21,271
2025-08-18,11,Primaria 3°,SuperSchool,109,10,99
2025-08-18,11,Primaria 3°,EduMax,189,17,172
2025-08-18,11,Primaria 3°,SuperSchool,249,10,239
2025-08-18,11,Primaria 3°,EduMax,91,18,73
2025-08-18,11,Primaria 3°,SuperSchool,90,2,88
2025-08-18,11,Primaria 3°,TopKids,147,6,141
2025-08-18,11,Primaria 3°,TopKids,200,12,188
2025-08-18,11,Primaria 3°,EduMax,164,15,149
2025-08-18,11,Primaria 3°,TopKids,253,18,235
2025-08-18,11,Primaria 4°,TopKids,221,5,216
2025-08-18,11,Primaria 4°,TopKids,177,24,153
2025-08-18,11,Primaria 4°,EduMax,202,11,191
2025-08-18,11,Primaria 4°,SuperSchool,91,4,87
2025-08-18,11,Primaria 4°,SuperSchool,189,10,179
2025-08-18,11,Primaria 4°,TopKids,287,5,282
2025-08-18,11,Primaria 5°,SuperSchool,129,5,124
2025-08-18,11,Primaria 5°,SuperSchool,78,18,60
2025-08-18,11,Primaria 5°,SuperSchool,183,21,162
2025-08-18,11,Primaria 5°,EduMax,209,10,199
2025-08-18,11,Primaria 5°,TopKids,208,24,184
2025-08-18,11,Primaria 6°,TopKids,203,19,184
2025-08-18,11,Primaria 6°,SuperSchool,158,20,138
2025-08-18,11,Primaria 6°,TopKids,193,7,186
2025-08-18,11,Primaria 6°,SuperSchool,256,8,248
2025-08-18,11,Primaria 6°,TopKids,290,1,289
2025-08-18,11,Primaria 6°,SuperSchool,294,8,286
2025-08-18,11,Primaria 6°,EduMax,81,10,71
2025-08-18,11,Primaria 6°,TopKids,100,8,92
2025-08-18,11,Primaria 6°,TopKids,85,10,75
2025-08-18,11,Primaria 6°,TopKids,212,4,208
2025-08-18,12,Preescolar,SuperSchool,261,20,241
2025-08-18,12,Preescolar,SuperSchool,294,17,277
2025-08-18,12,Preescolar,TopKids,202,16,186
2025-08-18,12,Preescolar,SuperSchool,162,6,156
2025-08-18,12,Preescolar,TopKids,229,24,205
2025-08-18,12,Preescolar,TopKids,245,8,237
2025-08-18,12,Preescolar,SuperSchool,103,1,102
2025-08-18,12,Preescolar,SuperSchool,139,2,137
2025-08-18,12,Preescolar,TopKids,187,23,164
2025-08-18,12,Preescolar,TopKids,162,24,138
2025-08-18,12,Preescolar,SuperSchool,206,14,192
2025-08-18,12,Preescolar,TopKids,144,11,133
2025-08-18,12,Kínder,TopKids,280,10,270
2025-08-18,12,Kínder,SuperSchool,63,3,60
2025-08-18,12,Kínder,SuperSchool,211,17,194
2025-08-18,12,Kínder,SuperSchool,145,3,142
2025-08-18,12,Kínder,EduMax,256,8,248
2025-08-18,12,Kínder,EduMax,203,9,194
2025-08-18,12,Kínder,SuperSchool,81,11,70
2025-08-18,12,Kínder,EduMax,211,9,202
2025-08-18,12,Kínder,EduMax,196,22,174
2025-08-18,12,Kínder,EduMax,86,18,68
2025-08-18,12,Kínder,TopKids,92,19,73
2025-08-18,12,Kínder,SuperSchool,183,13,170
2025-08-18,12,Kínder,TopKids,155,24,131
2025-08-18,12,Kínder,SuperSchool,159,4,155
2025-08-18,12,Primaria 1°,TopKids,145,12,133
2025-08-18,12,Primaria 1°,TopKids,139,10,129
2025-08-18,12,Primaria 1°,TopKids,122,11,111
2025-08-18,12,Primaria 1°,EduMax,286,22,264
2025-08-18,12,Primaria 1°,EduMax,267,8,259
2025-08-18,12,Primaria 1°,SuperSchool,70,21,49
2025-08-18,12,Primaria 1°,SuperSchool,151,13,138
2025-08-18,12,Primaria 1°,SuperSchool,269,6,263
2025-08-18,12,Primaria 2°,TopKids,161,4,157
2025-08-18,12,Primaria 2°,EduMax,66,9,57
2025-08-18,12,Primaria 2°,EduMax,292,20,272
2025-08-18,12,Primaria 2°,EduMax,253,22,231
2025-08-18,12,Primaria 2°,EduMax,157,9,148
2025-08-18,12,Primaria 2°,SuperSchool,166,3,163
2025-08-18,12,Primaria 2°,EduMax,57,10,47
2025-08-18,12,Primaria 2°,TopKids,218,10,208
2025-08-18,12,Primaria 2°,TopKids,174,9,165
2025-08-18,12,Primaria 2°,EduMax,278,9,269
2025-08-18,12,Primaria 2°,EduMax,164,1,163
2025-08-18,12,Primaria 2°,SuperSchool,50,12,38
2025-08-18,12,Primaria 2°,TopKids,114,14,100
2025-08-18,12,Primaria 2°,TopKids,252,7,245
2025-08-18,12,Primaria 2°,EduMax,192,8,184
2025-08-18,12,Primaria 2°,EduMax,165,15,150
2025-08-18,12,Primaria 2°,EduMax,89,10,79
2025-08-18,12,Primaria 2°,TopKids,84,20,64
2025-08-18,12,Primaria 2°,EduMax,282,9,273
2025-08-18,12,Primaria 3°,SuperSchool,87,8,79
2025-08-18,12,Primaria 3°,TopKids,145,8,137
2025-08-18,12,Primaria 3°,EduMax,112,23,89
2025-08-18,12,Primaria 3°,EduMax,271,9,262
2025-08-18,12,Primaria 3°,TopKids,54,21,33
2025-08-18,12,Primaria 3°,EduMax,162,17,145
2025-08-18,12,Primaria 3°,SuperSchool,73,22,51
2025-08-18,12,Primaria 3°,SuperSchool,194,14,180
2025-08-18,12,Primaria 3°,EduMax,267,19,248
2025-08-18,12,Primaria 4°,TopKids,51,2,49
2025-08-18,12,Primaria 4°,EduMax,120,4,116
2025-08-18,12,Primaria 4°,SuperSchool,87,7,80
2025-08-18,12,Primaria 4°,EduMax,250,20,230
2025-08-18,12,Primaria 4°,TopKids,203,4,199
2025-08-18,12,Primaria 4°,EduMax,205,5,200
2025-08-18,12,Primaria 4°,TopKids,123,18,105
2025-08-18,12,Primaria 4°,TopKids,234,1,233
2025-08-18,12,Primaria 4°,SuperSchool,86,8,78
2025-08-18,12,Primaria 4°,EduMax,263,22,241
2025-08-18,12,Primaria 4°,TopKids,66,19,47
2025-08-18,12,Primaria 4°,SuperSchool,94,22,72
2025-08-18,12,Primaria 4°,SuperSchool,219,17,202
2025-08-18,12,Primaria 4°,SuperSchool,131,17,114
2025-08-18,12,Primaria 5°,EduMax,184,5,179
2025-08-18,12,Primaria 5°,TopKids,122,19,103
2025-08-18,12,Primaria 5°,TopKids,250,23,227
2025-08-18,12,Primaria 5°,TopKids,209,20,189
2025-08-18,12,Primaria 5°,TopKids,66,16,50
2025-08-18,12,Primaria 5°,TopKids,107,22,85
2025-08-18,12,Primaria 5°,TopKids,79,21,58
2025-08-18,12,Primaria 5°,TopKids,153,5,148
2025-08-18,12,Primaria 6°,EduMax,183,2,181
2025-08-18,12,Primaria 6°,SuperSchool,164,13,151
2025-08-18,12,Primaria 6°,TopKids,279,6,273
2025-08-18,12,Primaria 6°,EduMax,171,24,147
2025-08-18,12,Primaria 6°,SuperSchool,252,11,241
2025-08-18,12,Primaria 6°,EduMax,158,8,150
2025-08-18,12,Primaria 6°,TopKids,221,3,218
2025-08-18,12,Primaria 6°,SuperSchool,296,5,291
2025-08-18,12,Primaria 6°,EduMax,51,8,43
2025-08-18,12,Primaria 6°,SuperSchool,167,17,150
2025-08-18,12,Primaria 6°,EduMax,275,11,264
2025-08-18,12,Primaria 6°,TopKids,250,6,244
2025-08-18,12,Primaria 6°,EduMax,107,15,92
2025-08-18,12,Primaria 6°,SuperSchool,145,12,133
2025-08-18,13,Preescolar,SuperSchool,181,10,171
2025-08-18,13,Preescolar,SuperSchool,92,16,76
2025-08-18,13,Preescolar,TopKids,58,2,56
2025-08-18,13,Preescolar,TopKids,228,18,210
2025-08-18,13,Preescolar,SuperSchool,69,7,62
2025-08-18,13,Preescolar,TopKids,90,12,78
2025-08-18,13,Preescolar,SuperSchool,84,23,61
2025-08-18,13,Preescolar,EduMax,107,16,91
2025-08-18,13,Preescolar,TopKids,264,5,259
2025-08-18,13,Preescolar,SuperSchool,264,7,257
2025-08-18,13,Preescolar,EduMax,132,17,115
2025-08-18,13,Preescolar,EduMax,143,21,122
2025-08-18,13,Preescolar,SuperSchool,75,19,56
2025-08-18,13,Preescolar,SuperSchool,99,19,80
2025-08-18,13,Preescolar,EduMax,82,4,78
2025-08-18,13,Preescolar,SuperSchool,185,2,183
2025-08-18,13,Preescolar,SuperSchool,72,6,66
2025-08-18,13,Kínder,TopKids,277,14,263
2025-08-18,13,Kínder,SuperSchool,199,9,190
2025-08-18,13,Kínder,EduMax,236,1,235
2025-08-18,13,Kínder,SuperSchool,218,22,196
2025-08-18,13,Kínder,EduMax,193,16,177
2025-08-18,13,Kínder,SuperSchool,177,24,153
2025-08-18,13,Kínder,EduMax,284,1,283
2025-08-18,13,Kínder,TopKids,113,24,89
2025-08-18,13,Kínder,TopKids,111,18,93
2025-08-18,13,Kínder,SuperSchool,120,18,102
2025-08-18,13,Kínder,SuperSchool,101,20,81
2025-08-18,13,Primaria 1°,EduMax,176,1,175
2025-08-18,13,Primaria 1°,EduMax,226,22,204
2025-08-18,13,Primaria 1°,SuperSchool,212,17,195
2025-08-18,13,Primaria 1°,EduMax,285,20,265
2025-08-18,13,Primaria 1°,EduMax,120,10,110
2025-08-18,13,Primaria 1°,EduMax,295,6,289
2025-08-18,13,Primaria 1°,TopKids,237,17,220
2025-08-18,13,Primaria 1°,EduMax,61,17,44
2025-08-18,13,Primaria 1°,TopKids,131,14,117
2025-08-18,13,Primaria 1°,TopKids,179,21,158
2025-08-18,13,Primaria 1°,SuperSchool,252,2,250
2025-08-18,13,Primaria 1°,EduMax,84,20,64
2025-08-18,13,Primaria 1°,SuperSchool,262,20,242
2025-08-18,13,Primaria 1°,TopKids,75,1,74
2025-08-18,13,Primaria 1°,EduMax,110,5,105
2025-08-18,13,Primaria 1°,EduMax,144,1,143
2025-08-18,13,Primaria 1°,TopKids,230,9,221
2025-08-18,13,Primaria 2°,EduMax,190,18,172
2025-08-18,13,Primaria 2°,EduMax,202,12,190
2025-08-18,13,Primaria 2°,EduMax,118,24,94
2025-08-18,13,Primaria 2°,EduMax,229,2,227
2025-08-18,13,Primaria 2°,TopKids,117,11,106
2025-08-18,13,Primaria 2°,SuperSchool,251,6,245
2025-08-18,13,Primaria 2°,TopKids,91,22,69
2025-08-18,13,Primaria 2°,SuperSchool,55,1,54
2025-08-18,13,Primaria 2°,SuperSchool,70,22,48
2025-08-18,13,Primaria 3°,EduMax,198,4,194
2025-08-18,13,Primaria 3°,TopKids,235,22,213
2025-08-18,13,Primaria 3°,EduMax,261,22,239
2025-08-18,13,Primaria 3°,SuperSchool,293,8,285
2025-08-18,13,Primaria 3°,TopKids,96,19,77
2025-08-18,13,Primaria 3°,SuperSchool,67,22,45
2025-08-18,13,Primaria 3°,SuperSchool,87,15,72
2025-08-18,13,Primaria 3°,SuperSchool,235,18,217
2025-08-18,13,Primaria 3°,TopKids,62,1,61
2025-08-18,13,Primaria 3°,EduMax,150,6,144
2025-08-18,13,Primaria 3°,SuperSchool,88,4,84
2025-08-18,13,Primaria 3°,SuperSchool,192,6,186
2025-08-18,13,Primaria 4°,SuperSchool,229,18,211
2025-08-18,13,Primaria 4°,EduMax,80,4,76
2025-08-18,13,Primaria 4°,SuperSchool,95,3,92
2025-08-18,13,Primaria 4°,SuperSchool,268,11,257
2025-08-18,13,Primaria 4°,SuperSchool,221,9,212
2025-08-18,13,Primaria 4°,SuperSchool,128,18,110
2025-08-18,13,Primaria 4°,SuperSchool,222,13,209
2025-08-18,13,Primaria 4°,SuperSchool,251,10,241
2025-08-18,13,Primaria 4°,EduMax,152,22,130
2025-08-18,13,Primaria 4°,TopKids,214,20,194
2025-08-18,13,Primaria 4°,TopKids,133,10,123
2025-08-18,13,Primaria 4°,EduMax,139,21,118
2025-08-18,13,Primaria 4°,SuperSchool,192,6,186
2025-08-18,13,Primaria 5°,TopKids,273,11,262
2025-08-18,13,Primaria 5°,EduMax,274,2,272
2025-08-18,13,Primaria 5°,TopKids,64,4,60
2025-08-18,13,Primaria 5°,SuperSchool,192,11,181
2025-08-18,13,Primaria 5°,EduMax,66,2,64
2025-08-18,13,Primaria 5°,EduMax,165,3,162
2025-08-18,13,Primaria 5°,TopKids,109,5,104
2025-08-18,13,Primaria 5°,TopKids,153,5,148
2025-08-18,13,Primaria 6°,EduMax,157,14,143
2025-08-18,13,Primaria 6°,TopKids,188,8,180
2025-08-18,13,Primaria 6°,SuperSchool,249,12,237
2025-08-18,13,Primaria 6°,TopKids,132,16,116
2025-08-18,13,Primaria 6°,TopKids,95,7,88
2025-08-18,13,Primaria 6°,TopKids,143,18,125
2025-08-18,13,Primaria 6°,EduMax,235,19,216
2025-08-18,13,Primaria 6°,TopKids,244,17,227
2025-08-18,13,Primaria 6°,EduMax,228,15,213
2025-08-18,13,Primaria 6°,EduMax,183,12,171
2025-08-18,13,Primaria 6°,TopKids,87,11,76
2025-08-18,13,Primaria 6°,SuperSchool,69,10,59
2025-08-18,13,Primaria 6°,EduMax,97,18,79
2025-08-18,13,Primaria 6°,EduMax,149,12,137
2025-08-18,13,Primaria 6°,TopKids,72,21,51
2025-08-18,13,Primaria 6°,TopKids,171,9,162
2025-08-18,14,Preescolar,TopKids,74,17,57
2025-08-18,14,Preescolar,EduMax,78,3,75
2025-08-18,14,Preescolar,SuperSchool,106,8,98
2025-08-18,14,Preescolar,EduMax,299,7,292
2025-08-18,14,Preescolar,EduMax,272,11,261
2025-08-18,14,Preescolar,EduMax,69,21,48
2025-08-18,14,Preescolar,EduMax,166,13,153
2025-08-18,14,Preescolar,TopKids,197,11,186
2025-08-18,14,Preescolar,EduMax,114,12,102
2025-08-18,14,Preescolar,EduMax,216,12,204
2025-08-18,14,Preescolar,SuperSchool,167,4,163
2025-08-18,14,Preescolar,EduMax,224,3,221
2025-08-18,14,Kínder,EduMax,256,15,241
2025-08-18,14,Kínder,EduMax,185,8,177
2025-08-18,14,Kínder,EduMax,242,13,229
2025-08-18,14,Kínder,TopKids,137,21,116
2025-08-18,14,Kínder,SuperSchool,92,4,88
2025-08-18,14,Kínder,TopKids,237,12,225
2025-08-18,14,Kínder,TopKids,254,22,232
2025-08-18,14,Kínder,EduMax,63,19,44
2025-08-18,14,Kínder,TopKids,107,4,103
2025-08-18,14,Kínder,SuperSchool,218,24,194
2025-08-18,14,Kínder,TopKids,295,10,285
2025-08-18,14,Primaria 1°,TopKids,283,12,271
2025-08-18,14,Primaria 1°,TopKids,120,18,102
2025-08-18,14,Primaria 1°,TopKids,128,7,121
2025-08-18,14,Primaria 1°,EduMax,216,10,206
2025-08-18,14,Primaria 1°,SuperSchool,297,22,275
2025-08-18,14,Primaria 2°,EduMax,69,10,59
2025-08-18,14,Primaria 2°,SuperSchool,136,5,131
2025-08-18,14,Primaria 2°,EduMax,90,16,74
2025-08-18,14,Primaria 2°,TopKids,106,10,96
2025-08-18,14,Primaria 2°,SuperSchool,184,5,179
2025-08-18,14,Primaria 2°,TopKids,100,10,90
2025-08-18,14,Primaria 2°,SuperSchool,60,22,38
2025-08-18,14,Primaria 2°,EduMax,148,13,135
2025-08-18,14,Primaria 2°,TopKids,237,10,227
2025-08-18,14,Primaria 2°,TopKids,192,6,186
2025-08-18,14,Primaria 2°,SuperSchool,95,18,77
2025-08-18,14,Primaria 2°,TopKids,281,22,259
2025-08-18,14,Primaria 2°,TopKids,191,2,189
2025-08-18,14,Primaria 2°,SuperSchool,209,16,193
2025-08-18,14,Primaria 2°,EduMax,274,14,260
2025-08-18,14,Primaria 2°,EduMax,183,9,174
2025-08-18,14,Primaria 3°,SuperSchool,275,11,264
2025-08-18,14,Primaria 3°,EduMax,278,9,269
2025-08-18,14,Primaria 3°,TopKids,106,14,92
2025-08-18,14,Primaria 3°,TopKids,289,22,267
2025-08-18,14,Primaria 3°,TopKids,88,10,78
2025-08-18,14,Primaria 3°,SuperSchool,247,17,230
2025-08-18,14,Primaria 3°,SuperSchool,275,14,261
2025-08-18,14,Primaria 3°,TopKids,250,23,227
2025-08-18,14,Primaria 3°,EduMax,272,17,255
2025-08-18,14,Primaria 3°,SuperSchool,156,4,152
2025-08-18,14,Primaria 3°,SuperSchool,204,9,195
2025-08-18,14,Primaria 4°,TopKids,213,24,189
2025-08-18,14,Primaria 4°,TopKids,286,19,267
2025-08-18,14,Primaria 4°,SuperSchool,234,21,213
2025-08-18,14,Primaria 4°,EduMax,210,23,187
2025-08-18,14,Primaria 4°,TopKids,112,6,106
2025-08-18,14,Primaria 4°,EduMax,244,3,241
2025-08-18,14,Primaria 4°,EduMax,108,17,91
2025-08-18,14,Primaria 4°,TopKids,126,11,115
2025-08-18,14,Primaria 4°,EduMax,216,24,192
2025-08-18,14,Primaria 4°,EduMax,137,1,136
2025-08-18,14,Primaria 4°,SuperSchool,234,12,222
2025-08-18,14,Primaria 4°,TopKids,119,16,103
2025-08-18,14,Primaria 4°,SuperSchool,269,9,260
2025-08-18,14,Primaria 4°,EduMax,188,20,168
2025-08-18,14,Primaria 4°,SuperSchool,80,21,59
2025-08-18,14,Primaria 4°,SuperSchool,296,19,277
2025-08-18,14,Primaria 5°,TopKids,89,14,75
2025-08-18,14,Primaria 5°,EduMax,90,24,66
2025-08-18,14,Primaria 5°,SuperSchool,87,4,83
2025-08-18,14,Primaria 5°,TopKids,221,2,219
2025-08-18,14,Primaria 5°,SuperSchool,79,15,64
2025-08-18,14,Primaria 5°,EduMax,276,20,256
2025-08-18,14,Primaria 5°,EduMax,146,1,145
2025-08-18,14,Primaria 6°,TopKids,103,15,88
2025-08-18,14,Primaria 6°,TopKids,138,23,115
2025-08-18,14,Primaria 6°,SuperSchool,199,10,189
2025-08-18,14,Primaria 6°,SuperSchool,130,22,108
2025-08-18,14,Primaria 6°,SuperSchool,174,16,158
2025-08-18,14,Primaria 6°,SuperSchool,104,15,89
2025-08-18,15,Preescolar,TopKids,70,2,68
2025-08-18,15,Preescolar,EduMax,248,10,238
2025-08-18,15,Preescolar,SuperSchool,181,11,170
2025-08-18,15,Preescolar,SuperSchool,277,3,274
2025-08-18,15,Preescolar,TopKids,220,3,217
2025-08-18,15,Preescolar,EduMax,131,19,112
2025-08-18,15,Preescolar,EduMax,105,11,94
2025-08-18,15,Preescolar,EduMax,108,2,106
2025-08-18,15,Preescolar,EduMax,187,23,164
2025-08-18,15,Preescolar,TopKids,167,12,155
2025-08-18,15,Preescolar,TopKids,66,18,48
2025-08-18,15,Preescolar,EduMax,130,15,115
2025-08-18,15,Preescolar,TopKids,65,23,42
2025-08-18,15,Preescolar,EduMax,211,2,209
2025-08-18,15,Preescolar,EduMax,153,7,146
2025-08-18,15,Preescolar,SuperSchool,117,11,106
2025-08-18,15,Preescolar,TopKids,67,4,63
2025-08-18,15,Kínder,SuperSchool,176,11,165
2025-08-18,15,Kínder,TopKids,197,11,186
2025-08-18,15,Kínder,TopKids,223,17,206
2025-08-18,15,Kínder,EduMax,291,16,275
2025-08-18,15,Kínder,EduMax,77,16,61
2025-08-18,15,Primaria 1°,TopKids,199,22,177
2025-08-18,15,Primaria 1°,SuperSchool,201,2,199
2025-08-18,15,Primaria 1°,TopKids,263,1,262
2025-08-18,15,Primaria 1°,SuperSchool,63,4,59
2025-08-18,15,Primaria 1°,SuperSchool,180,5,175
2025-08-18,15,Primaria 1°,SuperSchool,231,19,212
2025-08-18,15,Primaria 1°,SuperSchool,155,22,133
2025-08-18,15,Primaria 2°,EduMax,275,16,259
2025-08-18,15,Primaria 2°,EduMax,206,15,191
2025-08-18,15,Primaria 2°,TopKids,285,2,283
2025-08-18,15,Primaria 2°,EduMax,148,9,139
2025-08-18,15,Primaria 2°,EduMax,68,7,61
2025-08-18,15,Primaria 2°,EduMax,164,1,163
2025-08-18,15,Primaria 2°,TopKids,199,4,195
2025-08-18,15,Primaria 2°,EduMax,200,5,195
2025-08-18,15,Primaria 2°,EduMax,215,2,213
2025-08-18,15,Primaria 2°,EduMax,186,20,166
2025-08-18,15,Primaria 2°,SuperSchool,221,13,208
2025-08-18,15,Primaria 2°,TopKids,295,23,272
2025-08-18,15,Primaria 2°,SuperSchool,182,20,162
2025-08-18,15,Primaria 2°,SuperSchool,62,10,52
2025-08-18,15,Primaria 2°,TopKids,128,18,110
2025-08-18,15,Primaria 2°,EduMax,51,23,28
2025-08-18,15,Primaria 2°,TopKids,190,11,179
2025-08-18,15,Primaria 2°,TopKids,295,23,272
2025-08-18,15,Primaria 3°,TopKids,227,16,211
2025-08-18,15,Primaria 3°,EduMax,61,13,48
2025-08-18,15,Primaria 3°,SuperSchool,108,21,87
2025-08-18,15,Primaria 3°,SuperSchool,279,6,273
2025-08-18,15,Primaria 3°,TopKids,292,11,281
2025-08-18,15,Primaria 3°,EduMax,72,15,57
2025-08-18,15,Primaria 3°,SuperSchool,72,8,64
2025-08-18,15,Primaria 3°,SuperSchool,211,16,195
2025-08-18,15,Primaria 3°,TopKids,158,19,139
2025-08-18,15,Primaria 3°,SuperSchool,160,6,154
2025-08-18,15,Primaria 3°,EduMax,246,17,229
2025-08-18,15,Primaria 3°,EduMax,88,9,79
2025-08-18,15,Primaria 3°,EduMax,205,13,192
2025-08-18,15,Primaria 4°,EduMax,50,21,29
2025-08-18,15,Primaria 4°,EduMax,68,2,66
2025-08-18,15,Primaria 4°,TopKids,245,11,234
2025-08-18,15,Primaria 4°,TopKids,218,10,208
2025-08-18,15,Primaria 4°,EduMax,88,15,73
2025-08-18,15,Primaria 4°,TopKids,175,19,156
2025-08-18,15,Primaria 5°,EduMax,277,11,266
2025-08-18,15,Primaria 5°,TopKids,72,17,55
2025-08-18,15,Primaria 5°,TopKids,203,11,192
2025-08-18,15,Primaria 5°,EduMax,287,14,273
2025-08-18,15,Primaria 5°,EduMax,80,9,71
2025-08-18,15,Primaria 5°,EduMax,212,17,195
2025-08-18,15,Primaria 5°,TopKids,149,20,129
2025-08-18,15,Primaria 5°,SuperSchool,201,10,191
2025-08-18,15,Primaria 5°,EduMax,241,7,234
2025-08-18,15,Primaria 5°,EduMax,88,23,65
2025-08-18,15,Primaria 5°,EduMax,218,22,196
2025-08-18,15,Primaria 5°,EduMax,258,11,247
2025-08-18,15,Primaria 5°,SuperSchool,130,4,126
2025-08-18,15,Primaria 5°,EduMax,109,9,100
2025-08-18,15,Primaria 6°,SuperSchool,52,19,33
2025-08-18,15,Primaria 6°,EduMax,247,20,227
2025-08-18,15,Primaria 6°,SuperSchool,107,6,101
2025-08-18,15,Primaria 6°,SuperSchool,278,12,266
2025-08-18,15,Primaria 6°,SuperSchool,154,17,137
2025-08-18,15,Primaria 6°,TopKids,66,22,44
2025-08-18,15,Primaria 6°,TopKids,255,17,238
2025-08-18,15,Primaria 6°,EduMax,193,21,172
2025-08-18,15,Primaria 6°,EduMax,147,8,139
2025-08-18,15,Primaria 6°,SuperSchool,97,8,89
2025-08-18,15,Primaria 6°,EduMax,101,15,86
2025-08-18,15,Primaria 6°,EduMax,256,4,252
2025-08-18,15,Primaria 6°,EduMax,156,6,150
2025-08-18,15,Primaria 6°,SuperSchool,250,3,247
2025-08-18,15,Primaria 6°,TopKids,77,5,72
2025-08-18,15,Primaria 6°,TopKids,186,2,184
2025-08-18,15,Primaria 6°,TopKids,299,21,278
2025-08-18,16,Preescolar,SuperSchool,251,15,236
2025-08-18,16,Preescolar,EduMax,95,23,72
2025-08-18,16,Preescolar,SuperSchool,65,8,57
2025-08-18,16,Preescolar,EduMax,258,17,241
2025-08-18,16,Preescolar,TopKids,242,17,225
2025-08-18,16,Preescolar,EduMax,265,16,249
2025-08-18,16,Preescolar,SuperSchool,138,2,136
2025-08-18,16,Preescolar,SuperSchool,63,7,56
2025-08-18,16,Preescolar,SuperSchool,292,1,291
2025-08-18,16,Preescolar,SuperSchool,172,10,162
2025-08-18,16,Preescolar,EduMax,152,6,146
2025-08-18,16,Preescolar,SuperSchool,113,2,111
2025-08-18,16,Preescolar,EduMax,265,17,248
2025-08-18,16,Preescolar,TopKids,107,23,84
2025-08-18,16,Preescolar,TopKids,134,19,115
2025-08-18,16,Preescolar,TopKids,200,7,193
2025-08-18,16,Kínder,TopKids,256,11,245
2025-08-18,16,Kínder,EduMax,276,19,257
2025-08-18,16,Kínder,SuperSchool,107,15,92
2025-08-18,16,Kínder,SuperSchool,96,12,84
2025-08-18,16,Kínder,TopKids,280,11,269
2025-08-18,16,Kínder,SuperSchool,284,17,267
2025-08-18,16,Kínder,TopKids,161,5,156
2025-08-18,16,Kínder,EduMax,136,7,129
2025-08-18,16,Kínder,EduMax,246,15,231
2025-08-18,16,Kínder,EduMax,80,22,58
2025-08-18,16,Kínder,SuperSchool,261,20,241
2025-08-18,16,Kínder,TopKids,185,15,170
2025-08-18,16,Kínder,EduMax,98,23,75
2025-08-18,16,Kínder,EduMax,102,13,89
2025-08-18,16,Kínder,SuperSchool,249,11,238
2025-08-18,16,Kínder,TopKids,222,18,204
2025-08-18,16,Primaria 1°,SuperSchool,226,22,204
2025-08-18,16,Primaria 1°,SuperSchool,238,3,235
2025-08-18,16,Primaria 1°,TopKids,142,21,121
2025-08-18,16,Primaria 1°,TopKids,238,12,226
2025-08-18,16,Primaria 1°,TopKids,273,11,262
2025-08-18,16,Primaria 1°,EduMax,131,7,124
2025-08-18,16,Primaria 2°,TopKids,295,3,292
2025-08-18,16,Primaria 2°,TopKids,219,23,196
2025-08-18,16,Primaria 2°,TopKids,147,16,131
2025-08-18,16,Primaria 2°,SuperSchool,187,18,169
2025-08-18,16,Primaria 2°,TopKids,75,3,72
2025-08-18,16,Primaria 2°,TopKids,165,24,141
2025-08-18,16,Primaria 2°,TopKids,215,2,213
2025-08-18,16,Primaria 2°,TopKids,194,9,185
2025-08-18,16,Primaria 2°,EduMax,272,23,249
2025-08-18,16,Primaria 3°,SuperSchool,159,11,148
2025-08-18,16,Primaria 3°,EduMax,262,2,260
2025-08-18,16,Primaria 3°,TopKids,214,7,207
2025-08-18,16,Primaria 3°,EduMax,117,14,103
2025-08-18,16,Primaria 3°,EduMax,72,12,60
2025-08-18,16,Primaria 3°,EduMax,266,1,265
2025-08-18,16,Primaria 4°,TopKids,161,15,146
2025-08-18,16,Primaria 4°,EduMax,282,21,261
2025-08-18,16,Primaria 4°,TopKids,288,7,281
2025-08-18,16,Primaria 4°,SuperSchool,99,8,91
2025-08-18,16,Primaria 4°,TopKids,64,17,47
2025-08-18,16,Primaria 4°,EduMax,285,3,282
2025-08-18,16,Primaria 4°,TopKids,279,14,265
2025-08-18,16,Primaria 5°,TopKids,182,4,178
2025-08-18,16,Primaria 5°,TopKids,192,7,185
2025-08-18,16,Primaria 5°,TopKids,286,10,276
2025-08-18,16,Primaria 5°,TopKids,243,12,231
2025-08-18,16,Primaria 5°,EduMax,221,19,202
2025-08-18,16,Primaria 5°,TopKids,262,3,259
2025-08-18,16,Primaria 5°,EduMax,209,2,207
2025-08-18,16,Primaria 5°,SuperSchool,108,9,99
2025-08-18,16,Primaria 5°,SuperSchool,296,14,282
2025-08-18,16,Primaria 5°,TopKids,188,14,174
2025-08-18,16,Primaria 5°,EduMax,261,16,245
2025-08-18,16,Primaria 6°,EduMax,83,16,67
2025-08-18,16,Primaria 6°,EduMax,102,18,84
2025-08-18,16,Primaria 6°,EduMax,151,7,144
2025-08-18,16,Primaria 6°,SuperSchool,147,15,132
2025-08-18,16,Primaria 6°,SuperSchool,94,7,87
2025-08-18,16,Primaria 6°,SuperSchool,84,20,64
2025-08-18,16,Primaria 6°,EduMax,280,21,259
2025-08-18,16,Primaria 6°,SuperSchool,205,12,193
2025-08-18,16,Primaria 6°,EduMax,200,16,184
2025-08-18,16,Primaria 6°,EduMax,192,23,169
2025-08-18,16,Primaria 6°,TopKids,99,6,93
2025-08-18,16,Primaria 6°,SuperSchool,111,23,88
2025-08-18,16,Primaria 6°,TopKids,189,20,169
2025-08-18,16,Primaria 6°,TopKids,123,21,102
2025-08-18,16,Primaria 6°,EduMax,218,10,208
2025-08-18,16,Primaria 6°,TopKids,234,14,220
2025-08-19,9,Preescolar,SuperSchool,210,7,203
2025-08-19,9,Preescolar,TopKids,97,10,87
2025-08-19,9,Preescolar,TopKids,193,6,187
2025-08-19,9,Preescolar,TopKids,277,22,255
2025-08-19,9,Preescolar,EduMax,66,13,53
2025-08-19,9,Preescolar,EduMax,145,20,125
2025-08-19,9,Preescolar,EduMax,231,1,230
2025-08-19,9,Kínder,EduMax,230,4,226
2025-08-19,9,Kínder,SuperSchool,246,15,231
2025-08-19,9,Kínder,EduMax,89,7,82
2025-08-19,9,Kínder,EduMax,202,11,191
2025-08-19,9,Kínder,SuperSchool,224,17,207
2025-08-19,9,Kínder,EduMax,103,18,85
2025-08-19,9,Kínder,TopKids,121,6,115
2025-08-19,9,Kínder,TopKids,270,9,261
2025-08-19,9,Kínder,EduMax,118,7,111
2025-08-19,9,Kínder,EduMax,236,15,221
2025-08-19,9,Kínder,SuperSchool,295,4,291
2025-08-19,9,Kínder,TopKids,158,1,157
2025-08-19,9,Primaria 1°,EduMax,223,9,214
2025-08-19,9,Primaria 1°,EduMax,90,8,82
2025-08-19,9,Primaria 1°,EduMax,95,9,86
2025-08-19,9,Primaria 1°,SuperSchool,275,1,274
2025-08-19,9,Primaria 1°,SuperSchool,138,10,128
2025-08-19,9,Primaria 2°,TopKids,175,24,151
2025-08-19,9,Primaria 2°,SuperSchool,239,12,227
2025-08-19,9,Primaria 2°,EduMax,108,12,96
2025-08-19,9,Primaria 2°,TopKids,74,14,60
2025-08-19,9,Primaria 2°,EduMax,293,13,280
2025-08-19,9,Primaria 2°,EduMax,133,7,126
2025-08-19,9,Primaria 2°,SuperSchool,111,3,108
2025-08-19,9,Primaria 2°,SuperSchool,142,20,122
2025-08-19,9,Primaria 2°,SuperSchool,125,3,122
2025-08-19,9,Primaria 2°,SuperSchool,237,1,236
2025-08-19,9,Primaria 2°,EduMax,250,10,240
2025-08-19,9,Primaria 2°,SuperSchool,251,13,238
2025-08-19,9,Primaria 3°,SuperSchool,241,4,237
2025-08-19,9,Primaria 3°,EduMax,162,5,157
2025-08-19,9,Primaria 3°,SuperSchool,170,3,167
2025-08-19,9,Primaria 3°,SuperSchool,225,19,206
2025-08-19,9,Primaria 3°,TopKids,66,18,48
2025-08-19,9,Primaria 3°,EduMax,170,23,147
2025-08-19,9,Primaria 3°,EduMax,122,19,103
2025-08-19,9,Primaria 3°,EduMax,78,2,76
2025-08-19,9,Primaria 3°,SuperSchool,298,24,274
2025-08-19,9,Primaria 3°,SuperSchool,208,11,197
2025-08-19,9,Primaria 3°,TopKids,109,3,106
2025-08-19,9,Primaria 3°,TopKids,261,16,245
2025-08-19,9,Primaria 3°,EduMax,63,20,43
2025-08-19,9,Primaria 3°,EduMax,100,24,76
2025-08-19,9,Primaria 3°,TopKids,259,11,248
2025-08-19,9,Primaria 3°,SuperSchool,196,20,176
2025-08-19,9,Primaria 3°,SuperSchool,155,3,152
2025-08-19,9,Primaria 3°,TopKids,105,8,97
2025-08-19,9,Primaria 4°,SuperSchool,183,20,163
2025-08-19,9,Primaria 4°,SuperSchool,229,24,205
2025-08-19,9,Primaria 4°,EduMax,211,19,192
2025-08-19,9,Primaria 4°,TopKids,124,11,113
2025-08-19,9,Primaria 4°,TopKids,129,5,124
2025-08-19,9,Primaria 4°,EduMax,207,7,200
2025-08-19,9,Primaria 4°,SuperSchool,161,15,146
2025-08-19,9,Primaria 4°,SuperSchool,274,20,254
2025-08-19,9,Primaria 4°,EduMax,199,9,190
2025-08-19,9,Primaria 4°,EduMax,238,21,217
2025-08-19,9,Primaria 4°,SuperSchool,295,6,289
2025-08-19,9,Primaria 4°,TopKids,87,8,79
2025-08-19,9,Primaria 4°,EduMax,81,16,65
2025-08-19,9,Primaria 4°,TopKids,294,3,291
2025-08-19,9,Primaria 4°,SuperSchool,262,6,256
2025-08-19,9,Primaria 4°,EduMax,151,22,129
2025-08-19,9,Primaria 4°,TopKids,80,20,60
2025-08-19,9,Primaria 5°,TopKids,179,8,171
2025-08-19,9,Primaria 5°,TopKids,140,8,132
2025-08-19,9,Primaria 5°,SuperSchool,231,15,216
2025-08-19,9,Primaria 5°,TopKids,127,7,120
2025-08-19,9,Primaria 5°,SuperSchool,267,5,262
2025-08-19,9,Primaria 5°,EduMax,196,18,178
2025-08-19,9,Primaria 5°,EduMax,207,24,183
2025-08-19,9,Primaria 5°,EduMax,176,2,174
2025-08-19,9,Primaria 5°,EduMax,145,3,142
2025-08-19,9,Primaria 5°,TopKids,150,7,143
2025-08-19,9,Primaria 5°,TopKids,204,10,194
2025-08-19,9,Primaria 5°,SuperSchool,220,23,197
2025-08-19,9,Primaria 5°,TopKids,183,6,177
2025-08-19,9,Primaria 5°,SuperSchool,225,13,212
2025-08-19,9,Primaria 5°,EduMax,260,19,241
2025-08-19,9,Primaria 5°,SuperSchool,196,18,178
2025-08-19,9,Primaria 5°,SuperSchool,177,6,171
2025-08-19,9,Primaria 5°,EduMax,100,6,94
2025-08-19,9,Primaria 5°,TopKids,103,15,88
2025-08-19,9,Primaria 6°,TopKids,252,8,244
2025-08-19,9,Primaria 6°,SuperSchool,295,18,277
2025-08-19,9,Primaria 6°,SuperSchool,164,19,145
2025-08-19,9,Primaria 6°,SuperSchool,290,4,286
2025-08-19,9,Primaria 6°,TopKids,118,16,102
2025-08-19,9,Primaria 6°,EduMax,127,20,107
2025-08-19,9,Primaria 6°,EduMax,266,18,248
2025-08-19,9,Primaria 6°,EduMax,254,18,236
2025-08-19,9,Primaria 6°,SuperSchool,286,12,274
2025-08-19,9,Primaria 6°,TopKids,135,7,128
2025-08-19,10,Preescolar,EduMax,214,21,193
2025-08-19,10,Preescolar,SuperSchool,181,1,180
2025-08-19,10,Preescolar,SuperSchool,223,15,208
2025-08-19,10,Preescolar,SuperSchool,253,7,246
2025-08-19,10,Preescolar,TopKids,100,23,77
2025-08-19,10,Kínder,EduMax,203,4,199
2025-08-19,10,Kínder,EduMax,203,3,200
2025-08-19,10,Kínder,TopKids,205,12,193
2025-08-19,10,Kínder,SuperSchool,215,15,200
2025-08-19,10,Kínder,EduMax,115,8,107
2025-08-19,10,Kínder,EduMax,150,3,147
2025-08-19,10,Kínder,EduMax,152,11,141
2025-08-19,10,Primaria 1°,TopKids,243,5,238
2025-08-19,10,Primaria 1°,TopKids,145,8,137
2025-08-19,10,Primaria 1°,SuperSchool,156,17,139
2025-08-19,10,Primaria 1°,TopKids,210,19,191
2025-08-19,10,Primaria 1°,TopKids,62,23,39
2025-08-19,10,Primaria 1°,EduMax,200,4,196
2025-08-19,10,Primaria 1°,TopKids,227,18,209
2025-08-19,10,Primaria 1°,EduMax,130,13,117
2025-08-19,10,Primaria 1°,EduMax,234,14,220
2025-08-19,10,Primaria 1°,EduMax,248,10,238
2025-08-19,10,Primaria 1°,TopKids,243,19,224
2025-08-19,10,Primaria 1°,TopKids,86,3,83
2025-08-19,10,Primaria 1°,SuperSchool,211,23,188
2025-08-19,10,Primaria 1°,TopKids,299,22,277
2025-08-19,10,Primaria 1°,EduMax,63,7,56
2025-08-19,10,Primaria 1°,EduMax,179,11,168
2025-08-19,10,Primaria 1°,SuperSchool,180,9,171
2025-08-19,10,Primaria 1°,EduMax,145,11,134
2025-08-19,10,Primaria 1°,EduMax,240,1,239
2025-08-19,10,Primaria 2°,EduMax,124,18,106
2025-08-19,10,Primaria 2°,TopKids,110,15,95
2025-08-19,10,Primaria 2°,TopKids,280,7,273
2025-08-19,10,Primaria 2°,SuperSchool,71,20,51
2025-08-19,10,Primaria 2°,TopKids,297,16,281
2025-08-19,10,Primaria 2°,TopKids,101,15,86
2025-08-19,10,Primaria 2°,SuperSchool,91,2,89
2025-08-19,10,Primaria 2°,TopKids,95,16,79
2025-08-19,10,Primaria 2°,TopKids,64,7,57
2025-08-19,10,Primaria 2°,SuperSchool,234,10,224
2025-08-19,10,Primaria 2°,SuperSchool,154,6,148
2025-08-19,10,Primaria 2°,SuperSchool,125,23,102
2025-08-19,10,Primaria 2°,EduMax,133,22,111
2025-08-19,10,Primaria 2°,EduMax,76,20,56
2025-08-19,10,Primaria 2°,TopKids,56,8,48
2025-08-19,10,Primaria 2°,EduMax,121,2,119
2025-08-19,10,Primaria 2°,EduMax,187,18,169
2025-08-19,10,Primaria 2°,EduMax,67,16,51
2025-08-19,10,Primaria 2°,SuperSchool,229,5,224
2025-08-19,10,Primaria 3°,TopKids,145,10,135
2025-08-19,10,Primaria 3°,SuperSchool,239,13,226
2025-08-19,10,Primaria 3°,SuperSchool,227,13,214
2025-08-19,10,Primaria 3°,SuperSchool,173,15,158
2025-08-19,10,Primaria 3°,EduMax,221,10,211
2025-08-19,10,Primaria 3°,SuperSchool,143,11,132
2025-08-19,10,Primaria 3°,TopKids,71,10,61
2025-08-19,10,Primaria 3°,TopKids,87,1,86
2025-08-19,10,Primaria 4°,SuperSchool,56,22,34
2025-08-19,10,Primaria 4°,TopKids,243,1,242
2025-08-19,10,Primaria 4°,EduMax,136,18,118
2025-08-19,10,Primaria 4°,TopKids,164,22,142
2025-08-19,10,Primaria 4°,TopKids,142,10,132
2025-08-19,10,Primaria 4°,SuperSchool,108,11,97
2025-08-19,10,Primaria 4°,SuperSchool,240,2,238
2025-08-19,10,Primaria 4°,EduMax,281,23,258
2025-08-19,10,Primaria 4°,EduMax,178,24,154
2025-08-19,10,Primaria 4°,SuperSchool,153,11,142
2025-08-19,10,Primaria 5°,EduMax,157,20,137
2025-08-19,10,Primaria 5°,TopKids,193,5,188
2025-08-19,10,Primaria 5°,TopKids,55,5,50
2025-08-19,10,Primaria 5°,SuperSchool,100,10,90
2025-08-19,10,Primaria 5°,SuperSchool,176,14,162
2025-08-19,10,Primaria 5°,SuperSchool,198,3,195
2025-08-19,10,Primaria 6°,SuperSchool,112,17,95
2025-08-19,10,Primaria 6°,EduMax,61,5,56
2025-08-19,10,Primaria 6°,EduMax,122,12,110
2025-08-19,10,Primaria 6°,SuperSchool,276,1,275
2025-08-19,10,Primaria 6°,EduMax,288,10,278
2025-08-19,10,Primaria 6°,EduMax,152,4,148
2025-08-19,10,Primaria 6°,EduMax,86,20,66
2025-08-19,10,Primaria 6°,TopKids,130,13,117
2025-08-19,10,Primaria 6°,EduMax,235,5,230
2025-08-19,10,Primaria 6°,TopKids,130,5,125
2025-08-19,11,Preescolar,EduMax,166,1,165
2025-08-19,11,Preescolar,EduMax,198,10,188
2025-08-19,11,Preescolar,SuperSchool,204,3,201
2025-08-19,11,Preescolar,SuperSchool,243,17,226
2025-08-19,11,Preescolar,EduMax,86,10,76
2025-08-19,11,Preescolar,SuperSchool,237,1,236
2025-08-19,11,Preescolar,TopKids,299,4,295
2025-08-19,11,Preescolar,TopKids,191,14,177
2025-08-19,11,Preescolar,EduMax,83,1,82
2025-08-19,11,Preescolar,SuperSchool,71,16,55
2025-08-19,11,Kínder,EduMax,227,16,211
2025-08-19,11,Kínder,TopKids,135,24,111
2025-08-19,11,Kínder,EduMax,266,10,256
2025-08-19,11,Kínder,EduMax,120,21,99
2025-08-19,11,Kínder,SuperSchool,212,20,192
2025-08-19,11,Kínder,EduMax,56,17,39
2025-08-19,11,Kínder,TopKids,253,9,244
2025-08-19,11,Kínder,TopKids,255,2,253
2025-08-19,11,Kínder,SuperSchool,245,19,226
2025-08-19,11,Kínder,SuperSchool,161,22,139
2025-08-19,11,Kínder,SuperSchool,179,17,162
2025-08-19,11,Kínder,TopKids,153,24,129
2025-08-19,11,Kínder,EduMax,253,23,230
2025-08-19,11,Kínder,EduMax,147,19,128
2025-08-19,11,Kínder,EduMax,112,3,109
2025-08-19,11,Kínder,SuperSchool,141,12,129
2025-08-19,11,Kínder,EduMax,225,12,213
2025-08-19,11,Primaria 1°,SuperSchool,188,10,178
2025-08-19,11,Primaria 1°,TopKids,268,23,245
2025-08-19,11,Primaria 1°,SuperSchool,157,6,151
2025-08-19,11,Primaria 1°,TopKids,225,21,204
2025-08-19,11,Primaria 1°,TopKids,169,14,155
2025-08-19,11,Primaria 1°,EduMax,123,18,105
2025-08-19,11,Primaria 1°,TopKids,121,1,120
2025-08-19,11,Primaria 1°,EduMax,232,6,226
2025-08-19,11,Primaria 1°,EduMax,179,9,170
2025-08-19,11,Primaria 1°,SuperSchool,157,5,152
2025-08-19,11,Primaria 1°,EduMax,68,7,61
2025-08-19,11,Primaria 1°,TopKids,91,17,74
2025-08-19,11,Primaria 2°,EduMax,223,11,212
2025-08-19,11,Primaria 2°,EduMax,185,19,166
2025-08-19,11,Primaria 2°,EduMax,196,24,172
2025-08-19,11,Primaria 2°,SuperSchool,297,24,273
2025-08-19,11,Primaria 2°,EduMax,189,9,180
2025-08-19,11,Primaria 2°,TopKids,297,16,281
2025-08-19,11,Primaria 2°,EduMax,241,16,225
2025-08-19,11,Primaria 2°,TopKids,263,7,256
2025-08-19,11,Primaria 2°,SuperSchool,73,23,50
2025-08-19,11,Primaria 2°,SuperSchool,133,1,132
2025-08-19,11,Primaria 2°,TopKids,217,23,194
2025-08-19,11,Primaria 2°,EduMax,178,21,157
2025-08-19,11,Primaria 2°,SuperSchool,145,21,124
2025-08-19,11,Primaria 2°,SuperSchool,223,14,209
2025-08-19,11,Primaria 2°,EduMax,109,19,90
2025-08-19,11,Primaria 2°,SuperSchool,289,9,280
2025-08-19,11,Primaria 2°,TopKids,217,7,210
2025-08-19,11,Primaria 2°,TopKids,262,6,256
2025-08-19,11,Primaria 2°,TopKids,68,14,54
2025-08-19,11,Primaria 3°,EduMax,238,24,214
2025-08-19,11,Primaria 3°,EduMax,223,16,207
2025-08-19,11,Primaria 3°,SuperSchool,252,3,249
2025-08-19,11,Primaria 3°,TopKids,115,21,94
2025-08-19,11,Primaria 3°,EduMax,101,21,80
2025-08-19,11,Primaria 3°,EduMax,96,3,93
2025-08-19,11,Primaria 3°,SuperSchool,192,20,172
2025-08-19,11,Primaria 3°,EduMax,83,18,65
2025-08-19,11,Primaria 3°,SuperSchool,122,3,119
2025-08-19,11,Primaria 3°,EduMax,181,16,165
2025-08-19,11,Primaria 3°,EduMax,82,9,73
2025-08-19,11,Primaria 3°,SuperSchool,89,6,83
2025-08-19,11,Primaria 3°,EduMax,65,8,57
2025-08-19,11,Primaria 3°,TopKids,109,4,105
2025-08-19,11,Primaria 3°,TopKids,64,6,58
2025-08-19,11,Primaria 3°,TopKids,274,18,256
2025-08-19,11,Primaria 3°,TopKids,284,3,281
2025-08-19,11,Primaria 3°,EduMax,222,17,205
2025-08-19,11,Primaria 3°,EduMax,235,14,221
2025-08-19,11,Primaria 4°,TopKids,216,14,202
2025-08-19,11,Primaria 4°,EduMax,233,15,218
2025-08-19,11,Primaria 4°,SuperSchool,211,14,197
2025-08-19,11,Primaria 4°,SuperSchool,65,5,60
2025-08-19,11,Primaria 4°,SuperSchool,293,21,272
2025-08-19,11,Primaria 4°,EduMax,291,5,286
2025-08-19,11,Primaria 4°,TopKids,190,3,187
2025-08-19,11,Primaria 4°,SuperSchool,138,18,120
2025-08-19,11,Primaria 4°,EduMax,157,14,143
2025-08-19,11,Primaria 4°,EduMax,131,20,111
2025-08-19,11,Primaria 4°,EduMax,120,15,105
2025-08-19,11,Primaria 4°,EduMax,256,17,239
2025-08-19,11,Primaria 4°,TopKids,147,21,126
2025-08-19,11,Primaria 5°,EduMax,298,4,294
2025-08-19,11,Primaria 5°,SuperSchool,236,17,219
2025-08-19,11,Primaria 5°,SuperSchool,290,16,274
2025-08-19,11,Primaria 5°,SuperSchool,281,23,258
2025-08-19,11,Primaria 5°,TopKids,82,19,63
2025-08-19,11,Primaria 5°,SuperSchool,64,9,55
2025-08-19,11,Primaria 5°,SuperSchool,257,13,244
2025-08-19,11,Primaria 5°,EduMax,220,13,207
2025-08-19,11,Primaria 5°,EduMax,75,20,55
2025-08-19,11,Primaria 5°,SuperSchool,182,17,165
2025-08-19,11,Primaria 5°,SuperSchool,268,5,263
2025-08-19,11,Primaria 5°,SuperSchool,120,16,104
2025-08-19,11,Primaria 5°,EduMax,144,6,138
2025-08-19,11,Primaria 5°,EduMax,176,13,163
2025-08-19,11,Primaria 5°,EduMax,166,20,146
2025-08-19,11,Primaria 5°,TopKids,75,21,54
2025-08-19,11,Primaria 5°,EduMax,217,24,193
2025-08-19,11,Primaria 5°,EduMax,228,20,208
2025-08-19,11,Primaria 5°,SuperSchool,257,10,247
2025-08-19,11,Primaria 6°,EduMax,73,19,54
2025-08-19,11,Primaria 6°,TopKids,109,9,100
2025-08-19,11,Primaria 6°,TopKids,168,9,159
2025-08-19,11,Primaria 6°,EduMax,149,19,130
2025-08-19,11,Primaria 6°,SuperSchool,274,1,273
2025-08-19,11,Primaria 6°,TopKids,212,10,202
2025-08-19,11,Primaria 6°,EduMax,255,10,245
2025-08-19,11,Primaria 6°,EduMax,195,24,171
2025-08-19,11,Primaria 6°,SuperSchool,271,15,256
2025-08-19,12,Preescolar,EduMax,148,18,130
2025-08-19,12,Preescolar,SuperSchool,193,21,172
2025-08-19,12,Preescolar,TopKids,239,5,234
2025-08-19,12,Preescolar,SuperSchool,167,20,147
2025-08-19,12,Preescolar,TopKids,161,7,154
2025-08-19,12,Preescolar,TopKids,266,22,244
2025-08-19,12,Preescolar,SuperSchool,66,9,57
2025-08-19,12,Preescolar,SuperSchool,267,9,258
2025-08-19,12,Preescolar,SuperSchool,280,1,279
2025-08-19,12,Preescolar,EduMax,117,16,101
2025-08-19,12,Preescolar,SuperSchool,199,4,195
2025-08-19,12,Preescolar,EduMax,235,23,212
2025-08-19,12,Kínder,SuperSchool,121,17,104
2025-08-19,12,Kínder,SuperSchool,67,18,49
2025-08-19,12,Kínder,EduMax,298,12,286
2025-08-19,12,Kínder,SuperSchool,106,1,105
2025-08-19,12,Kínder,TopKids,112,12,100
2025-08-19,12,Kínder,TopKids,190,3,187
2025-08-19,12,Kínder,TopKids,266,8,258
2025-08-19,12,Primaria 1°,SuperSchool,138,13,125
2025-08-19,12,Primaria 1°,EduMax,130,3,127
2025-08-19,12,Primaria 1°,SuperSchool,199,6,193
2025-08-19,12,Primaria 1°,EduMax,140,10,130
2025-08-19,12,Primaria 1°,EduMax,177,13,164
2025-08-19,12,Primaria 1°,EduMax,247,10,237
2025-08-19,12,Primaria 1°,SuperSchool,270,6,264
2025-08-19,12,Primaria 2°,TopKids,161,12,149
2025-08-19,12,Primaria 2°,EduMax,104,20,84
2025-08-19,12,Primaria 2°,EduMax,86,16,70
2025-08-19,12,Primaria 2°,TopKids,270,6,264
2025-08-19,12,Primaria 2°,SuperSchool,273,9,264
2025-08-19,12,Primaria 2°,SuperSchool,230,23,207
2025-08-19,12,Primaria 2°,EduMax,196,12,184
2025-08-19,12,Primaria 2°,EduMax,235,10,225
2025-08-19,12,Primaria 2°,EduMax,259,19,240
2025-08-19,12,Primaria 2°,EduMax,86,16,70
2025-08-19,12,Primaria 2°,EduMax,94,21,73
2025-08-19,12,Primaria 3°,EduMax,93,1,92
2025-08-19,12,Primaria 3°,TopKids,173,16,157
2025-08-19,12,Primaria 3°,EduMax,56,21,35
2025-08-19,12,Primaria 3°,TopKids,161,6,155
2025-08-19,12,Primaria 3°,EduMax,82,1,81
2025-08-19,12,Primaria 3°,EduMax,74,14,60
2025-08-19,12,Primaria 4°,EduMax,53,12,41
2025-08-19,12,Primaria 4°,EduMax,131,10,121
2025-08-19,12,Primaria 4°,TopKids,148,8,140
2025-08-19,12,Primaria 4°,EduMax,72,1,71
2025-08-19,12,Primaria 4°,EduMax,256,21,235
2025-08-19,12,Primaria 4°,SuperSchool,234,11,223
2025-08-19,12,Primaria 4°,SuperSchool,266,20,246
2025-08-19,12,Primaria 4°,SuperSchool,219,13,206
2025-08-19,12,Primaria 4°,SuperSchool,80,21,59
2025-08-19,12,Primaria 4°,SuperSchool,229,16,213
2025-08-19,12,Primaria 5°,SuperSchool,79,3,76
2025-08-19,12,Primaria 5°,EduMax,119,11,108
2025-08-19,12,Primaria 5°,SuperSchool,52,1,51
2025-08-19,12,Primaria 5°,TopKids,94,5,89
2025-08-19,12,Primaria 5°,EduMax,209,15,194
2025-08-19,12,Primaria 5°,EduMax,288,20,268
2025-08-19,12,Primaria 5°,TopKids,290,8,282
2025-08-19,12,Primaria 5°,SuperSchool,267,16,251
2025-08-19,12,Primaria 5°,SuperSchool,251,14,237
2025-08-19,12,Primaria 5°,TopKids,279,20,259
2025-08-19,12,Primaria 5°,EduMax,203,7,196
2025-08-19,12,Primaria 5°,EduMax,108,17,91
2025-08-19,12,Primaria 5°,SuperSchool,265,8,257
2025-08-19,12,Primaria 5°,EduMax,298,4,294
2025-08-19,12,Primaria 5°,EduMax,183,7,176
2025-08-19,12,Primaria 5°,SuperSchool,80,8,72
2025-08-19,12,Primaria 6°,TopKids,175,21,154
2025-08-19,12,Primaria 6°,SuperSchool,222,22,200
2025-08-19,12,Primaria 6°,EduMax,256,7,249
2025-08-19,12,Primaria 6°,TopKids,64,3,61
2025-08-19,12,Primaria 6°,EduMax,171,14,157
2025-08-19,12,Primaria 6°,TopKids,182,11,171
2025-08-19,12,Primaria 6°,EduMax,115,16,99
2025-08-19,13,Preescolar,EduMax,99,7,92
2025-08-19,13,Preescolar,SuperSchool,112,7,105
2025-08-19,13,Preescolar,SuperSchool,141,6,135
2025-08-19,13,Preescolar,SuperSchool,124,13,111
2025-08-19,13,Preescolar,SuperSchool,102,15,87
2025-08-19,13,Preescolar,SuperSchool,116,15,101
2025-08-19,13,Preescolar,SuperSchool,63,23,40
2025-08-19,13,Preescolar,EduMax,169,8,161
2025-08-19,13,Preescolar,EduMax,85,20,65
2025-08-19,13,Preescolar,EduMax,146,18,128
2025-08-19,13,Preescolar,EduMax,207,14,193
2025-08-19,13,Preescolar,TopKids,130,9,121
2025-08-19,13,Preescolar,EduMax,120,14,106
2025-08-19,13,Kínder,SuperSchool,281,16,265
2025-08-19,13,Kínder,SuperSchool,246,14,232
2025-08-19,13,Kínder,EduMax,184,23,161
2025-08-19,13,Kínder,SuperSchool,194,9,185
2025-08-19,13,Kínder,TopKids,199,13,186
2025-08-19,13,Kínder,SuperSchool,236,16,220
2025-08-19,13,Kínder,EduMax,286,13,273
2025-08-19,13,Kínder,TopKids,61,4,57
2025-08-19,13,Kínder,EduMax,65,24,41
2025-08-19,13,Kínder,TopKids,153,6,147
2025-08-19,13,Kínder,EduMax,152,14,138
2025-08-19,13,Kínder,TopKids,222,21,201
2025-08-19,13,Kínder,SuperSchool,186,3,183
2025-08-19,13,Kínder,EduMax,96,20,76
2025-08-19,13,Kínder,SuperSchool,194,23,171
2025-08-19,13,Kínder,TopKids,55,3,52
2025-08-19,13,Primaria 1°,SuperSchool,62,1,61
2025-08-19,13,Primaria 1°,SuperSchool,171,3,168
2025-08-19,13,Primaria 1°,EduMax,132,21,111
2025-08-19,13,Primaria 1°,EduMax,125,8,117
2025-08-19,13,Primaria 1°,TopKids,92,20,72
2025-08-19,13,Primaria 1°,SuperSchool,142,16,126
2025-08-19,13,Primaria 2°,EduMax,56,6,50
2025-08-19,13,Primaria 2°,SuperSchool,85,22,63
2025-08-19,13,Primaria 2°,EduMax,196,3,193
2025-08-19,13,Primaria 2°,SuperSchool,230,2,228
2025-08-19,13,Primaria 2°,TopKids,97,10,87
2025-08-19,13,Primaria 2°,TopKids,140,10,130
2025-08-19,13,Primaria 2°,EduMax,183,14,169
2025-08-19,13,Primaria 2°,EduMax,155,17,138
2025-08-19,13,Primaria 2°,EduMax,289,14,275
2025-08-19,13,Primaria 2°,EduMax,286,1,285
2025-08-19,13,Primaria 2°,EduMax,111,22,89
2025-08-19,13,Primaria 2°,EduMax,273,17,256
2025-08-19,13,Primaria 2°,EduMax,54,19,35
2025-08-19,13,Primaria 2°,SuperSchool,160,13,147
2025-08-19,13,Primaria 2°,SuperSchool,274,14,260
2025-08-19,13,Primaria 2°,SuperSchool,271,9,262
2025-08-19,13,Primaria 2°,SuperSchool,244,13,231
2025-08-19,13,Primaria 2°,EduMax,264,3,261
2025-08-19,13,Primaria 3°,SuperSchool,100,22,78
2025-08-19,13,Primaria 3°,SuperSchool,152,2,150
2025-08-19,13,Primaria 3°,SuperSchool,97,8,89
2025-08-19,13,Primaria 3°,TopKids,140,8,132
2025-08-19,13,Primaria 3°,SuperSchool,75,14,61
2025-08-19,13,Primaria 4°,EduMax,129,23,106
2025-08-19,13,Primaria 4°,SuperSchool,199,15,184
2025-08-19,13,Primaria 4°,SuperSchool,125,18,107
2025-08-19,13,Primaria 4°,SuperSchool,259,14,245
2025-08-19,13,Primaria 4°,EduMax,231,2,229
2025-08-19,13,Primaria 4°,TopKids,270,24,246
2025-08-19,13,Primaria 4°,TopKids,253,4,249
2025-08-19,13,Primaria 4°,SuperSchool,137,17,120
2025-08-19,13,Primaria 4°,SuperSchool,288,20,268
2025-08-19,13,Primaria 4°,EduMax,135,7,128
2025-08-19,13,Primaria 4°,EduMax,270,4,266
2025-08-19,13,Primaria 4°,EduMax,255,14,241
2025-08-19,13,Primaria 4°,SuperSchool,287,22,265
2025-08-19,13,Primaria 4°,EduMax,96,23,73
2025-08-19,13,Primaria 4°,EduMax,292,13,279
2025-08-19,13,Primaria 5°,TopKids,68,20,48
2025-08-19,13,Primaria 5°,EduMax,273,21,252
2025-08-19,13,Primaria 5°,TopKids,283,5,278
2025-08-19,13,Primaria 5°,SuperSchool,56,9,47
2025-08-19,13,Primaria 5°,EduMax,266,10,256
2025-08-19,13,Primaria 5°,EduMax,93,6,87
2025-08-19,13,Primaria 5°,TopKids,212,10,202
2025-08-19,13,Primaria 5°,SuperSchool,250,20,230
2025-08-19,13,Primaria 5°,SuperSchool,212,5,207
2025-08-19,13,Primaria 5°,EduMax,169,22,147
2025-08-19,13,Primaria 5°,TopKids,176,17,159
2025-08-19,13,Primaria 5°,TopKids,299,16,283
2025-08-19,13,Primaria 5°,EduMax,209,11,198
2025-08-19,13,Primaria 5°,EduMax,200,9,191
2025-08-19,13,Primaria 5°,TopKids,205,24,181
2025-08-19,13,Primaria 5°,TopKids,152,18,134
2025-08-19,13,Primaria 6°,TopKids,147,22,125
2025-08-19,13,Primaria 6°,SuperSchool,211,10,201
2025-08-19,13,Primaria 6°,TopKids,123,19,104
2025-08-19,13,Primaria 6°,EduMax,222,24,198
2025-08-19,13,Primaria 6°,TopKids,295,2,293
2025-08-19,14,Preescolar,TopKids,190,22,168
2025-08-19,14,Preescolar,SuperSchool,295,21,274
2025-08-19,14,Preescolar,SuperSchool,235,5,230
2025-08-19,14,Preescolar,SuperSchool,135,7,128
2025-08-19,14,Preescolar,SuperSchool,286,20,266
2025-08-19,14,Preescolar,TopKids,198,6,192
2025-08-19,14,Preescolar,SuperSchool,227,11,216
2025-08-19,14,Preescolar,TopKids,137,24,113
2025-08-19,14,Preescolar,TopKids,154,3,151
2025-08-19,14,Kínder,SuperSchool,162,3,159
2025-08-19,14,Kínder,TopKids,282,17,265
2025-08-19,14,Kínder,TopKids,99,23,76
2025-08-19,14,Kínder,TopKids,96,1,95
2025-08-19,14,Kínder,SuperSchool,235,10,225
2025-08-19,14,Primaria 1°,EduMax,174,2,172
2025-08-19,14,Primaria 1°,TopKids,255,8,247
2025-08-19,14,Primaria 1°,TopKids,178,16,162
2025-08-19,14,Primaria 1°,SuperSchool,73,15,58
2025-08-19,14,Primaria 1°,EduMax,118,3,115
2025-08-19,14,Primaria 1°,SuperSchool,238,10,228
2025-08-19,14,Primaria 1°,SuperSchool,60,6,54
2025-08-19,14,Primaria 1°,TopKids,196,7,189
2025-08-19,14,Primaria 1°,EduMax,290,23,267
2025-08-19,14,Primaria 1°,SuperSchool,62,1,61
2025-08-19,14,Primaria 1°,EduMax,259,4,255
2025-08-19,14,Primaria 1°,SuperSchool,274,4,270
2025-08-19,14,Primaria 2°,SuperSchool,250,17,233
2025-08-19,14,Primaria 2°,SuperSchool,72,20,52
2025-08-19,14,Primaria 2°,SuperSchool,179,3,176
2025-08-19,14,Primaria 2°,TopKids,203,15,188
2025-08-19,14,Primaria 2°,TopKids,277,12,265
2025-08-19,14,Primaria 2°,SuperSchool,162,4,158
2025-08-19,14,Primaria 3°,EduMax,72,9,63
2025-08-19,14,Primaria 3°,EduMax,269,21,248
2025-08-19,14,Primaria 3°,EduMax,204,19,185
2025-08-19,14,Primaria 3°,TopKids,256,22,234
2025-08-19,14,Primaria 3°,SuperSchool,152,3,149
2025-08-19,14,Primaria 3°,SuperSchool,129,23,106
2025-08-19,14,Primaria 3°,TopKids,289,9,280
2025-08-19,14,Primaria 3°,SuperSchool,84,8,76
2025-08-19,14,Primaria 4°,EduMax,201,19,182
2025-08-19,14,Primaria 4°,TopKids,238,20,218
2025-08-19,14,Primaria 4°,TopKids,279,11,268
2025-08-19,14,Primaria 4°,SuperSchool,157,1,156
2025-08-19,14,Primaria 4°,TopKids,156,15,141
2025-08-19,14,Primaria 4°,SuperSchool,65,3,62
2025-08-19,14,Primaria 5°,TopKids,251,2,249
2025-08-19,14,Primaria 5°,SuperSchool,264,23,241
2025-08-19,14,Primaria 5°,SuperSchool,142,8,134
2025-08-19,14,Primaria 5°,SuperSchool,160,2,158
2025-08-19,14,Primaria 5°,SuperSchool,176,19,157
2025-08-19,14,Primaria 5°,SuperSchool,173,23,150
2025-08-19,14,Primaria 5°,SuperSchool,185,10,175
2025-08-19,14,Primaria 5°,SuperSchool,246,22,224
2025-08-19,14,Primaria 5°,SuperSchool,123,14,109
2025-08-19,14,Primaria 5°,EduMax,124,14,110
2025-08-19,14,Primaria 5°,EduMax,116,21,95
2025-08-19,14,Primaria 5°,EduMax,162,5,157
2025-08-19,14,Primaria 5°,EduMax,184,17,167
2025-08-19,14,Primaria 5°,EduMax,60,12,48
2025-08-19,14,Primaria 5°,SuperSchool,236,24,212
2025-08-19,14,Primaria 6°,TopKids,132,5,127
2025-08-19,14,Primaria 6°,TopKids,104,19,85
2025-08-19,14,Primaria 6°,TopKids,262,22,240
2025-08-19,14,Primaria 6°,EduMax,60,14,46
2025-08-19,14,Primaria 6°,SuperSchool,179,11,168
2025-08-19,14,Primaria 6°,EduMax,177,7,170
2025-08-19,15,Preescolar,SuperSchool,159,24,135
2025-08-19,15,Preescolar,SuperSchool,265,12,253
2025-08-19,15,Preescolar,TopKids,177,5,172
2025-08-19,15,Preescolar,EduMax,299,8,291
2025-08-19,15,Preescolar,TopKids,167,4,163
2025-08-19,15,Preescolar,TopKids,133,12,121
2025-08-19,15,Preescolar,EduMax,296,21,275
2025-08-19,15,Preescolar,EduMax,79,24,55
2025-08-19,15,Kínder,TopKids,229,8,221
2025-08-19,15,Kínder,SuperSchool,215,3,212
2025-08-19,15,Kínder,SuperSchool,57,23,34
2025-08-19,15,Kínder,EduMax,246,11,235
2025-08-19,15,Kínder,SuperSchool,235,3,232
2025-08-19,15,Kínder,EduMax,89,24,65
2025-08-19,15,Kínder,SuperSchool,65,14,51
2025-08-19,15,Kínder,SuperSchool,97,4,93
2025-08-19,15,Kínder,SuperSchool,242,22,220
2025-08-19,15,Kínder,TopKids,293,20,273
2025-08-19,15,Kínder,TopKids,63,9,54
2025-08-19,15,Primaria 1°,EduMax,53,1,52
2025-08-19,15,Primaria 1°,TopKids,214,2,212
2025-08-19,15,Primaria 1°,TopKids,222,17,205
2025-08-19,15,Primaria 1°,SuperSchool,227,21,206
2025-08-19,15,Primaria 1°,TopKids,112,9,103
2025-08-19,15,Primaria 1°,EduMax,173,20,153
2025-08-19,15,Primaria 1°,TopKids,116,8,108
2025-08-19,15,Primaria 2°,SuperSchool,165,13,152
2025-08-19,15,Primaria 2°,SuperSchool,113,5,108
2025-08-19,15,Primaria 2°,SuperSchool,297,16,281
2025-08-19,15,Primaria 2°,SuperSchool,181,9,172
2025-08-19,15,Primaria 2°,SuperSchool,214,21,193
2025-08-19,15,Primaria 2°,SuperSchool,201,19,182
2025-08-19,15,Primaria 2°,SuperSchool,78,8,70
2025-08-19,15,Primaria 3°,EduMax,160,4,156
2025-08-19,15,Primaria 3°,TopKids,158,18,140
2025-08-19,15,Primaria 3°,SuperSchool,195,8,187
2025-08-19,15,Primaria 3°,SuperSchool,68,23,45
2025-08-19,15,Primaria 3°,EduMax,290,2,288
2025-08-19,15,Primaria 3°,TopKids,239,16,223
2025-08-19,15,Primaria 3°,EduMax,67,2,65
2025-08-19,15,Primaria 4°,TopKids,55,7,48
2025-08-19,15,Primaria 4°,EduMax,236,6,230
2025-08-19,15,Primaria 4°,TopKids,154,8,146
2025-08-19,15,Primaria 4°,EduMax,105,22,83
2025-08-19,15,Primaria 4°,SuperSchool,218,12,206
2025-08-19,15,Primaria 4°,EduMax,136,6,130
2025-08-19,15,Primaria 4°,TopKids,269,4,265
2025-08-19,15,Primaria 4°,SuperSchool,56,18,38
2025-08-19,15,Primaria 4°,SuperSchool,197,5,192
2025-08-19,15,Primaria 4°,EduMax,155,8,147
2025-08-19,15,Primaria 4°,SuperSchool,128,3,125
2025-08-19,15,Primaria 4°,TopKids,159,1,158
2025-08-19,15,Primaria 4°,TopKids,262,8,254
2025-08-19,15,Primaria 4°,TopKids,90,18,72
2025-08-19,15,Primaria 4°,EduMax,87,3,84
2025-08-19,15,Primaria 4°,EduMax,223,8,215
2025-08-19,15,Primaria 5°,SuperSchool,134,13,121
2025-08-19,15,Primaria 5°,SuperSchool,222,9,213
2025-08-19,15,Primaria 5°,EduMax,239,19,220
2025-08-19,15,Primaria 5°,EduMax,193,24,169
2025-08-19,15,Primaria 5°,SuperSchool,118,23,95
2025-08-19,15,Primaria 5°,EduMax,297,6,291
2025-08-19,15,Primaria 5°,TopKids,102,24,78
2025-08-19,15,Primaria 5°,SuperSchool,177,17,160
2025-08-19,15,Primaria 5°,SuperSchool,244,13,231
2025-08-19,15,Primaria 5°,EduMax,199,21,178
2025-08-19,15,Primaria 6°,SuperSchool,223,7,216
2025-08-19,15,Primaria 6°,SuperSchool,255,18,237
2025-08-19,15,Primaria 6°,SuperSchool,216,20,196
2025-08-19,15,Primaria 6°,SuperSchool,277,13,264
2025-08-19,15,Primaria 6°,TopKids,185,20,165
2025-08-19,15,Primaria 6°,SuperSchool,162,15,147
2025-08-19,15,Primaria 6°,EduMax,297,22,275
2025-08-19,15,Primaria 6°,EduMax,283,4,279
2025-08-19,15,Primaria 6°,SuperSchool,65,7,58
2025-08-19,15,Primaria 6°,EduMax,236,6,230
2025-08-19,15,Primaria 6°,SuperSchool,67,12,55
2025-08-19,15,Primaria 6°,EduMax,268,15,253
2025-08-19,15,Primaria 6°,SuperSchool,192,15,177
2025-08-19,15,Primaria 6°,TopKids,257,21,236
2025-08-19,15,Primaria 6°,SuperSchool,142,3,139
2025-08-19,15,Primaria 6°,TopKids,214,1,213
2025-08-19,15,Primaria 6°,SuperSchool,288,8,280
2025-08-19,16,Preescolar,EduMax,78,23,55
2025-08-19,16,Preescolar,SuperSchool,100,12,88
2025-08-19,16,Preescolar,EduMax,196,4,192
2025-08-19,16,Preescolar,TopKids,299,6,293
2025-08-19,16,Preescolar,SuperSchool,156,9,147
2025-08-19,16,Preescolar,TopKids,142,9,133
2025-08-19,16,Preescolar,SuperSchool,125,3,122
2025-08-19,16,Preescolar,SuperSchool,294,12,282
2025-08-19,16,Preescolar,SuperSchool,99,4,95
2025-08-19,16,Preescolar,EduMax,259,8,251
2025-08-19,16,Preescolar,SuperSchool,164,13,151
2025-08-19,16,Preescolar,TopKids,170,6,164
2025-08-19,16,Preescolar,EduMax,120,21,99
2025-08-19,16,Preescolar,EduMax,156,17,139
2025-08-19,16,Preescolar,TopKids,77,12,65
2025-08-19,16,Kínder,SuperSchool,265,13,252
2025-08-19,16,Kínder,EduMax,206,7,199
2025-08-19,16,Kínder,SuperSchool,168,5,163
2025-08-19,16,Kínder,SuperSchool,113,16,97
2025-08-19,16,Kínder,EduMax,277,23,254
2025-08-19,16,Kínder,SuperSchool,53,3,50
2025-08-19,16,Kínder,SuperSchool,145,4,141
2025-08-19,16,Kínder,SuperSchool,189,13,176
2025-08-19,16,Kínder,EduMax,173,9,164
2025-08-19,16,Primaria 1°,TopKids,190,22,168
2025-08-19,16,Primaria 1°,EduMax,210,18,192
2025-08-19,16,Primaria 1°,TopKids,195,19,176
2025-08-19,16,Primaria 1°,TopKids,253,11,242
2025-08-19,16,Primaria 1°,TopKids,79,9,70
2025-08-19,16,Primaria 1°,TopKids,130,11,119
2025-08-19,16,Primaria 1°,TopKids,179,23,156
2025-08-19,16,Primaria 1°,TopKids,291,22,269
2025-08-19,16,Primaria 1°,SuperSchool,203,12,191
2025-08-19,16,Primaria 1°,SuperSchool,284,5,279
2025-08-19,16,Primaria 1°,EduMax,248,1,247
2025-08-19,16,Primaria 1°,SuperSchool,144,5,139
2025-08-19,16,Primaria 1°,EduMax,286,11,275
2025-08-19,16,Primaria 1°,EduMax,160,10,150
2025-08-19,16,Primaria 1°,EduMax,70,15,55
2025-08-19,16,Primaria 1°,SuperSchool,119,5,114
2025-08-19,16,Primaria 1°,EduMax,295,3,292
2025-08-19,16,Primaria 1°,TopKids,220,16,204
2025-08-19,16,Primaria 1°,TopKids,122,3,119
2025-08-19,16,Primaria 2°,TopKids,159,2,157
2025-08-19,16,Primaria 2°,TopKids,59,10,49
2025-08-19,16,Primaria 2°,SuperSchool,55,21,34
2025-08-19,16,Primaria 2°,EduMax,115,6,109
2025-08-19,16,Primaria 2°,SuperSchool,116,4,112
2025-08-19,16,Primaria 2°,SuperSchool,84,15,69
2025-08-19,16,Primaria 2°,SuperSchool,199,11,188
2025-08-19,16,Primaria 3°,EduMax,66,5,61
2025-08-19,16,Primaria 3°,SuperSchool,106,24,82
2025-08-19,16,Primaria 3°,TopKids,217,21,196
2025-08-19,16,Primaria 3°,EduMax,219,7,212
2025-08-19,16,Primaria 3°,SuperSchool,173,7,166
2025-08-19,16,Primaria 3°,TopKids,265,19,246
2025-08-19,16,Primaria 3°,SuperSchool,297,2,295
2025-08-19,16,Primaria 3°,EduMax,101,19,82
2025-08-19,16,Primaria 4°,EduMax,251,13,238
2025-08-19,16,Primaria 4°,TopKids,202,2,200
2025-08-19,16,Primaria 4°,EduMax,251,5,246
2025-08-19,16,Primaria 4°,EduMax,117,23,94
2025-08-19,16,Primaria 4°,EduMax,120,18,102
2025-08-19,16,Primaria 4°,SuperSchool,60,21,39
2025-08-19,16,Primaria 4°,EduMax,185,12,173
2025-08-19,16,Primaria 4°,SuperSchool,293,21,272
2025-08-19,16,Primaria 4°,TopKids,139,6,133
2025-08-19,16,Primaria 4°,TopKids,150,14,136
2025-08-19,16,Primaria 4°,SuperSchool,222,17,205
2025-08-19,16,Primaria 4°,TopKids,192,6,186
2025-08-19,16,Primaria 4°,EduMax,213,20,193
2025-08-19,16,Primaria 4°,SuperSchool,106,21,85
2025-08-19,16,Primaria 4°,TopKids,290,6,284
2025-08-19,16,Primaria 5°,SuperSchool,76,17,59
2025-08-19,16,Primaria 5°,TopKids,60,23,37
2025-08-19,16,Primaria 5°,TopKids,179,19,160
2025-08-19,16,Primaria 5°,EduMax,231,13,218
2025-08-19,16,Primaria 5°,TopKids,226,11,215
2025-08-19,16,Primaria 5°,SuperSchool,204,24,180
2025-08-19,16,Primaria 5°,SuperSchool,174,14,160
2025-08-19,16,Primaria 5°,SuperSchool,266,11,255
2025-08-19,16,Primaria 5°,EduMax,148,1,147
2025-08-19,16,Primaria 5°,TopKids,89,19,70
2025-08-19,16,Primaria 5°,SuperSchool,280,13,267
2025-08-19,16,Primaria 5°,EduMax,119,3,116
2025-08-19,16,Primaria 6°,TopKids,62,13,49
2025-08-19,16,Primaria 6°,EduMax,298,13,285
2025-08-19,16,Primaria 6°,SuperSchool,89,5,84
2025-08-19,16,Primaria 6°,TopKids,293,17,276
2025-08-19,16,Primaria 6°,SuperSchool,158,13,145
2025-08-19,16,Primaria 6°,SuperSchool,191,11,180
2025-08-19,16,Primaria 6°,SuperSchool,272,14,258
2025-08-19,16,Primaria 6°,SuperSchool,120,24,96
2025-08-19,16,Primaria 6°,SuperSchool,149,10,139
2025-08-19,16,Primaria 6°,EduMax,96,20,76
2025-08-20,9,Preescolar,SuperSchool,180,15,165
2025-08-20,9,Preescolar,EduMax,160,1,159
2025-08-20,9,Preescolar,TopKids,188,5,183
2025-08-20,9,Preescolar,TopKids,61,20,41
2025-08-20,9,Preescolar,SuperSchool,215,22,193
2025-08-20,9,Preescolar,TopKids,155,21,134
2025-08-20,9,Preescolar,EduMax,295,4,291
2025-08-20,9,Preescolar,SuperSchool,228,5,223
2025-08-20,9,Preescolar,TopKids,108,22,86
2025-08-20,9,Preescolar,EduMax,50,21,29
2025-08-20,9,Preescolar,SuperSchool,77,16,61
2025-08-20,9,Preescolar,EduMax,260,16,244
2025-08-20,9,Preescolar,SuperSchool,272,20,252
2025-08-20,9,Preescolar,EduMax,147,14,133
2025-08-20,9,Preescolar,EduMax,141,3,138
2025-08-20,9,Preescolar,TopKids,257,17,240
2025-08-20,9,Kínder,TopKids,228,24,204
2025-08-20,9,Kínder,TopKids,190,16,174
2025-08-20,9,Kínder,TopKids,197,16,181
2025-08-20,9,Kínder,TopKids,293,2,291
2025-08-20,9,Kínder,TopKids,109,4,105
2025-08-20,9,Kínder,SuperSchool,178,1,177
2025-08-20,9,Kínder,EduMax,54,22,32
2025-08-20,9,Kínder,EduMax,209,6,203
2025-08-20,9,Kínder,SuperSchool,66,22,44
2025-08-20,9,Kínder,SuperSchool,89,24,65
2025-08-20,9,Kínder,TopKids,177,19,158
2025-08-20,9,Kínder,SuperSchool,262,20,242
2025-08-20,9,Kínder,SuperSchool,122,21,101
2025-08-20,9,Kínder,EduMax,109,2,107
2025-08-20,9,Kínder,TopKids,168,20,148
2025-08-20,9,Kínder,SuperSchool,230,18,212
2025-08-20,9,Primaria 1°,TopKids,129,1,128
2025-08-20,9,Primaria 1°,EduMax,108,22,86
2025-08-20,9,Primaria 1°,TopKids,138,2,136
2025-08-20,9,Primaria 1°,SuperSchool,165,11,154
2025-08-20,9,Primaria 1°,TopKids,212,23,189
2025-08-20,9,Primaria 1°,SuperSchool,94,21,73
2025-08-20,9,Primaria 1°,SuperSchool,83,6,77
2025-08-20,9,Primaria 1°,EduMax,157,4,153
2025-08-20,9,Primaria 1°,SuperSchool,296,8,288
2025-08-20,9,Primaria 1°,EduMax,70,3,67
2025-08-20,9,Primaria 1°,TopKids,249,19,230
2025-08-20,9,Primaria 1°,SuperSchool,252,18,234
2025-08-20,9,Primaria 1°,EduMax,235,20,215
2025-08-20,9,Primaria 1°,SuperSchool,249,19,230
2025-08-20,9,Primaria 1°,SuperSchool,289,21,268
2025-08-20,9,Primaria 1°,EduMax,58,4,54
2025-08-20,9,Primaria 1°,SuperSchool,74,2,72
2025-08-20,9,Primaria 1°,SuperSchool,186,18,168
2025-08-20,9,Primaria 1°,TopKids,190,6,184
2025-08-20,9,Primaria 2°,EduMax,56,15,41
2025-08-20,9,Primaria 2°,SuperSchool,87,11,76
2025-08-20,9,Primaria 2°,TopKids,271,20,251
2025-08-20,9,Primaria 2°,SuperSchool,149,19,130
2025-08-20,9,Primaria 2°,TopKids,156,13,143
2025-08-20,9,Primaria 2°,TopKids,171,21,150
2025-08-20,9,Primaria 2°,TopKids,191,2,189
2025-08-20,9,Primaria 2°,SuperSchool,195,5,190
2025-08-20,9,Primaria 2°,SuperSchool,94,24,70
2025-08-20,9,Primaria 2°,EduMax,189,21,168
2025-08-20,9,Primaria 2°,SuperSchool,81,18,63
2025-08-20,9,Primaria 2°,SuperSchool,181,23,158
2025-08-20,9,Primaria 2°,EduMax,103,10,93
2025-08-20,9,Primaria 3°,SuperSchool,291,8,283
2025-08-20,9,Primaria 3°,EduMax,147,8,139
2025-08-20,9,Primaria 3°,TopKids,120,3,117
2025-08-20,9,Primaria 3°,SuperSchool,149,7,142
2025-08-20,9,Primaria 3°,SuperSchool,168,17,151
2025-08-20,9,Primaria 3°,SuperSchool,240,20,220
2025-08-20,9,Primaria 3°,EduMax,95,13,82
2025-08-20,9,Primaria 3°,SuperSchool,230,17,213
2025-08-20,9,Primaria 3°,TopKids,111,18,93
2025-08-20,9,Primaria 3°,TopKids,117,20,97
2025-08-20,9,Primaria 3°,TopKids,283,22,261
2025-08-20,9,Primaria 4°,EduMax,249,13,236
2025-08-20,9,Primaria 4°,SuperSchool,143,1,142
2025-08-20,9,Primaria 4°,SuperSchool,288,22,266
2025-08-20,9,Primaria 4°,TopKids,133,1,132
2025-08-20,9,Primaria 4°,SuperSchool,285,11,274
2025-08-20,9,Primaria 4°,TopKids,224,21,203
2025-08-20,9,Primaria 4°,EduMax,82,24,58
2025-08-20,9,Primaria 4°,TopKids,191,15,176
2025-08-20,9,Primaria 4°,SuperSchool,91,22,69
2025-08-20,9,Primaria 4°,SuperSchool,144,15,129
2025-08-20,9,Primaria 4°,TopKids,166,20,146
2025-08-20,9,Primaria 4°,TopKids,231,12,219
2025-08-20,9,Primaria 4°,TopKids,257,8,249
2025-08-20,9,Primaria 4°,EduMax,195,23,172
2025-08-20,9,Primaria 4°,EduMax,274,2,272
2025-08-20,9,Primaria 4°,SuperSchool,275,17,258
2025-08-20,9,Primaria 4°,SuperSchool,248,6,242
2025-08-20,9,Primaria 5°,EduMax,185,5,180
2025-08-20,9,Primaria 5°,TopKids,203,7,196
2025-08-20,9,Primaria 5°,TopKids,234,10,224
2025-08-20,9,Primaria 5°,TopKids,271,14,257
2025-08-20,9,Primaria 5°,EduMax,116,1,115
2025-08-20,9,Primaria 5°,SuperSchool,68,4,64
2025-08-20,9,Primaria 5°,EduMax,147,11,136
2025-08-20,9,Primaria 5°,SuperSchool,193,16,177
2025-08-20,9,Primaria 5°,TopKids,168,20,148
2025-08-20,9,Primaria 5°,SuperSchool,261,9,252
2025-08-20,9,Primaria 6°,TopKids,62,4,58
2025-08-20,9,Primaria 6°,SuperSchool,153,2,151
2025-08-20,9,Primaria 6°,TopKids,92,17,75
2025-08-20,9,Primaria 6°,SuperSchool,223,13,210
2025-08-20,9,Primaria 6°,TopKids,263,21,242
2025-08-20,9,Primaria 6°,SuperSchool,90,3,87
2025-08-20,9,Primaria 6°,SuperSchool,126,13,113
2025-08-20,9,Primaria 6°,SuperSchool,67,5,62
2025-08-20,9,Primaria 6°,TopKids,211,17,194
2025-08-20,9,Primaria 6°,TopKids,101,21,80
2025-08-20,9,Primaria 6°,EduMax,236,18,218
2025-08-20,9,Primaria 6°,TopKids,189,11,178
2025-08-20,9,Primaria 6°,SuperSchool,269,3,266
2025-08-20,9,Primaria 6°,TopKids,193,13,180
2025-08-20,9,Primaria 6°,TopKids,96,3,93
2025-08-20,10,Preescolar,SuperSchool,238,12,226
2025-08-20,10,Preescolar,EduMax,84,12,72
2025-08-20,10,Preescolar,SuperSchool,296,21,275
2025-08-20,10,Preescolar,EduMax,232,2,230
2025-08-20,10,Preescolar,EduMax,159,4,155
2025-08-20,10,Preescolar,SuperSchool,288,16,272
2025-08-20,10,Preescolar,SuperSchool,201,17,184
2025-08-20,10,Preescolar,TopKids,248,23,225
2025-08-20,10,Preescolar,TopKids,130,12,118
2025-08-20,10,Preescolar,TopKids,164,11,153
2025-08-20,10,Preescolar,EduMax,176,15,161
2025-08-20,10,Preescolar,SuperSchool,163,21,142
2025-08-20,10,Preescolar,SuperSchool,225,4,221
2025-08-20,10,Preescolar,TopKids,296,10,286
2025-08-20,10,Preescolar,EduMax,177,2,175
2025-08-20,10,Preescolar,TopKids,149,16,133
2025-08-20,10,Preescolar,EduMax,236,7,229
2025-08-20,10,Preescolar,SuperSchool,298,12,286
2025-08-20,10,Preescolar,TopKids,130,9,121
2025-08-20,10,Kínder,TopKids,279,15,264
2025-08-20,10,Kínder,EduMax,232,6,226
2025-08-20,10,Kínder,TopKids,207,14,193
2025-08-20,10,Kínder,EduMax,164,13,151
2025-08-20,10,Kínder,EduMax,244,4,240
2025-08-20,10,Kínder,EduMax,255,14,241
2025-08-20,10,Kínder,EduMax,89,10,79
2025-08-20,10,Kínder,SuperSchool,95,8,87
2025-08-20,10,Kínder,TopKids,219,18,201
2025-08-20,10,Kínder,EduMax,110,8,102
2025-08-20,10,Kínder,TopKids,131,7,124
2025-08-20,10,Kínder,TopKids,114,22,92
2025-08-20,10,Primaria 1°,SuperSchool,52,3,49
2025-08-20,10,Primaria 1°,TopKids,70,19,51
2025-08-20,10,Primaria 1°,SuperSchool,190,15,175
2025-08-20,10,Primaria 1°,TopKids,225,7,218
2025-08-20,10,Primaria 1°,TopKids,143,20,123
2025-08-20,10,Primaria 1°,EduMax,291,11,280
2025-08-20,10,Primaria 1°,SuperSchool,97,17,80
2025-08-20,10,Primaria 1°,EduMax,130,3,127
2025-08-20,10,Primaria 1°,EduMax,68,14,54
2025-08-20,10,Primaria 1°,SuperSchool,298,2,296
2025-08-20,10,Primaria 1°,TopKids,175,17,158
2025-08-20,10,Primaria 1°,TopKids,183,19,164
2025-08-20,10,Primaria 1°,SuperSchool,280,22,258
2025-08-20,10,Primaria 1°,TopKids,241,7,234
2025-08-20,10,Primaria 1°,SuperSchool,222,21,201
2025-08-20,10,Primaria 1°,SuperSchool,143,19,124
2025-08-20,10,Primaria 1°,TopKids,168,15,153
2025-08-20,10,Primaria 2°,SuperSchool,276,21,255
2025-08-20,10,Primaria 2°,SuperSchool,280,1,279
2025-08-20,10,Primaria 2°,TopKids,272,24,248
2025-08-20,10,Primaria 2°,TopKids,240,3,237
2025-08-20,10,Primaria 2°,TopKids,286,22,264
2025-08-20,10,Primaria 2°,EduMax,120,1,119
2025-08-20,10,Primaria 2°,TopKids,158,4,154
2025-08-20,10,Primaria 2°,TopKids,177,2,175
2025-08-20,10,Primaria 2°,SuperSchool,114,14,100
2025-08-20,10,Primaria 2°,EduMax,263,21,242
2025-08-20,10,Primaria 2°,SuperSchool,203,3,200
2025-08-20,10,Primaria 2°,TopKids,124,7,117
2025-08-20,10,Primaria 2°,SuperSchool,238,9,229
2025-08-20,10,Primaria 2°,TopKids,231,3,228
2025-08-20,10,Primaria 2°,SuperSchool,100,2,98
2025-08-20,10,Primaria 2°,TopKids,70,24,46
2025-08-20,10,Primaria 2°,SuperSchool,113,17,96
2025-08-20,10,Primaria 2°,TopKids,173,5,168
2025-08-20,10,Primaria 3°,SuperSchool,127,10,117
2025-08-20,10,Primaria 3°,SuperSchool,248,8,240
2025-08-20,10,Primaria 3°,EduMax,121,7,114
2025-08-20,10,Primaria 3°,SuperSchool,159,19,140
2025-08-20,10,Primaria 3°,TopKids,179,17,162
2025-08-20,10,Primaria 3°,EduMax,206,9,197
2025-08-20,10,Primaria 3°,TopKids,182,9,173
2025-08-20,10,Primaria 3°,EduMax,207,7,200
2025-08-20,10,Primaria 3°,EduMax,149,18,131
2025-08-20,10,Primaria 3°,EduMax,101,17,84
2025-08-20,10,Primaria 3°,EduMax,149,22,127
2025-08-20,10,Primaria 4°,TopKids,182,9,173
2025-08-20,10,Primaria 4°,EduMax,147,4,143
2025-08-20,10,Primaria 4°,TopKids,293,20,273
2025-08-20,10,Primaria 4°,SuperSchool,261,21,240
2025-08-20,10,Primaria 4°,SuperSchool,132,3,129
2025-08-20,10,Primaria 4°,EduMax,246,10,236
2025-08-20,10,Primaria 4°,EduMax,52,17,35
2025-08-20,10,Primaria 4°,EduMax,73,12,61
2025-08-20,10,Primaria 4°,SuperSchool,291,19,272
2025-08-20,10,Primaria 4°,EduMax,229,4,225
2025-08-20,10,Primaria 5°,SuperSchool,87,12,75
2025-08-20,10,Primaria 5°,EduMax,264,15,249
2025-08-20,10,Primaria 5°,SuperSchool,228,9,219
2025-08-20,10,Primaria 5°,EduMax,241,24,217
2025-08-20,10,Primaria 5°,SuperSchool,97,13,84
2025-08-20,10,Primaria 5°,SuperSchool,163,22,141
2025-08-20,10,Primaria 5°,TopKids,66,22,44
2025-08-20,10,Primaria 5°,SuperSchool,110,6,104
2025-08-20,10,Primaria 5°,SuperSchool,130,17,113
2025-08-20,10,Primaria 5°,TopKids,274,7,267
2025-08-20,10,Primaria 5°,EduMax,175,16,159
2025-08-20,10,Primaria 5°,SuperSchool,97,4,93
2025-08-20,10,Primaria 5°,TopKids,127,13,114
2025-08-20,10,Primaria 5°,TopKids,137,8,129
2025-08-20,10,Primaria 5°,SuperSchool,240,20,220
2025-08-20,10,Primaria 5°,TopKids,291,7,284
2025-08-20,10,Primaria 5°,SuperSchool,164,9,155
2025-08-20,10,Primaria 5°,TopKids,144,10,134
2025-08-20,10,Primaria 5°,EduMax,225,8,217
2025-08-20,10,Primaria 6°,TopKids,147,16,131
2025-08-20,10,Primaria 6°,EduMax,253,24,229
2025-08-20,10,Primaria 6°,SuperSchool,197,21,176
2025-08-20,10,Primaria 6°,EduMax,155,20,135
2025-08-20,10,Primaria 6°,EduMax,298,18,280
2025-08-20,11,Preescolar,SuperSchool,51,12,39
2025-08-20,11,Preescolar,EduMax,249,19,230
2025-08-20,11,Preescolar,EduMax,252,14,238
2025-08-20,11,Preescolar,EduMax,96,24,72
2025-08-20,11,Preescolar,TopKids,219,4,215
2025-08-20,11,Preescolar,TopKids,188,24,164
2025-08-20,11,Kínder,EduMax,244,5,239
2025-08-20,11,Kínder,EduMax,179,12,167
2025-08-20,11,Kínder,SuperSchool,246,7,239
2025-08-20,11,Kínder,EduMax,92,22,70
2025-08-20,11,Kínder,SuperSchool,149,22,127
2025-08-20,11,Kínder,SuperSchool,250,12,238
2025-08-20,11,Kínder,SuperSchool,249,1,248
2025-08-20,11,Kínder,TopKids,245,14,231
2025-08-20,11,Kínder,TopKids,142,14,128
2025-08-20,11,Kínder,SuperSchool,122,17,105
2025-08-20,11,Primaria 1°,EduMax,194,9,185
2025-08-20,11,Primaria 1°,SuperSchool,159,3,156
2025-08-20,11,Primaria 1°,SuperSchool,74,21,53
2025-08-20,11,Primaria 1°,EduMax,50,1,49
2025-08-20,11,Primaria 1°,SuperSchool,223,16,207
2025-08-20,11,Primaria 1°,TopKids,59,15,44
2025-08-20,11,Primaria 1°,TopKids,233,14,219
2025-08-20,11,Primaria 1°,SuperSchool,136,13,123
2025-08-20,11,Primaria 1°,TopKids,282,17,265
2025-08-20,11,Primaria 1°,EduMax,110,19,91
2025-08-20,11,Primaria 1°,SuperSchool,189,21,168
2025-08-20,11,Primaria 1°,TopKids,57,24,33
2025-08-20,11,Primaria 1°,TopKids,216,1,215
2025-08-20,11,Primaria 1°,EduMax,192,4,188
2025-08-20,11,Primaria 1°,SuperSchool,209,11,198
2025-08-20,11,Primaria 1°,EduMax,86,19,67
2025-08-20,11,Primaria 1°,TopKids,277,2,275
2025-08-20,11,Primaria 1°,TopKids,237,13,224
2025-08-20,11,Primaria 1°,SuperSchool,189,2,187
2025-08-20,11,Primaria 2°,SuperSchool,97,8,89
2025-08-20,11,Primaria 2°,EduMax,272,4,268
2025-08-20,11,Primaria 2°,TopKids,66,8,58
2025-08-20,11,Primaria 2°,TopKids,281,6,275
2025-08-20,11,Primaria 2°,TopKids,211,15,196
2025-08-20,11,Primaria 2°,SuperSchool,119,19,100
2025-08-20,11,Primaria 2°,SuperSchool,288,9,279
2025-08-20,11,Primaria 2°,TopKids,211,16,195
2025-08-20,11,Primaria 2°,EduMax,195,6,189
2025-08-20,11,Primaria 2°,EduMax,220,7,213
2025-08-20,11,Primaria 3°,TopKids,95,18,77
2025-08-20,11,Primaria 3°,TopKids,283,8,275
2025-08-20,11,Primaria 3°,EduMax,227,5,222
2025-08-20,11,Primaria 3°,EduMax,231,22,209
2025-08-20,11,Primaria 3°,EduMax,71,10,61
2025-08-20,11,Primaria 3°,EduMax,128,6,122
2025-08-20,11,Primaria 3°,SuperSchool,283,23,260
2025-08-20,11,Primaria 3°,SuperSchool,178,14,164
2025-08-20,11,Primaria 3°,TopKids,77,2,75
2025-08-20,11,Primaria 3°,TopKids,237,7,230
2025-08-20,11,Primaria 3°,EduMax,136,14,122
2025-08-20,11,Primaria 4°,TopKids,174,18,156
2025-08-20,11,Primaria 4°,TopKids,174,1,173
2025-08-20,11,Primaria 4°,SuperSchool,75,3,72
2025-08-20,11,Primaria 4°,SuperSchool,256,4,252
2025-08-20,11,Primaria 4°,TopKids,91,6,85
2025-08-20,11,Primaria 4°,SuperSchool,216,22,194
2025-08-20,11,Primaria 4°,SuperSchool,71,11,60
2025-08-20,11,Primaria 4°,EduMax,279,5,274
2025-08-20,11,Primaria 4°,TopKids,139,19,120
2025-08-20,11,Primaria 4°,TopKids,107,13,94
2025-08-20,11,Primaria 4°,TopKids,185,14,171
2025-08-20,11,Primaria 4°,TopKids,292,23,269
2025-08-20,11,Primaria 4°,EduMax,157,23,134
2025-08-20,11,Primaria 4°,TopKids,58,14,44
2025-08-20,11,Primaria 4°,EduMax,160,13,147
2025-08-20,11,Primaria 4°,TopKids,188,10,178
2025-08-20,11,Primaria 5°,TopKids,227,23,204
2025-08-20,11,Primaria 5°,TopKids,90,5,85
2025-08-20,11,Primaria 5°,TopKids,233,13,220
2025-08-20,11,Primaria 5°,EduMax,284,17,267
2025-08-20,11,Primaria 5°,TopKids,256,6,250
2025-08-20,11,Primaria 6°,EduMax,196,20,176
2025-08-20,11,Primaria 6°,TopKids,243,3,240
2025-08-20,11,Primaria 6°,EduMax,295,4,291
2025-08-20,11,Primaria 6°,EduMax,98,6,92
2025-08-20,11,Primaria 6°,TopKids,90,4,86
2025-08-20,11,Primaria 6°,TopKids,85,11,74
2025-08-20,11,Primaria 6°,EduMax,175,23,152
2025-08-20,11,Primaria 6°,EduMax,187,6,181
2025-08-20,11,Primaria 6°,TopKids,286,22,264
2025-08-20,11,Primaria 6°,EduMax,69,1,68
2025-08-20,12,Preescolar,TopKids,265,18,247
2025-08-20,12,Preescolar,EduMax,128,5,123
2025-08-20,12,Preescolar,TopKids,137,11,126
2025-08-20,12,Preescolar,TopKids,70,8,62
2025-08-20,12,Preescolar,EduMax,279,15,264
2025-08-20,12,Preescolar,TopKids,86,13,73
2025-08-20,12,Preescolar,EduMax,92,20,72
2025-08-20,12,Preescolar,SuperSchool,285,20,265
2025-08-20,12,Preescolar,SuperSchool,52,8,44
2025-08-20,12,Preescolar,TopKids,221,15,206
2025-08-20,12,Preescolar,TopKids,140,3,137
2025-08-20,12,Preescolar,SuperSchool,145,22,123
2025-08-20,12,Preescolar,TopKids,165,6,159
2025-08-20,12,Preescolar,EduMax,141,11,130
2025-08-20,12,Preescolar,TopKids,51,5,46
2025-08-20,12,Preescolar,SuperSchool,222,13,209
2025-08-20,12,Preescolar,TopKids,83,23,60
2025-08-20,12,Preescolar,SuperSchool,56,23,33
2025-08-20,12,Preescolar,SuperSchool,249,18,231
2025-08-20,12,Kínder,TopKids,214,2,212
2025-08-20,12,Kínder,SuperSchool,214,23,191
2025-08-20,12,Kínder,EduMax,270,12,258
2025-08-20,12,Kínder,SuperSchool,229,8,221
2025-08-20,12,Kínder,TopKids,127,24,103
2025-08-20,12,Kínder,SuperSchool,155,2,153
2025-08-20,12,Kínder,TopKids,222,17,205
2025-08-20,12,Kínder,TopKids,84,10,74
2025-08-20,12,Kínder,SuperSchool,174,7,167
2025-08-20,12,Kínder,TopKids,225,5,220
2025-08-20,12,Kínder,SuperSchool,251,4,247
2025-08-20,12,Kínder,TopKids,191,5,186
2025-08-20,12,Kínder,EduMax,159,24,135
2025-08-20,12,Kínder,EduMax,76,24,52
2025-08-20,12,Kínder,SuperSchool,188,16,172
2025-08-20,12,Kínder,EduMax,172,16,156
2025-08-20,12,Kínder,SuperSchool,181,1,180
2025-08-20,12,Kínder,EduMax,285,24,261
2025-08-20,12,Kínder,EduMax,209,19,190
2025-08-20,12,Primaria 1°,SuperSchool,244,4,240
2025-08-20,12,Primaria 1°,EduMax,107,15,92
2025-08-20,12,Primaria 1°,TopKids,129,4,125
2025-08-20,12,Primaria 1°,EduMax,144,8,136
2025-08-20,12,Primaria 1°,SuperSchool,200,20,180
2025-08-20,12,Primaria 1°,SuperSchool,219,5,214
2025-08-20,12,Primaria 1°,SuperSchool,174,24,150
2025-08-20,12,Primaria 1°,EduMax,78,5,73
2025-08-20,12,Primaria 1°,TopKids,292,20,272
2025-08-20,12,Primaria 1°,TopKids,129,5,124
2025-08-20,12,Primaria 1°,SuperSchool,223,12,211
2025-08-20,12,Primaria 1°,SuperSchool,70,14,56
2025-08-20,12,Primaria 1°,SuperSchool,199,23,176
2025-08-20,12,Primaria 1°,SuperSchool,112,18,94
2025-08-20,12,Primaria 1°,EduMax,291,20,271
2025-08-20,12,Primaria 1°,SuperSchool,88,17,71
2025-08-20,12,Primaria 1°,TopKids,219,7,212
2025-08-20,12,Primaria 2°,EduMax,272,15,257
2025-08-20,12,Primaria 2°,TopKids,230,16,214
2025-08-20,12,Primaria 2°,EduMax,269,4,265
2025-08-20,12,Primaria 2°,EduMax,284,17,267
2025-08-20,12,Primaria 2°,EduMax,173,6,167
2025-08-20,12,Primaria 2°,TopKids,280,7,273
2025-08-20,12,Primaria 2°,EduMax,185,15,170
2025-08-20,12,Primaria 2°,TopKids,140,16,124
2025-08-20,12,Primaria 2°,SuperSchool,108,10,98
2025-08-20,12,Primaria 2°,TopKids,161,10,151
2025-08-20,12,Primaria 2°,SuperSchool,286,12,274
2025-08-20,12,Primaria 2°,TopKids,95,19,76
2025-08-20,12,Primaria 2°,TopKids,267,14,253
2025-08-20,12,Primaria 2°,EduMax,175,5,170
2025-08-20,12,Primaria 2°,SuperSchool,151,18,133
2025-08-20,12,Primaria 3°,TopKids,178,13,165
2025-08-20,12,Primaria 3°,TopKids,244,17,227
2025-08-20,12,Primaria 3°,EduMax,74,10,64
2025-08-20,12,Primaria 3°,SuperSchool,190,20,170
2025-08-20,12,Primaria 3°,TopKids,96,16,80
2025-08-20,12,Primaria 3°,EduMax,231,12,219
2025-08-20,12,Primaria 3°,SuperSchool,109,20,89
2025-08-20,12,Primaria 3°,TopKids,263,20,243
2025-08-20,12,Primaria 3°,EduMax,83,13,70
2025-08-20,12,Primaria 3°,EduMax,215,12,203
2025-08-20,12,Primaria 3°,TopKids,85,7,78
2025-08-20,12,Primaria 3°,SuperSchool,220,8,212
2025-08-20,12,Primaria 3°,TopKids,164,2,162
2025-08-20,12,Primaria 3°,SuperSchool,131,21,110
2025-08-20,12,Primaria 3°,EduMax,80,6,74
2025-08-20,12,Primaria 3°,EduMax,277,19,258
2025-08-20,12,Primaria 3°,EduMax,63,18,45
2025-08-20,12,Primaria 3°,SuperSchool,258,18,240
2025-08-20,12,Primaria 4°,TopKids,150,9,141
2025-08-20,12,Primaria 4°,SuperSchool,117,7,110
2025-08-20,12,Primaria 4°,TopKids,63,10,53
2025-08-20,12,Primaria 4°,TopKids,153,3,150
2025-08-20,12,Primaria 4°,SuperSchool,291,5,286
2025-08-20,12,Primaria 4°,TopKids,186,19,167
2025-08-20,12,Primaria 5°,TopKids,278,16,262
2025-08-20,12,Primaria 5°,EduMax,74,13,61
2025-08-20,12,Primaria 5°,EduMax,97,18,79
2025-08-20,12,Primaria 5°,SuperSchool,93,1,92
2025-08-20,12,Primaria 5°,TopKids,127,18,109
2025-08-20,12,Primaria 5°,TopKids,210,20,190
2025-08-20,12,Primaria 5°,EduMax,192,11,181
2025-08-20,12,Primaria 5°,TopKids,230,16,214
2025-08-20,12,Primaria 5°,EduMax,299,15,284
2025-08-20,12,Primaria 5°,TopKids,290,23,267
2025-08-20,12,Primaria 5°,TopKids,99,16,83
2025-08-20,12,Primaria 5°,TopKids,64,11,53
2025-08-20,12,Primaria 5°,SuperSchool,259,8,251
2025-08-20,12,Primaria 5°,TopKids,122,22,100
2025-08-20,12,Primaria 5°,TopKids,130,1,129
2025-08-20,12,Primaria 5°,EduMax,252,7,245
2025-08-20,12,Primaria 6°,TopKids,106,4,102
2025-08-20,12,Primaria 6°,TopKids,73,9,64
2025-08-20,12,Primaria 6°,SuperSchool,259,1,258
2025-08-20,12,Primaria 6°,EduMax,85,10,75
2025-08-20,12,Primaria 6°,TopKids,127,7,120
2025-08-20,12,Primaria 6°,EduMax,268,16,252
2025-08-20,12,Primaria 6°,SuperSchool,252,4,248
2025-08-20,12,Primaria 6°,SuperSchool,145,8,137
2025-08-20,12,Primaria 6°,TopKids,156,11,145
2025-08-20,12,Primaria 6°,EduMax,130,22,108
2025-08-20,12,Primaria 6°,EduMax,83,20,63
2025-08-20,12,Primaria 6°,SuperSchool,249,22,227
2025-08-20,13,Preescolar,EduMax,198,15,183
2025-08-20,13,Preescolar,SuperSchool,151,17,134
2025-08-20,13,Preescolar,TopKids,54,23,31
2025-08-20,13,Preescolar,TopKids,63,10,53
2025-08-20,13,Preescolar,TopKids,190,22,168
2025-08-20,13,Preescolar,SuperSchool,216,10,206
2025-08-20,13,Preescolar,TopKids,220,3,217
2025-08-20,13,Preescolar,SuperSchool,271,2,269
2025-08-20,13,Preescolar,TopKids,160,4,156
2025-08-20,13,Preescolar,TopKids,166,4,162
2025-08-20,13,Preescolar,EduMax,224,6,218
2025-08-20,13,Preescolar,TopKids,205,5,200
2025-08-20,13,Preescolar,TopKids,84,7,77
2025-08-20,13,Preescolar,TopKids,260,6,254
2025-08-20,13,Preescolar,SuperSchool,240,6,234
2025-08-20,13,Kínder,TopKids,276,5,271
2025-08-20,13,Kínder,SuperSchool,105,16,89
2025-08-20,13,Kínder,EduMax,129,9,120
2025-08-20,13,Kínder,EduMax,254,11,243
2025-08-20,13,Kínder,SuperSchool,123,10,113
2025-08-20,13,Kínder,EduMax,257,12,245
2025-08-20,13,Kínder,SuperSchool,83,19,64
2025-08-20,13,Kínder,SuperSchool,181,12,169
2025-08-20,13,Kínder,EduMax,253,16,237
2025-08-20,13,Kínder,EduMax,290,2,288
2025-08-20,13,Kínder,EduMax,174,23,151
2025-08-20,13,Kínder,TopKids,296,15,281
2025-08-20,13,Kínder,SuperSchool,95,16,79
2025-08-20,13,Kínder,TopKids,93,19,74
2025-08-20,13,Primaria 1°,EduMax,137,7,130
2025-08-20,13,Primaria 1°,EduMax,218,14,204
2025-08-20,13,Primaria 1°,EduMax,293,12,281
2025-08-20,13,Primaria 1°,TopKids,125,21,104
2025-08-20,13,Primaria 1°,SuperSchool,270,23,247
2025-08-20,13,Primaria 2°,SuperSchool,137,7,130
2025-08-20,13,Primaria 2°,EduMax,242,10,232
2025-08-20,13,Primaria 2°,SuperSchool,151,15,136
2025-08-20,13,Primaria 2°,TopKids,58,13,45
2025-08-20,13,Primaria 2°,TopKids,210,9,201
2025-08-20,13,Primaria 2°,TopKids,271,9,262
2025-08-20,13,Primaria 2°,TopKids,202,15,187
2025-08-20,13,Primaria 2°,TopKids,213,20,193
2025-08-20,13,Primaria 2°,SuperSchool,231,4,227
2025-08-20,13,Primaria 2°,EduMax,68,5,63
2025-08-20,13,Primaria 2°,TopKids,156,22,134
2025-08-20,13,Primaria 2°,TopKids,196,21,175
2025-08-20,13,Primaria 2°,EduMax,129,24,105
2025-08-20,13,Primaria 2°,EduMax,278,21,257
2025-08-20,13,Primaria 2°,SuperSchool,289,2,287
2025-08-20,13,Primaria 2°,TopKids,237,11,226
2025-08-20,13,Primaria 2°,EduMax,76,7,69
2025-08-20,13,Primaria 3°,SuperSchool,298,15,283
2025-08-20,13,Primaria 3°,TopKids,168,22,146
2025-08-20,13,Primaria 3°,TopKids,142,9,133
2025-08-20,13,Primaria 3°,EduMax,51,15,36
2025-08-20,13,Primaria 3°,TopKids,76,7,69
2025-08-20,13,Primaria 4°,SuperSchool,190,23,167
2025-08-20,13,Primaria 4°,SuperSchool,124,10,114
2025-08-20,13,Primaria 4°,SuperSchool,82,14,68
2025-08-20,13,Primaria 4°,SuperSchool,175,8,167
2025-08-20,13,Primaria 4°,SuperSchool,184,2,182
2025-08-20,13,Primaria 4°,TopKids,184,9,175
2025-08-20,13,Primaria 4°,EduMax,277,23,254
2025-08-20,13,Primaria 4°,TopKids,133,18,115
2025-08-20,13,Primaria 4°,SuperSchool,220,9,211
2025-08-20,13,Primaria 4°,EduMax,217,21,196
2025-08-20,13,Primaria 4°,EduMax,198,17,181
2025-08-20,13,Primaria 4°,TopKids,106,14,92
2025-08-20,13,Primaria 4°,EduMax,140,24,116
2025-08-20,13,Primaria 4°,SuperSchool,219,6,213
2025-08-20,13,Primaria 4°,EduMax,220,24,196
2025-08-20,13,Primaria 5°,EduMax,287,20,267
2025-08-20,13,Primaria 5°,TopKids,184,2,182
2025-08-20,13,Primaria 5°,TopKids,130,13,117
2025-08-20,13,Primaria 5°,EduMax,134,9,125
2025-08-20,13,Primaria 5°,SuperSchool,96,13,83
2025-08-20,13,Primaria 5°,SuperSchool,249,9,240
2025-08-20,13,Primaria 5°,SuperSchool,217,16,201
2025-08-20,13,Primaria 5°,EduMax,239,7,232
2025-08-20,13,Primaria 5°,SuperSchool,152,6,146
2025-08-20,13,Primaria 5°,SuperSchool,258,8,250
2025-08-20,13,Primaria 6°,SuperSchool,257,17,240
2025-08-20,13,Primaria 6°,EduMax,80,3,77
2025-08-20,13,Primaria 6°,SuperSchool,121,16,105
2025-08-20,13,Primaria 6°,EduMax,176,7,169
2025-08-20,13,Primaria 6°,SuperSchool,64,24,40
2025-08-20,13,Primaria 6°,EduMax,105,2,103
2025-08-20,13,Primaria 6°,EduMax,113,5,108
2025-08-20,13,Primaria 6°,TopKids,117,15,102
2025-08-20,13,Primaria 6°,SuperSchool,130,21,109
2025-08-20,13,Primaria 6°,TopKids,146,18,128
2025-08-20,13,Primaria 6°,TopKids,255,9,246
2025-08-20,13,Primaria 6°,SuperSchool,79,23,56
2025-08-20,13,Primaria 6°,EduMax,296,23,273
2025-08-20,13,Primaria 6°,TopKids,166,9,157
2025-08-20,14,Preescolar,EduMax,169,1,168
2025-08-20,14,Preescolar,SuperSchool,93,13,80
2025-08-20,14,Preescolar,EduMax,86,3,83
2025-08-20,14,Preescolar,TopKids,85,17,68
2025-08-20,14,Preescolar,TopKids,156,8,148
2025-08-20,14,Preescolar,EduMax,291,9,282
2025-08-20,14,Kínder,SuperSchool,162,13,149
2025-08-20,14,Kínder,EduMax,297,22,275
2025-08-20,14,Kínder,EduMax,256,23,233
2025-08-20,14,Kínder,EduMax,245,18,227
2025-08-20,14,Kínder,SuperSchool,113,12,101
2025-08-20,14,Kínder,EduMax,218,10,208
2025-08-20,14,Kínder,SuperSchool,237,18,219
2025-08-20,14,Kínder,SuperSchool,260,4,256
2025-08-20,14,Kínder,TopKids,122,8,114
2025-08-20,14,Primaria 1°,TopKids,155,8,147
2025-08-20,14,Primaria 1°,SuperSchool,253,14,239
2025-08-20,14,Primaria 1°,TopKids,61,2,59
2025-08-20,14,Primaria 1°,TopKids,95,7,88
2025-08-20,14,Primaria 1°,SuperSchool,235,13,222
2025-08-20,14,Primaria 1°,SuperSchool,149,1,148
2025-08-20,14,Primaria 1°,SuperSchool,84,17,67
2025-08-20,14,Primaria 1°,TopKids,172,10,162
2025-08-20,14,Primaria 1°,EduMax,263,4,259
2025-08-20,14,Primaria 1°,SuperSchool,78,14,64
2025-08-20,14,Primaria 1°,TopKids,223,13,210
2025-08-20,14,Primaria 1°,TopKids,238,4,234
2025-08-20,14,Primaria 1°,EduMax,211,11,200
2025-08-20,14,Primaria 2°,SuperSchool,58,20,38
2025-08-20,14,Primaria 2°,SuperSchool,176,17,159
2025-08-20,14,Primaria 2°,EduMax,116,5,111
2025-08-20,14,Primaria 2°,SuperSchool,229,14,215
2025-08-20,14,Primaria 2°,EduMax,196,9,187
2025-08-20,14,Primaria 2°,SuperSchool,103,7,96
2025-08-20,14,Primaria 2°,EduMax,117,10,107
2025-08-20,14,Primaria 2°,TopKids,137,9,128
2025-08-20,14,Primaria 2°,SuperSchool,210,15,195
2025-08-20,14,Primaria 2°,TopKids,64,11,53
2025-08-20,14,Primaria 3°,EduMax,106,7,99
2025-08-20,14,Primaria 3°,SuperSchool,56,5,51
2025-08-20,14,Primaria 3°,EduMax,174,23,151
2025-08-20,14,Primaria 3°,SuperSchool,121,22,99
2025-08-20,14,Primaria 3°,EduMax,217,14,203
2025-08-20,14,Primaria 3°,TopKids,248,20,228
2025-08-20,14,Primaria 3°,TopKids,220,2,218
2025-08-20,14,Primaria 3°,SuperSchool,183,23,160
2025-08-20,14,Primaria 3°,EduMax,114,3,111
2025-08-20,14,Primaria 3°,EduMax,251,5,246
2025-08-20,14,Primaria 3°,TopKids,285,23,262
2025-08-20,14,Primaria 3°,SuperSchool,186,21,165
2025-08-20,14,Primaria 3°,SuperSchool,141,19,122
2025-08-20,14,Primaria 3°,TopKids,203,16,187
2025-08-20,14,Primaria 3°,EduMax,267,19,248
2025-08-20,14,Primaria 3°,TopKids,232,4,228
2025-08-20,14,Primaria 4°,SuperSchool,242,17,225
2025-08-20,14,Primaria 4°,SuperSchool,254,19,235
2025-08-20,14,Primaria 4°,EduMax,222,9,213
2025-08-20,14,Primaria 4°,SuperSchool,136,1,135
2025-08-20,14,Primaria 4°,EduMax,112,11,101
2025-08-20,14,Primaria 4°,TopKids,154,5,149
2025-08-20,14,Primaria 4°,SuperSchool,266,8,258
2025-08-20,14,Primaria 4°,EduMax,280,17,263
2025-08-20,14,Primaria 4°,EduMax,172,11,161
2025-08-20,14,Primaria 4°,TopKids,74,3,71
2025-08-20,14,Primaria 4°,SuperSchool,163,20,143
2025-08-20,14,Primaria 4°,TopKids,145,2,143
2025-08-20,14,Primaria 4°,SuperSchool,293,5,288
2025-08-20,14,Primaria 4°,SuperSchool,141,8,133
2025-08-20,14,Primaria 5°,TopKids,131,16,115
2025-08-20,14,Primaria 5°,SuperSchool,57,21,36
2025-08-20,14,Primaria 5°,EduMax,265,5,260
2025-08-20,14,Primaria 5°,EduMax,160,14,146
2025-08-20,14,Primaria 5°,EduMax,206,3,203
2025-08-20,14,Primaria 5°,TopKids,149,11,138
2025-08-20,14,Primaria 5°,TopKids,299,12,287
2025-08-20,14,Primaria 5°,TopKids,87,24,63
2025-08-20,14,Primaria 5°,SuperSchool,195,14,181
2025-08-20,14,Primaria 5°,SuperSchool,105,7,98
2025-08-20,14,Primaria 5°,EduMax,154,2,152
2025-08-20,14,Primaria 5°,EduMax,208,1,207
2025-08-20,14,Primaria 5°,EduMax,80,2,78
2025-08-20,14,Primaria 5°,TopKids,266,16,250
2025-08-20,14,Primaria 5°,EduMax,277,21,256
2025-08-20,14,Primaria 6°,SuperSchool,174,4,170
2025-08-20,14,Primaria 6°,SuperSchool,171,3,168
2025-08-20,14,Primaria 6°,SuperSchool,263,15,248
2025-08-20,14,Primaria 6°,TopKids,221,15,206
2025-08-20,14,Primaria 6°,SuperSchool,293,8,285
2025-08-20,14,Primaria 6°,SuperSchool,126,15,111
2025-08-20,14,Primaria 6°,TopKids,98,21,77
2025-08-20,14,Primaria 6°,TopKids,80,12,68
2025-08-20,14,Primaria 6°,EduMax,67,16,51
2025-08-20,14,Primaria 6°,TopKids,239,9,230
2025-08-20,14,Primaria 6°,EduMax,88,19,69
2025-08-20,14,Primaria 6°,SuperSchool,164,10,154
2025-08-20,14,Primaria 6°,EduMax,180,19,161
2025-08-20,14,Primaria 6°,TopKids,188,8,180
2025-08-20,14,Primaria 6°,EduMax,158,23,135
2025-08-20,15,Preescolar,EduMax,67,12,55
2025-08-20,15,Preescolar,TopKids,203,11,192
2025-08-20,15,Preescolar,EduMax,180,7,173
2025-08-20,15,Preescolar,SuperSchool,181,8,173
2025-08-20,15,Preescolar,EduMax,62,12,50
2025-08-20,15,Preescolar,TopKids,279,22,257
2025-08-20,15,Preescolar,TopKids,92,4,88
2025-08-20,15,Preescolar,TopKids,115,15,100
2025-08-20,15,Preescolar,SuperSchool,211,7,204
2025-08-20,15,Preescolar,EduMax,161,5,156
2025-08-20,15,Preescolar,SuperSchool,100,2,98
2025-08-20,15,Kínder,EduMax,204,23,181
2025-08-20,15,Kínder,EduMax,295,24,271
2025-08-20,15,Kínder,SuperSchool,118,18,100
2025-08-20,15,Kínder,SuperSchool,53,1,52
2025-08-20,15,Kínder,EduMax,133,6,127
2025-08-20,15,Kínder,EduMax,76,10,66
2025-08-20,15,Kínder,EduMax,154,12,142
2025-08-20,15,Kínder,EduMax,137,24,113
2025-08-20,15,Kínder,SuperSchool,228,6,222
2025-08-20,15,Kínder,EduMax,266,8,258
2025-08-20,15,Kínder,TopKids,127,11,116
2025-08-20,15,Kínder,TopKids,137,16,121
2025-08-20,15,Kínder,EduMax,160,15,145
2025-08-20,15,Kínder,EduMax,294,12,282
2025-08-20,15,Kínder,EduMax,121,19,102
2025-08-20,15,Kínder,EduMax,246,24,222
2025-08-20,15,Kínder,TopKids,112,9,103
2025-08-20,15,Kínder,SuperSchool,81,9,72
2025-08-20,15,Kínder,EduMax,214,2,212
2025-08-20,15,Primaria 1°,TopKids,252,23,229
2025-08-20,15,Primaria 1°,TopKids,221,13,208
2025-08-20,15,Primaria 1°,SuperSchool,80,1,79
2025-08-20,15,Primaria 1°,SuperSchool,188,4,184
2025-08-20,15,Primaria 1°,TopKids,236,3,233
2025-08-20,15,Primaria 1°,TopKids,206,21,185
2025-08-20,15,Primaria 1°,EduMax,55,22,33
2025-08-20,15,Primaria 1°,SuperSchool,54,2,52
2025-08-20,15,Primaria 1°,EduMax,61,5,56
2025-08-20,15,Primaria 1°,EduMax,237,9,228
2025-08-20,15,Primaria 1°,SuperSchool,105,6,99
2025-08-20,15,Primaria 2°,EduMax,188,3,185
2025-08-20,15,Primaria 2°,TopKids,77,15,62
2025-08-20,15,Primaria 2°,TopKids,169,5,164
2025-08-20,15,Primaria 2°,EduMax,65,21,44
2025-08-20,15,Primaria 2°,TopKids,77,7,70
2025-08-20,15,Primaria 2°,EduMax,186,7,179
2025-08-20,15,Primaria 2°,TopKids,220,12,208
2025-08-20,15,Primaria 2°,SuperSchool,138,11,127
2025-08-20,15,Primaria 2°,SuperSchool,272,2,270
2025-08-20,15,Primaria 2°,SuperSchool,140,24,116
2025-08-20,15,Primaria 2°,EduMax,191,13,178
2025-08-20,15,Primaria 2°,SuperSchool,83,23,60
2025-08-20,15,Primaria 3°,TopKids,79,17,62
2025-08-20,15,Primaria 3°,TopKids,193,20,173
2025-08-20,15,Primaria 3°,EduMax,165,8,157
2025-08-20,15,Primaria 3°,EduMax,226,11,215
2025-08-20,15,Primaria 3°,EduMax,289,15,274
2025-08-20,15,Primaria 3°,TopKids,84,7,77
2025-08-20,15,Primaria 3°,SuperSchool,157,22,135
2025-08-20,15,Primaria 3°,EduMax,72,24,48
2025-08-20,15,Primaria 3°,TopKids,292,10,282
2025-08-20,15,Primaria 3°,SuperSchool,185,16,169
2025-08-20,15,Primaria 3°,SuperSchool,175,23,152
2025-08-20,15,Primaria 4°,SuperSchool,273,20,253
2025-08-20,15,Primaria 4°,EduMax,298,6,292
2025-08-20,15,Primaria 4°,SuperSchool,125,22,103
2025-08-20,15,Primaria 4°,EduMax,255,2,253
2025-08-20,15,Primaria 4°,TopKids,119,18,101
2025-08-20,15,Primaria 4°,EduMax,214,6,208
2025-08-20,15,Primaria 4°,TopKids,151,8,143
2025-08-20,15,Primaria 4°,SuperSchool,102,22,80
2025-08-20,15,Primaria 4°,EduMax,167,2,165
2025-08-20,15,Primaria 4°,SuperSchool,207,16,191
2025-08-20,15,Primaria 4°,SuperSchool,50,7,43
2025-08-20,15,Primaria 4°,SuperSchool,161,16,145
2025-08-20,15,Primaria 4°,EduMax,131,22,109
2025-08-20,15,Primaria 4°,EduMax,148,8,140
2025-08-20,15,Primaria 5°,SuperSchool,296,4,292
2025-08-20,15,Primaria 5°,SuperSchool,167,5,162
2025-08-20,15,Primaria 5°,SuperSchool,144,14,130
2025-08-20,15,Primaria 5°,EduMax,224,12,212
2025-08-20,15,Primaria 5°,TopKids,222,24,198
2025-08-20,15,Primaria 5°,TopKids,104,18,86
2025-08-20,15,Primaria 5°,EduMax,105,19,86
2025-08-20,15,Primaria 5°,EduMax,75,7,68
2025-08-20,15,Primaria 5°,EduMax,246,4,242
2025-08-20,15,Primaria 5°,EduMax,234,14,220
2025-08-20,15,Primaria 5°,TopKids,168,20,148
2025-08-20,15,Primaria 5°,EduMax,273,5,268
2025-08-20,15,Primaria 5°,EduMax,77,11,66
2025-08-20,15,Primaria 5°,EduMax,149,13,136
2025-08-20,15,Primaria 5°,SuperSchool,85,23,62
2025-08-20,15,Primaria 6°,TopKids,56,23,33
2025-08-20,15,Primaria 6°,EduMax,166,18,148
2025-08-20,15,Primaria 6°,SuperSchool,119,16,103
2025-08-20,15,Primaria 6°,TopKids,295,15,280
2025-08-20,15,Primaria 6°,SuperSchool,133,10,123
2025-08-20,15,Primaria 6°,SuperSchool,252,14,238
2025-08-20,15,Primaria 6°,TopKids,156,17,139
2025-08-20,15,Primaria 6°,SuperSchool,113,9,104
2025-08-20,15,Primaria 6°,EduMax,168,13,155
2025-08-20,15,Primaria 6°,TopKids,86,23,63
2025-08-20,15,Primaria 6°,SuperSchool,205,1,204
2025-08-20,15,Primaria 6°,SuperSchool,122,23,99
2025-08-20,15,Primaria 6°,SuperSchool,238,13,225
2025-08-20,15,Primaria 6°,TopKids,241,21,220
2025-08-20,15,Primaria 6°,TopKids,57,8,49
2025-08-20,15,Primaria 6°,EduMax,136,10,126
2025-08-20,15,Primaria 6°,SuperSchool,289,19,270
2025-08-20,16,Preescolar,SuperSchool,245,7,238
2025-08-20,16,Preescolar,SuperSchool,243,16,227
2025-08-20,16,Preescolar,EduMax,145,5,140
2025-08-20,16,Preescolar,SuperSchool,159,17,142
2025-08-20,16,Preescolar,EduMax,212,21,191
2025-08-20,16,Kínder,EduMax,243,21,222
2025-08-20,16,Kínder,SuperSchool,70,15,55
2025-08-20,16,Kínder,TopKids,251,18,233
2025-08-20,16,Kínder,TopKids,177,22,155
2025-08-20,16,Kínder,TopKids,297,21,276
2025-08-20,16,Kínder,EduMax,216,7,209
2025-08-20,16,Kínder,TopKids,81,23,58
2025-08-20,16,Kínder,EduMax,206,24,182
2025-08-20,16,Kínder,TopKids,243,2,241
2025-08-20,16,Primaria 1°,EduMax,224,11,213
2025-08-20,16,Primaria 1°,SuperSchool,176,10,166
2025-08-20,16,Primaria 1°,TopKids,98,9,89
2025-08-20,16,Primaria 1°,EduMax,64,14,50
2025-08-20,16,Primaria 1°,TopKids,66,22,44
2025-08-20,16,Primaria 1°,EduMax,130,16,114
2025-08-20,16,Primaria 1°,TopKids,216,12,204
2025-08-20,16,Primaria 1°,SuperSchool,235,12,223
2025-08-20,16,Primaria 1°,SuperSchool,215,16,199
2025-08-20,16,Primaria 1°,EduMax,132,23,109
2025-08-20,16,Primaria 1°,TopKids,174,3,171
2025-08-20,16,Primaria 2°,TopKids,100,5,95
2025-08-20,16,Primaria 2°,EduMax,262,16,246
2025-08-20,16,Primaria 2°,SuperSchool,82,17,65
2025-08-20,16,Primaria 2°,TopKids,79,9,70
2025-08-20,16,Primaria 2°,SuperSchool,53,2,51
2025-08-20,16,Primaria 2°,SuperSchool,295,5,290
2025-08-20,16,Primaria 2°,TopKids,118,24,94
2025-08-20,16,Primaria 2°,SuperSchool,291,13,278
2025-08-20,16,Primaria 2°,TopKids,214,24,190
2025-08-20,16,Primaria 3°,TopKids,212,22,190
2025-08-20,16,Primaria 3°,EduMax,55,6,49
2025-08-20,16,Primaria 3°,SuperSchool,79,1,78
2025-08-20,16,Primaria 3°,TopKids,185,1,184
2025-08-20,16,Primaria 3°,SuperSchool,87,20,67
2025-08-20,16,Primaria 3°,EduMax,188,2,186
2025-08-20,16,Primaria 3°,SuperSchool,143,4,139
2025-08-20,16,Primaria 4°,TopKids,279,3,276
2025-08-20,16,Primaria 4°,SuperSchool,255,20,235
2025-08-20,16,Primaria 4°,TopKids,188,5,183
2025-08-20,16,Primaria 4°,EduMax,196,8,188
2025-08-20,16,Primaria 4°,TopKids,184,7,177
2025-08-20,16,Primaria 4°,TopKids,52,3,49
2025-08-20,16,Primaria 4°,EduMax,94,1,93
2025-08-20,16,Primaria 4°,SuperSchool,141,4,137
2025-08-20,16,Primaria 4°,TopKids,206,18,188
2025-08-20,16,Primaria 4°,SuperSchool,287,14,273
2025-08-20,16,Primaria 4°,TopKids,206,6,200
2025-08-20,16,Primaria 4°,SuperSchool,227,15,212
2025-08-20,16,Primaria 4°,SuperSchool,104,7,97
2025-08-20,16,Primaria 4°,TopKids,132,17,115
2025-08-20,16,Primaria 4°,SuperSchool,188,5,183
2025-08-20,16,Primaria 4°,EduMax,160,24,136
2025-08-20,16,Primaria 4°,EduMax,155,20,135
2025-08-20,16,Primaria 5°,EduMax,77,7,70
2025-08-20,16,Primaria 5°,EduMax,126,5,121
2025-08-20,16,Primaria 5°,SuperSchool,100,10,90
2025-08-20,16,Primaria 5°,EduMax,178,5,173
2025-08-20,16,Primaria 5°,TopKids,293,11,282
2025-08-20,16,Primaria 5°,EduMax,192,7,185
2025-08-20,16,Primaria 5°,TopKids,270,16,254
2025-08-20,16,Primaria 5°,EduMax,60,17,43
2025-08-20,16,Primaria 5°,TopKids,65,24,41
2025-08-20,16,Primaria 5°,EduMax,213,19,194
2025-08-20,16,Primaria 5°,EduMax,291,21,270
2025-08-20,16,Primaria 5°,TopKids,282,3,279
2025-08-20,16,Primaria 5°,EduMax,67,15,52
2025-08-20,16,Primaria 5°,SuperSchool,231,18,213
2025-08-20,16,Primaria 5°,TopKids,256,17,239
2025-08-20,16,Primaria 6°,TopKids,163,11,152
2025-08-20,16,Primaria 6°,EduMax,296,3,293
2025-08-20,16,Primaria 6°,SuperSchool,112,14,98
2025-08-20,16,Primaria 6°,TopKids,213,18,195
2025-08-20,16,Primaria 6°,SuperSchool,63,12,51
2025-08-20,16,Primaria 6°,SuperSchool,88,12,76
2025-08-21,9,Preescolar,SuperSchool,111,21,90
2025-08-21,9,Preescolar,SuperSchool,205,3,202
2025-08-21,9,Preescolar,EduMax,114,3,111
2025-08-21,9,Preescolar,TopKids,99,7,92
2025-08-21,9,Preescolar,SuperSchool,85,23,62
2025-08-21,9,Preescolar,EduMax,99,23,76
2025-08-21,9,Preescolar,SuperSchool,61,19,42
2025-08-21,9,Preescolar,EduMax,244,8,236
2025-08-21,9,Preescolar,TopKids,238,19,219
2025-08-21,9,Preescolar,SuperSchool,100,17,83
2025-08-21,9,Preescolar,SuperSchool,179,4,175
2025-08-21,9,Preescolar,SuperSchool,177,11,166
2025-08-21,9,Kínder,SuperSchool,138,11,127
2025-08-21,9,Kínder,TopKids,51,19,32
2025-08-21,9,Kínder,SuperSchool,217,23,194
2025-08-21,9,Kínder,SuperSchool,129,15,114
2025-08-21,9,Kínder,SuperSchool,175,5,170
2025-08-21,9,Kínder,TopKids,264,17,247
2025-08-21,9,Primaria 1°,EduMax,284,6,278
2025-08-21,9,Primaria 1°,TopKids,93,22,71
2025-08-21,9,Primaria 1°,EduMax,130,14,116
2025-08-21,9,Primaria 1°,EduMax,219,16,203
2025-08-21,9,Primaria 1°,EduMax,204,20,184
2025-08-21,9,Primaria 1°,EduMax,164,3,161
2025-08-21,9,Primaria 1°,TopKids,289,4,285
2025-08-21,9,Primaria 2°,SuperSchool,117,4,113
2025-08-21,9,Primaria 2°,TopKids,198,12,186
2025-08-21,9,Primaria 2°,EduMax,193,7,186
2025-08-21,9,Primaria 2°,TopKids,284,1,283
2025-08-21,9,Primaria 2°,SuperSchool,278,17,261
2025-08-21,9,Primaria 2°,TopKids,274,17,257
2025-08-21,9,Primaria 2°,SuperSchool,222,24,198
2025-08-21,9,Primaria 2°,TopKids,190,13,177
2025-08-21,9,Primaria 2°,EduMax,75,22,53
2025-08-21,9,Primaria 2°,EduMax,197,21,176
2025-08-21,9,Primaria 2°,EduMax,132,3,129
2025-08-21,9,Primaria 2°,EduMax,120,5,115
2025-08-21,9,Primaria 2°,SuperSchool,221,4,217
2025-08-21,9,Primaria 3°,TopKids,141,18,123
2025-08-21,9,Primaria 3°,TopKids,280,8,272
2025-08-21,9,Primaria 3°,TopKids,166,17,149
2025-08-21,9,Primaria 3°,TopKids,85,16,69
2025-08-21,9,Primaria 3°,EduMax,94,12,82
2025-08-21,9,Primaria 3°,SuperSchool,107,9,98
2025-08-21,9,Primaria 3°,EduMax,144,15,129
2025-08-21,9,Primaria 3°,EduMax,177,9,168
2025-08-21,9,Primaria 3°,EduMax,85,4,81
2025-08-21,9,Primaria 3°,TopKids,279,24,255
2025-08-21,9,Primaria 3°,SuperSchool,173,24,149
2025-08-21,9,Primaria 3°,SuperSchool,190,20,170
2025-08-21,9,Primaria 3°,SuperSchool,100,23,77
2025-08-21,9,Primaria 3°,SuperSchool,198,17,181
2025-08-21,9,Primaria 3°,EduMax,202,3,199
2025-08-21,9,Primaria 3°,TopKids,268,14,254
2025-08-21,9,Primaria 3°,TopKids,279,20,259
2025-08-21,9,Primaria 3°,EduMax,51,4,47
2025-08-21,9,Primaria 4°,SuperSchool,104,22,82
2025-08-21,9,Primaria 4°,SuperSchool,268,23,245
2025-08-21,9,Primaria 4°,SuperSchool,247,11,236
2025-08-21,9,Primaria 4°,TopKids,257,8,249
2025-08-21,9,Primaria 4°,SuperSchool,146,10,136
2025-08-21,9,Primaria 4°,EduMax,68,14,54
2025-08-21,9,Primaria 4°,TopKids,232,24,208
2025-08-21,9,Primaria 4°,TopKids,154,23,131
2025-08-21,9,Primaria 4°,TopKids,224,6,218
2025-08-21,9,Primaria 4°,EduMax,242,3,239
2025-08-21,9,Primaria 4°,SuperSchool,113,23,90
2025-08-21,9,Primaria 4°,EduMax,255,17,238
2025-08-21,9,Primaria 4°,EduMax,208,19,189
2025-08-21,9,Primaria 4°,EduMax,231,9,222
2025-08-21,9,Primaria 4°,EduMax,218,8,210
2025-08-21,9,Primaria 4°,TopKids,199,24,175
2025-08-21,9,Primaria 4°,EduMax,179,9,170
2025-08-21,9,Primaria 5°,TopKids,154,2,152
2025-08-21,9,Primaria 5°,EduMax,260,16,244
2025-08-21,9,Primaria 5°,EduMax,199,14,185
2025-08-21,9,Primaria 5°,SuperSchool,222,22,200
2025-08-21,9,Primaria 5°,EduMax,135,14,121
2025-08-21,9,Primaria 5°,SuperSchool,256,18,238
2025-08-21,9,Primaria 5°,SuperSchool,71,8,63
2025-08-21,9,Primaria 5°,TopKids,154,9,145
2025-08-21,9,Primaria 5°,TopKids,117,7,110
2025-08-21,9,Primaria 5°,SuperSchool,248,4,244
2025-08-21,9,Primaria 5°,EduMax,140,17,123
2025-08-21,9,Primaria 5°,TopKids,203,3,200
2025-08-21,9,Primaria 5°,SuperSchool,246,20,226
2025-08-21,9,Primaria 6°,TopKids,70,16,54
2025-08-21,9,Primaria 6°,TopKids,65,18,47
2025-08-21,9,Primaria 6°,TopKids,105,18,87
2025-08-21,9,Primaria 6°,EduMax,233,16,217
2025-08-21,9,Primaria 6°,SuperSchool,281,16,265
2025-08-21,9,Primaria 6°,SuperSchool,242,11,231
2025-08-21,9,Primaria 6°,EduMax,252,2,250
2025-08-21,9,Primaria 6°,EduMax,81,22,59
2025-08-21,9,Primaria 6°,TopKids,105,5,100
2025-08-21,9,Primaria 6°,TopKids,205,23,182
2025-08-21,9,Primaria 6°,EduMax,121,4,117
2025-08-21,9,Primaria 6°,SuperSchool,254,22,232
2025-08-21,10,Preescolar,SuperSchool,150,21,129
2025-08-21,10,Preescolar,TopKids,72,6,66
2025-08-21,10,Preescolar,TopKids,128,8,120
2025-08-21,10,Preescolar,EduMax,63,16,47
2025-08-21,10,Preescolar,SuperSchool,136,10,126
2025-08-21,10,Preescolar,TopKids,296,4,292
2025-08-21,10,Preescolar,EduMax,275,4,271
2025-08-21,10,Preescolar,EduMax,191,23,168
2025-08-21,10,Preescolar,TopKids,224,1,223
2025-08-21,10,Preescolar,TopKids,106,1,105
2025-08-21,10,Preescolar,SuperSchool,185,18,167
2025-08-21,10,Preescolar,EduMax,212,23,189
2025-08-21,10,Preescolar,EduMax,293,9,284
2025-08-21,10,Preescolar,EduMax,261,2,259
2025-08-21,10,Preescolar,EduMax,175,4,171
2025-08-21,10,Preescolar,SuperSchool,79,18,61
2025-08-21,10,Preescolar,TopKids,76,11,65
2025-08-21,10,Preescolar,SuperSchool,185,11,174
2025-08-21,10,Kínder,EduMax,143,20,123
2025-08-21,10,Kínder,SuperSchool,293,15,278
2025-08-21,10,Kínder,TopKids,88,24,64
2025-08-21,10,Kínder,TopKids,219,20,199
2025-08-21,10,Kínder,SuperSchool,96,20,76
2025-08-21,10,Kínder,EduMax,182,15,167
2025-08-21,10,Kínder,SuperSchool,112,15,97
2025-08-21,10,Kínder,TopKids,226,23,203
2025-08-21,10,Kínder,SuperSchool,78,19,59
2025-08-21,10,Kínder,TopKids,122,10,112
2025-08-21,10,Kínder,SuperSchool,187,22,165
2025-08-21,10,Kínder,SuperSchool,266,22,244
2025-08-21,10,Kínder,SuperSchool,246,23,223
2025-08-21,10,Kínder,TopKids,232,5,227
2025-08-21,10,Kínder,SuperSchool,178,22,156
2025-08-21,10,Kínder,EduMax,189,3,186
2025-08-21,10,Kínder,EduMax,289,18,271
2025-08-21,10,Kínder,EduMax,296,15,281
2025-08-21,10,Primaria 1°,SuperSchool,260,2,258
2025-08-21,10,Primaria 1°,SuperSchool,202,16,186
2025-08-21,10,Primaria 1°,TopKids,262,19,243
2025-08-21,10,Primaria 1°,EduMax,188,12,176
2025-08-21,10,Primaria 1°,TopKids,188,22,166
2025-08-21,10,Primaria 1°,SuperSchool,268,18,250
2025-08-21,10,Primaria 1°,EduMax,283,16,267
2025-08-21,10,Primaria 1°,EduMax,271,19,252
2025-08-21,10,Primaria 1°,SuperSchool,288,13,275
2025-08-21,10,Primaria 1°,SuperSchool,262,2,260
2025-08-21,10,Primaria 1°,SuperSchool,243,11,232
2025-08-21,10,Primaria 1°,SuperSchool,80,10,70
2025-08-21,10,Primaria 1°,TopKids,263,15,248
2025-08-21,10,Primaria 1°,SuperSchool,274,14,260
2025-08-21,10,Primaria 2°,EduMax,60,7,53
2025-08-21,10,Primaria 2°,TopKids,52,2,50
2025-08-21,10,Primaria 2°,EduMax,121,8,113
2025-08-21,10,Primaria 2°,TopKids,225,2,223
2025-08-21,10,Primaria 2°,EduMax,173,5,168
2025-08-21,10,Primaria 2°,TopKids,69,13,56
2025-08-21,10,Primaria 2°,EduMax,81,3,78
2025-08-21,10,Primaria 2°,SuperSchool,91,24,67
2025-08-21,10,Primaria 2°,SuperSchool,298,21,277
2025-08-21,10,Primaria 2°,SuperSchool,150,23,127
2025-08-21,10,Primaria 2°,TopKids,194,15,179
2025-08-21,10,Primaria 2°,EduMax,246,24,222
2025-08-21,10,Primaria 2°,TopKids,172,2,170
2025-08-21,10,Primaria 2°,EduMax,297,18,279
2025-08-21,10,Primaria 3°,SuperSchool,172,14,158
2025-08-21,10,Primaria 3°,TopKids,196,16,180
2025-08-21,10,Primaria 3°,TopKids,279,12,267
2025-08-21,10,Primaria 3°,TopKids,248,24,224
2025-08-21,10,Primaria 3°,TopKids,202,17,185
2025-08-21,10,Primaria 3°,TopKids,132,19,113
2025-08-21,10,Primaria 3°,TopKids,60,21,39
2025-08-21,10,Primaria 3°,EduMax,152,19,133
2025-08-21,10,Primaria 3°,TopKids,155,12,143
2025-08-21,10,Primaria 3°,TopKids,268,18,250
2025-08-21,10,Primaria 3°,TopKids,151,20,131
2025-08-21,10,Primaria 3°,TopKids,166,8,158
2025-08-21,10,Primaria 3°,SuperSchool,244,2,242
2025-08-21,10,Primaria 3°,EduMax,119,7,112
2025-08-21,10,Primaria 4°,SuperSchool,71,22,49
2025-08-21,10,Primaria 4°,TopKids,122,12,110
2025-08-21,10,Primaria 4°,SuperSchool,272,17,255
2025-08-21,10,Primaria 4°,TopKids,123,19,104
2025-08-21,10,Primaria 4°,EduMax,267,11,256
2025-08-21,10,Primaria 4°,EduMax,105,13,92
2025-08-21,10,Primaria 4°,TopKids,253,24,229
2025-08-21,10,Primaria 4°,EduMax,59,22,37
2025-08-21,10,Primaria 4°,TopKids,73,2,71
2025-08-21,10,Primaria 4°,SuperSchool,238,7,231
2025-08-21,10,Primaria 4°,SuperSchool,292,6,286
2025-08-21,10,Primaria 4°,SuperSchool,185,22,163
2025-08-21,10,Primaria 5°,SuperSchool,165,24,141
2025-08-21,10,Primaria 5°,SuperSchool,86,6,80
2025-08-21,10,Primaria 5°,TopKids,125,5,120
2025-08-21,10,Primaria 5°,SuperSchool,80,18,62
2025-08-21,10,Primaria 5°,EduMax,55,9,46
2025-08-21,10,Primaria 5°,TopKids,144,23,121
2025-08-21,10,Primaria 5°,EduMax,169,2,167
2025-08-21,10,Primaria 5°,TopKids,78,14,64
2025-08-21,10,Primaria 5°,SuperSchool,228,10,218
2025-08-21,10,Primaria 5°,SuperSchool,200,4,196
2025-08-21,10,Primaria 5°,TopKids,177,24,153
2025-08-21,10,Primaria 5°,TopKids,126,10,116
2025-08-21,10,Primaria 5°,EduMax,123,4,119
2025-08-21,10,Primaria 5°,TopKids,102,11,91
2025-08-21,10,Primaria 5°,TopKids,262,24,238
2025-08-21,10,Primaria 5°,TopKids,256,16,240
2025-08-21,10,Primaria 5°,EduMax,142,5,137
2025-08-21,10,Primaria 5°,EduMax,226,18,208
2025-08-21,10,Primaria 5°,TopKids,178,9,169
2025-08-21,10,Primaria 6°,EduMax,165,21,144
2025-08-21,10,Primaria 6°,SuperSchool,136,11,125
2025-08-21,10,Primaria 6°,EduMax,133,24,109
2025-08-21,10,Primaria 6°,TopKids,138,5,133
2025-08-21,10,Primaria 6°,EduMax,176,24,152
2025-08-21,10,Primaria 6°,TopKids,61,14,47
2025-08-21,10,Primaria 6°,TopKids,284,21,263
2025-08-21,10,Primaria 6°,EduMax,282,20,262
2025-08-21,10,Primaria 6°,EduMax,84,21,63
2025-08-21,11,Preescolar,TopKids,299,7,292
2025-08-21,11,Preescolar,SuperSchool,61,20,41
2025-08-21,11,Preescolar,EduMax,195,15,180
2025-08-21,11,Preescolar,TopKids,141,3,138
2025-08-21,11,Preescolar,TopKids,64,16,48
2025-08-21,11,Preescolar,EduMax,167,17,150
2025-08-21,11,Preescolar,TopKids,240,1,239
2025-08-21,11,Preescolar,TopKids,55,23,32
2025-08-21,11,Preescolar,SuperSchool,229,16,213
2025-08-21,11,Preescolar,EduMax,107,6,101
2025-08-21,11,Preescolar,TopKids,158,13,145
2025-08-21,11,Preescolar,TopKids,209,4,205
2025-08-21,11,Preescolar,SuperSchool,287,14,273
2025-08-21,11,Preescolar,SuperSchool,214,23,191
2025-08-21,11,Preescolar,TopKids,240,2,238
2025-08-21,11,Preescolar,SuperSchool,145,11,134
2025-08-21,11,Preescolar,EduMax,50,21,29
2025-08-21,11,Preescolar,SuperSchool,180,12,168
2025-08-21,11,Preescolar,TopKids,82,9,73
2025-08-21,11,Kínder,EduMax,105,20,85
2025-08-21,11,Kínder,EduMax,154,23,131
2025-08-21,11,Kínder,TopKids,249,23,226
2025-08-21,11,Kínder,EduMax,138,15,123
2025-08-21,11,Kínder,SuperSchool,159,18,141
2025-08-21,11,Kínder,TopKids,164,10,154
2025-08-21,11,Kínder,SuperSchool,55,17,38
2025-08-21,11,Kínder,EduMax,286,8,278
2025-08-21,11,Kínder,EduMax,283,9,274
2025-08-21,11,Kínder,SuperSchool,232,4,228
2025-08-21,11,Kínder,EduMax,247,13,234
2025-08-21,11,Kínder,EduMax,89,5,84
2025-08-21,11,Kínder,EduMax,186,11,175
2025-08-21,11,Kínder,TopKids,280,14,266
2025-08-21,11,Kínder,EduMax,87,4,83
2025-08-21,11,Kínder,EduMax,276,23,253
2025-08-21,11,Kínder,EduMax,180,1,179
2025-08-21,11,Kínder,EduMax,166,18,148
2025-08-21,11,Primaria 1°,SuperSchool,200,4,196
2025-08-21,11,Primaria 1°,EduMax,258,18,240
2025-08-21,11,Primaria 1°,TopKids,183,2,181
2025-08-21,11,Primaria 1°,TopKids,149,16,133
2025-08-21,11,Primaria 1°,EduMax,74,10,64
2025-08-21,11,Primaria 1°,TopKids,287,7,280
2025-08-21,11,Primaria 1°,TopKids,162,11,151
2025-08-21,11,Primaria 1°,SuperSchool,52,19,33
2025-08-21,11,Primaria 1°,EduMax,53,8,45
2025-08-21,11,Primaria 1°,EduMax,261,24,237
2025-08-21,11,Primaria 1°,EduMax,269,16,253
2025-08-21,11,Primaria 2°,TopKids,118,12,106
2025-08-21,11,Primaria 2°,SuperSchool,54,10,44
2025-08-21,11,Primaria 2°,EduMax,66,15,51
2025-08-21,11,Primaria 2°,EduMax,59,20,39
2025-08-21,11,Primaria 2°,SuperSchool,65,9,56
2025-08-21,11,Primaria 2°,EduMax,52,23,29
2025-08-21,11,Primaria 2°,EduMax,170,14,156
2025-08-21,11,Primaria 2°,SuperSchool,277,4,273
2025-08-21,11,Primaria 2°,EduMax,73,19,54
2025-08-21,11,Primaria 2°,TopKids,89,14,75
2025-08-21,11,Primaria 2°,EduMax,287,23,264
2025-08-21,11,Primaria 2°,TopKids,294,18,276
2025-08-21,11,Primaria 2°,EduMax,288,18,270
2025-08-21,11,Primaria 2°,SuperSchool,157,10,147
2025-08-21,11,Primaria 2°,TopKids,183,24,159
2025-08-21,11,Primaria 2°,TopKids,82,13,69
2025-08-21,11,Primaria 2°,EduMax,129,18,111
2025-08-21,11,Primaria 2°,TopKids,234,5,229
2025-08-21,11,Primaria 2°,SuperSchool,62,8,54
2025-08-21,11,Primaria 3°,TopKids,298,20,278
2025-08-21,11,Primaria 3°,EduMax,53,12,41
2025-08-21,11,Primaria 3°,SuperSchool,115,19,96
2025-08-21,11,Primaria 3°,TopKids,286,19,267
2025-08-21,11,Primaria 3°,EduMax,156,18,138
2025-08-21,11,Primaria 3°,SuperSchool,50,14,36
2025-08-21,11,Primaria 3°,TopKids,195,16,179
2025-08-21,11,Primaria 3°,SuperSchool,73,2,71
2025-08-21,11,Primaria 3°,TopKids,256,2,254
2025-08-21,11,Primaria 3°,TopKids,272,9,263
2025-08-21,11,Primaria 4°,SuperSchool,266,19,247
2025-08-21,11,Primaria 4°,SuperSchool,63,10,53
2025-08-21,11,Primaria 4°,EduMax,298,8,290
2025-08-21,11,Primaria 4°,EduMax,131,21,110
2025-08-21,11,Primaria 4°,SuperSchool,294,20,274
2025-08-21,11,Primaria 4°,TopKids,150,17,133
2025-08-21,11,Primaria 4°,EduMax,239,5,234
2025-08-21,11,Primaria 4°,SuperSchool,245,1,244
2025-08-21,11,Primaria 4°,EduMax,119,1,118
2025-08-21,11,Primaria 4°,EduMax,53,2,51
2025-08-21,11,Primaria 4°,SuperSchool,159,17,142
2025-08-21,11,Primaria 4°,TopKids,84,7,77
2025-08-21,11,Primaria 4°,EduMax,284,10,274
2025-08-21,11,Primaria 4°,SuperSchool,200,2,198
2025-08-21,11,Primaria 5°,TopKids,81,16,65
2025-08-21,11,Primaria 5°,EduMax,173,16,157
2025-08-21,11,Primaria 5°,EduMax,125,21,104
2025-08-21,11,Primaria 5°,EduMax,221,2,219
2025-08-21,11,Primaria 5°,TopKids,297,14,283
2025-08-21,11,Primaria 5°,TopKids,122,22,100
2025-08-21,11,Primaria 5°,TopKids,270,12,258
2025-08-21,11,Primaria 5°,SuperSchool,130,9,121
2025-08-21,11,Primaria 5°,EduMax,221,20,201
2025-08-21,11,Primaria 5°,EduMax,122,12,110
2025-08-21,11,Primaria 5°,SuperSchool,81,2,79
2025-08-21,11,Primaria 5°,TopKids,82,16,66
2025-08-21,11,Primaria 5°,EduMax,163,23,140
2025-08-21,11,Primaria 5°,EduMax,286,22,264
2025-08-21,11,Primaria 5°,SuperSchool,86,9,77
2025-08-21,11,Primaria 5°,EduMax,62,16,46
2025-08-21,11,Primaria 6°,EduMax,175,16,159
2025-08-21,11,Primaria 6°,EduMax,177,2,175
2025-08-21,11,Primaria 6°,TopKids,109,19,90
2025-08-21,11,Primaria 6°,TopKids,196,11,185
2025-08-21,11,Primaria 6°,EduMax,96,7,89
2025-08-21,11,Primaria 6°,TopKids,143,24,119
2025-08-21,11,Primaria 6°,TopKids,202,8,194
2025-08-21,11,Primaria 6°,EduMax,85,18,67
2025-08-21,11,Primaria 6°,EduMax,78,21,57
2025-08-21,11,Primaria 6°,EduMax,85,2,83
2025-08-21,11,Primaria 6°,SuperSchool,87,11,76
2025-08-21,11,Primaria 6°,SuperSchool,256,12,244
2025-08-21,11,Primaria 6°,EduMax,175,5,170
2025-08-21,11,Primaria 6°,TopKids,169,21,148
2025-08-21,11,Primaria 6°,TopKids,167,1,166
2025-08-21,11,Primaria 6°,SuperSchool,217,23,194
2025-08-21,12,Preescolar,EduMax,220,19,201
2025-08-21,12,Preescolar,TopKids,192,8,184
2025-08-21,12,Preescolar,EduMax,191,1,190
2025-08-21,12,Preescolar,EduMax,56,18,38
2025-08-21,12,Preescolar,EduMax,227,21,206
2025-08-21,12,Preescolar,TopKids,293,12,281
2025-08-21,12,Preescolar,SuperSchool,127,10,117
2025-08-21,12,Preescolar,SuperSchool,72,15,57
2025-08-21,12,Preescolar,EduMax,144,20,124
2025-08-21,12,Preescolar,EduMax,196,19,177
2025-08-21,12,Preescolar,TopKids,236,12,224
2025-08-21,12,Preescolar,SuperSchool,236,20,216
2025-08-21,12,Preescolar,SuperSchool,161,1,160
2025-08-21,12,Preescolar,SuperSchool,116,12,104
2025-08-21,12,Kínder,TopKids,238,9,229
2025-08-21,12,Kínder,EduMax,71,22,49
2025-08-21,12,Kínder,SuperSchool,144,20,124
2025-08-21,12,Kínder,SuperSchool,63,3,60
2025-08-21,12,Kínder,EduMax,58,15,43
2025-08-21,12,Kínder,EduMax,145,24,121
2025-08-21,12,Kínder,TopKids,59,17,42
2025-08-21,12,Kínder,SuperSchool,274,11,263
2025-08-21,12,Kínder,SuperSchool,58,7,51
2025-08-21,12,Kínder,TopKids,211,19,192
2025-08-21,12,Kínder,EduMax,283,5,278
2025-08-21,12,Kínder,SuperSchool,104,5,99
2025-08-21,12,Kínder,TopKids,295,16,279
2025-08-21,12,Kínder,EduMax,169,17,152
2025-08-21,12,Kínder,SuperSchool,70,16,54
2025-08-21,12,Kínder,EduMax,186,2,184
2025-08-21,12,Kínder,TopKids,256,3,253
2025-08-21,12,Primaria 1°,SuperSchool,228,22,206
2025-08-21,12,Primaria 1°,EduMax,127,5,122
2025-08-21,12,Primaria 1°,SuperSchool,55,18,37
2025-08-21,12,Primaria 1°,EduMax,131,19,112
2025-08-21,12,Primaria 1°,EduMax,145,17,128
2025-08-21,12,Primaria 1°,SuperSchool,58,13,45
2025-08-21,12,Primaria 1°,SuperSchool,235,23,212
2025-08-21,12,Primaria 1°,TopKids,291,10,281
2025-08-21,12,Primaria 1°,SuperSchool,173,4,169
2025-08-21,12,Primaria 1°,EduMax,75,13,62
2025-08-21,12,Primaria 1°,SuperSchool,66,8,58
2025-08-21,12,Primaria 1°,TopKids,212,11,201
2025-08-21,12,Primaria 2°,SuperSchool,256,13,243
2025-08-21,12,Primaria 2°,SuperSchool,246,19,227
2025-08-21,12,Primaria 2°,TopKids,250,3,247
2025-08-21,12,Primaria 2°,EduMax,76,13,63
2025-08-21,12,Primaria 2°,SuperSchool,237,12,225
2025-08-21,12,Primaria 2°,SuperSchool,283,13,270
2025-08-21,12,Primaria 2°,SuperSchool,204,22,182
2025-08-21,12,Primaria 2°,SuperSchool,137,10,127
2025-08-21,12,Primaria 2°,TopKids,87,7,80
2025-08-21,12,Primaria 2°,TopKids,103,19,84
2025-08-21,12,Primaria 2°,EduMax,161,14,147
2025-08-21,12,Primaria 2°,SuperSchool,270,20,250
2025-08-21,12,Primaria 2°,EduMax,250,3,247
2025-08-21,12,Primaria 2°,EduMax,86,14,72
2025-08-21,12,Primaria 2°,SuperSchool,160,18,142
2025-08-21,12,Primaria 2°,SuperSchool,58,19,39
2025-08-21,12,Primaria 3°,SuperSchool,154,16,138
2025-08-21,12,Primaria 3°,EduMax,215,8,207
2025-08-21,12,Primaria 3°,SuperSchool,148,22,126
2025-08-21,12,Primaria 3°,SuperSchool,120,23,97
2025-08-21,12,Primaria 3°,SuperSchool,114,22,92
2025-08-21,12,Primaria 3°,SuperSchool,245,16,229
2025-08-21,12,Primaria 3°,TopKids,255,1,254
2025-08-21,12,Primaria 3°,EduMax,252,7,245
2025-08-21,12,Primaria 3°,SuperSchool,75,1,74
2025-08-21,12,Primaria 3°,SuperSchool,76,10,66
2025-08-21,12,Primaria 3°,SuperSchool,120,8,112
2025-08-21,12,Primaria 4°,SuperSchool,181,12,169
2025-08-21,12,Primaria 4°,EduMax,144,11,133
2025-08-21,12,Primaria 4°,SuperSchool,157,21,136
2025-08-21,12,Primaria 4°,SuperSchool,71,1,70
2025-08-21,12,Primaria 4°,EduMax,53,4,49
2025-08-21,12,Primaria 4°,SuperSchool,269,20,249
2025-08-21,12,Primaria 5°,TopKids,154,14,140
2025-08-21,12,Primaria 5°,SuperSchool,215,13,202
2025-08-21,12,Primaria 5°,SuperSchool,116,23,93
2025-08-21,12,Primaria 5°,TopKids,114,11,103
2025-08-21,12,Primaria 5°,EduMax,246,24,222
2025-08-21,12,Primaria 5°,EduMax,111,14,97
2025-08-21,12,Primaria 5°,SuperSchool,254,16,238
2025-08-21,12,Primaria 5°,TopKids,288,3,285
2025-08-21,12,Primaria 5°,EduMax,282,3,279
2025-08-21,12,Primaria 5°,EduMax,222,13,209
2025-08-21,12,Primaria 6°,TopKids,246,8,238
2025-08-21,12,Primaria 6°,EduMax,184,19,165
2025-08-21,12,Primaria 6°,SuperSchool,152,23,129
2025-08-21,12,Primaria 6°,EduMax,81,13,68
2025-08-21,12,Primaria 6°,EduMax,292,10,282
2025-08-21,12,Primaria 6°,TopKids,182,3,179
2025-08-21,12,Primaria 6°,EduMax,205,22,183
2025-08-21,12,Primaria 6°,EduMax,275,11,264
2025-08-21,12,Primaria 6°,EduMax,109,23,86
2025-08-21,12,Primaria 6°,SuperSchool,248,10,238
2025-08-21,13,Preescolar,TopKids,145,22,123
2025-08-21,13,Preescolar,EduMax,122,13,109
2025-08-21,13,Preescolar,TopKids,88,18,70
2025-08-21,13,Preescolar,EduMax,263,5,258
2025-08-21,13,Preescolar,EduMax,158,24,134
2025-08-21,13,Preescolar,TopKids,100,9,91
2025-08-21,13,Preescolar,EduMax,72,14,58
2025-08-21,13,Preescolar,SuperSchool,200,10,190
2025-08-21,13,Preescolar,SuperSchool,162,13,149
2025-08-21,13,Preescolar,SuperSchool,228,13,215
2025-08-21,13,Preescolar,SuperSchool,114,1,113
2025-08-21,13,Preescolar,SuperSchool,217,18,199
2025-08-21,13,Preescolar,TopKids,103,1,102
2025-08-21,13,Preescolar,TopKids,229,4,225
2025-08-21,13,Preescolar,SuperSchool,58,22,36
2025-08-21,13,Preescolar,EduMax,165,10,155
2025-08-21,13,Kínder,TopKids,52,2,50
2025-08-21,13,Kínder,EduMax,86,24,62
2025-08-21,13,Kínder,TopKids,146,11,135
2025-08-21,13,Kínder,EduMax,244,23,221
2025-08-21,13,Kínder,SuperSchool,161,14,147
2025-08-21,13,Kínder,EduMax,193,21,172
2025-08-21,13,Kínder,SuperSchool,226,7,219
2025-08-21,13,Kínder,TopKids,154,4,150
2025-08-21,13,Kínder,EduMax,192,23,169
2025-08-21,13,Kínder,EduMax,195,14,181
2025-08-21,13,Kínder,SuperSchool,154,13,141
2025-08-21,13,Kínder,SuperSchool,170,19,151
2025-08-21,13,Primaria 1°,TopKids,243,23,220
2025-08-21,13,Primaria 1°,EduMax,256,5,251
2025-08-21,13,Primaria 1°,TopKids,277,5,272
2025-08-21,13,Primaria 1°,SuperSchool,161,15,146
2025-08-21,13,Primaria 1°,TopKids,65,4,61
2025-08-21,13,Primaria 1°,EduMax,259,3,256
2025-08-21,13,Primaria 1°,SuperSchool,71,24,47
2025-08-21,13,Primaria 1°,TopKids,172,5,167
2025-08-21,13,Primaria 1°,EduMax,136,16,120
2025-08-21,13,Primaria 1°,EduMax,236,15,221
2025-08-21,13,Primaria 1°,EduMax,151,13,138
2025-08-21,13,Primaria 1°,SuperSchool,242,16,226
2025-08-21,13,Primaria 1°,SuperSchool,131,16,115
2025-08-21,13,Primaria 1°,SuperSchool,151,11,140
2025-08-21,13,Primaria 1°,EduMax,258,4,254
2025-08-21,13,Primaria 2°,EduMax,159,20,139
2025-08-21,13,Primaria 2°,EduMax,115,5,110
2025-08-21,13,Primaria 2°,EduMax,133,24,109
2025-08-21,13,Primaria 2°,SuperSchool,148,16,132
2025-08-21,13,Primaria 2°,EduMax,269,15,254
2025-08-21,13,Primaria 2°,SuperSchool,199,15,184
2025-08-21,13,Primaria 2°,EduMax,261,22,239
2025-08-21,13,Primaria 2°,EduMax,97,21,76
2025-08-21,13,Primaria 2°,TopKids,122,24,98
2025-08-21,13,Primaria 2°,TopKids,273,17,256
2025-08-21,13,Primaria 2°,EduMax,132,8,124
2025-08-21,13,Primaria 2°,TopKids,228,5,223
2025-08-21,13,Primaria 2°,EduMax,288,17,271
2025-08-21,13,Primaria 2°,TopKids,187,21,166
2025-08-21,13,Primaria 2°,SuperSchool,295,2,293
2025-08-21,13,Primaria 2°,SuperSchool,147,18,129
2025-08-21,13,Primaria 2°,TopKids,134,20,114
2025-08-21,13,Primaria 2°,EduMax,227,13,214
2025-08-21,13,Primaria 3°,TopKids,61,9,52
2025-08-21,13,Primaria 3°,TopKids,51,16,35
2025-08-21,13,Primaria 3°,SuperSchool,181,15,166
2025-08-21,13,Primaria 3°,SuperSchool,101,15,86
2025-08-21,13,Primaria 3°,TopKids,254,18,236
2025-08-21,13,Primaria 3°,SuperSchool,91,20,71
2025-08-21,13,Primaria 3°,TopKids,106,8,98
2025-08-21,13,Primaria 3°,SuperSchool,205,18,187
2025-08-21,13,Primaria 4°,EduMax,105,12,93
2025-08-21,13,Primaria 4°,SuperSchool,83,14,69
2025-08-21,13,Primaria 4°,SuperSchool,174,15,159
2025-08-21,13,Primaria 4°,TopKids,194,19,175
2025-08-21,13,Primaria 4°,EduMax,186,17,169
2025-08-21,13,Primaria 4°,TopKids,214,18,196
2025-08-21,13,Primaria 4°,TopKids,181,21,160
2025-08-21,13,Primaria 4°,EduMax,196,5,191
2025-08-21,13,Primaria 4°,EduMax,181,5,176
2025-08-21,13,Primaria 4°,TopKids,209,13,196
2025-08-21,13,Primaria 4°,SuperSchool,105,16,89
2025-08-21,13,Primaria 4°,EduMax,103,1,102
2025-08-21,13,Primaria 4°,TopKids,107,21,86
2025-08-21,13,Primaria 4°,SuperSchool,297,19,278
2025-08-21,13,Primaria 4°,EduMax,263,12,251
2025-08-21,13,Primaria 4°,EduMax,143,4,139
2025-08-21,13,Primaria 5°,SuperSchool,242,14,228
2025-08-21,13,Primaria 5°,TopKids,93,12,81
2025-08-21,13,Primaria 5°,EduMax,203,13,190
2025-08-21,13,Primaria 5°,EduMax,56,16,40
2025-08-21,13,Primaria 5°,TopKids,154,14,140
2025-08-21,13,Primaria 5°,SuperSchool,111,24,87
2025-08-21,13,Primaria 5°,TopKids,189,3,186
2025-08-21,13,Primaria 5°,TopKids,95,19,76
2025-08-21,13,Primaria 5°,TopKids,278,23,255
2025-08-21,13,Primaria 5°,SuperSchool,237,10,227
2025-08-21,13,Primaria 5°,TopKids,290,16,274
2025-08-21,13,Primaria 6°,SuperSchool,254,11,243
2025-08-21,13,Primaria 6°,EduMax,150,6,144
2025-08-21,13,Primaria 6°,EduMax,157,4,153
2025-08-21,13,Primaria 6°,TopKids,220,20,200
2025-08-21,13,Primaria 6°,EduMax,149,7,142
2025-08-21,13,Primaria 6°,SuperSchool,192,20,172
2025-08-21,13,Primaria 6°,EduMax,169,8,161
2025-08-21,13,Primaria 6°,SuperSchool,266,5,261
2025-08-21,13,Primaria 6°,EduMax,227,3,224
2025-08-21,13,Primaria 6°,EduMax,266,22,244
2025-08-21,13,Primaria 6°,EduMax,129,11,118
2025-08-21,13,Primaria 6°,SuperSchool,276,23,253
2025-08-21,14,Preescolar,SuperSchool,241,3,238
2025-08-21,14,Preescolar,SuperSchool,288,23,265
2025-08-21,14,Preescolar,SuperSchool,103,3,100
2025-08-21,14,Preescolar,EduMax,136,14,122
2025-08-21,14,Preescolar,EduMax,131,6,125
2025-08-21,14,Preescolar,SuperSchool,223,17,206
2025-08-21,14,Preescolar,TopKids,242,10,232
2025-08-21,14,Preescolar,SuperSchool,165,12,153
2025-08-21,14,Preescolar,EduMax,82,24,58
2025-08-21,14,Preescolar,EduMax,189,2,187
2025-08-21,14,Preescolar,SuperSchool,242,1,241
2025-08-21,14,Kínder,TopKids,85,21,64
2025-08-21,14,Kínder,EduMax,224,1,223
2025-08-21,14,Kínder,EduMax,191,14,177
2025-08-21,14,Kínder,EduMax,184,23,161
2025-08-21,14,Kínder,TopKids,167,12,155
2025-08-21,14,Kínder,TopKids,201,19,182
2025-08-21,14,Kínder,SuperSchool,148,4,144
2025-08-21,14,Kínder,SuperSchool,91,14,77
2025-08-21,14,Kínder,EduMax,77,8,69
2025-08-21,14,Kínder,TopKids,206,10,196
2025-08-21,14,Primaria 1°,SuperSchool,54,5,49
2025-08-21,14,Primaria 1°,SuperSchool,110,23,87
2025-08-21,14,Primaria 1°,SuperSchool,160,9,151
2025-08-21,14,Primaria 1°,SuperSchool,255,6,249
2025-08-21,14,Primaria 1°,EduMax,103,20,83
2025-08-21,14,Primaria 1°,EduMax,83,5,78
2025-08-21,14,Primaria 1°,SuperSchool,91,14,77
2025-08-21,14,Primaria 1°,EduMax,82,22,60
2025-08-21,14,Primaria 1°,EduMax,141,4,137
2025-08-21,14,Primaria 1°,SuperSchool,289,5,284
2025-08-21,14,Primaria 2°,EduMax,194,11,183
2025-08-21,14,Primaria 2°,SuperSchool,256,4,252
2025-08-21,14,Primaria 2°,TopKids,143,10,133
2025-08-21,14,Primaria 2°,TopKids,201,4,197
2025-08-21,14,Primaria 2°,EduMax,246,5,241
2025-08-21,14,Primaria 2°,TopKids,113,19,94
2025-08-21,14,Primaria 2°,SuperSchool,166,8,158
2025-08-21,14,Primaria 2°,TopKids,89,13,76
2025-08-21,14,Primaria 2°,SuperSchool,173,18,155
2025-08-21,14,Primaria 2°,SuperSchool,179,16,163
2025-08-21,14,Primaria 2°,EduMax,177,17,160
2025-08-21,14,Primaria 3°,EduMax,276,17,259
2025-08-21,14,Primaria 3°,SuperSchool,87,8,79
2025-08-21,14,Primaria 3°,SuperSchool,55,16,39
2025-08-21,14,Primaria 3°,EduMax,98,21,77
2025-08-21,14,Primaria 3°,TopKids,72,12,60
2025-08-21,14,Primaria 3°,SuperSchool,113,6,107
2025-08-21,14,Primaria 3°,SuperSchool,120,11,109
2025-08-21,14,Primaria 3°,SuperSchool,257,5,252
2025-08-21,14,Primaria 3°,TopKids,198,4,194
2025-08-21,14,Primaria 3°,SuperSchool,184,3,181
2025-08-21,14,Primaria 3°,SuperSchool,192,2,190
2025-08-21,14,Primaria 3°,SuperSchool,54,7,47
2025-08-21,14,Primaria 3°,EduMax,290,8,282
2025-08-21,14,Primaria 3°,SuperSchool,219,11,208
2025-08-21,14,Primaria 3°,SuperSchool,288,8,280
2025-08-21,14,Primaria 3°,TopKids,285,6,279
2025-08-21,14,Primaria 4°,SuperSchool,105,7,98
2025-08-21,14,Primaria 4°,TopKids,104,22,82
2025-08-21,14,Primaria 4°,EduMax,76,9,67
2025-08-21,14,Primaria 4°,TopKids,87,16,71
2025-08-21,14,Primaria 4°,TopKids,192,23,169
2025-08-21,14,Primaria 4°,EduMax,238,8,230
2025-08-21,14,Primaria 4°,TopKids,183,20,163
2025-08-21,14,Primaria 4°,TopKids,222,23,199
2025-08-21,14,Primaria 4°,SuperSchool,171,13,158
2025-08-21,14,Primaria 4°,EduMax,113,22,91
2025-08-21,14,Primaria 4°,SuperSchool,66,8,58
2025-08-21,14,Primaria 4°,TopKids,138,5,133
2025-08-21,14,Primaria 4°,SuperSchool,75,16,59
2025-08-21,14,Primaria 4°,SuperSchool,289,4,285
2025-08-21,14,Primaria 5°,EduMax,166,8,158
2025-08-21,14,Primaria 5°,SuperSchool,94,17,77
2025-08-21,14,Primaria 5°,SuperSchool,126,9,117
2025-08-21,14,Primaria 5°,EduMax,140,10,130
2025-08-21,14,Primaria 5°,SuperSchool,152,11,141
2025-08-21,14,Primaria 5°,SuperSchool,170,10,160
2025-08-21,14,Primaria 5°,TopKids,84,8,76
2025-08-21,14,Primaria 5°,SuperSchool,248,12,236
2025-08-21,14,Primaria 5°,TopKids,294,13,281
2025-08-21,14,Primaria 5°,EduMax,163,24,139
2025-08-21,14,Primaria 6°,EduMax,60,3,57
2025-08-21,14,Primaria 6°,SuperSchool,236,23,213
2025-08-21,14,Primaria 6°,TopKids,285,3,282
2025-08-21,14,Primaria 6°,TopKids,237,2,235
2025-08-21,14,Primaria 6°,EduMax,197,21,176
2025-08-21,14,Primaria 6°,TopKids,255,8,247
2025-08-21,14,Primaria 6°,EduMax,267,19,248
2025-08-21,14,Primaria 6°,EduMax,205,5,200
2025-08-21,14,Primaria 6°,TopKids,77,9,68
2025-08-21,15,Preescolar,TopKids,182,15,167
2025-08-21,15,Preescolar,EduMax,122,20,102
2025-08-21,15,Preescolar,EduMax,86,15,71
2025-08-21,15,Preescolar,SuperSchool,53,21,32
2025-08-21,15,Preescolar,SuperSchool,277,20,257
2025-08-21,15,Preescolar,TopKids,198,22,176
2025-08-21,15,Preescolar,TopKids,224,22,202
2025-08-21,15,Preescolar,TopKids,66,18,48
2025-08-21,15,Preescolar,TopKids,175,19,156
2025-08-21,15,Preescolar,EduMax,76,13,63
2025-08-21,15,Preescolar,EduMax,263,20,243
2025-08-21,15,Preescolar,TopKids,92,5,87
2025-08-21,15,Preescolar,TopKids,119,3,116
2025-08-21,15,Preescolar,SuperSchool,276,3,273
2025-08-21,15,Kínder,TopKids,142,15,127
2025-08-21,15,Kínder,TopKids,195,12,183
2025-08-21,15,Kínder,TopKids,183,19,164
2025-08-21,15,Kínder,EduMax,237,18,219
2025-08-21,15,Kínder,TopKids,116,17,99
2025-08-21,15,Kínder,SuperSchool,83,19,64
2025-08-21,15,Kínder,SuperSchool,186,8,178
2025-08-21,15,Kínder,TopKids,236,15,221
2025-08-21,15,Kínder,SuperSchool,296,7,289
2025-08-21,15,Kínder,SuperSchool,225,7,218
2025-08-21,15,Primaria 1°,SuperSchool,157,17,140
2025-08-21,15,Primaria 1°,TopKids,277,19,258
2025-08-21,15,Primaria 1°,EduMax,211,24,187
2025-08-21,15,Primaria 1°,SuperSchool,265,9,256
2025-08-21,15,Primaria 1°,EduMax,50,10,40
2025-08-21,15,Primaria 1°,TopKids,64,21,43
2025-08-21,15,Primaria 1°,TopKids,170,23,147
2025-08-21,15,Primaria 1°,SuperSchool,115,14,101
2025-08-21,15,Primaria 2°,EduMax,186,2,184
2025-08-21,15,Primaria 2°,EduMax,195,17,178
2025-08-21,15,Primaria 2°,SuperSchool,121,2,119
2025-08-21,15,Primaria 2°,EduMax,246,12,234
2025-08-21,15,Primaria 2°,SuperSchool,239,16,223
2025-08-21,15,Primaria 2°,EduMax,101,2,99
2025-08-21,15,Primaria 2°,SuperSchool,181,20,161
2025-08-21,15,Primaria 2°,SuperSchool,229,19,210
2025-08-21,15,Primaria 3°,TopKids,225,11,214
2025-08-21,15,Primaria 3°,TopKids,94,2,92
2025-08-21,15,Primaria 3°,SuperSchool,268,8,260
2025-08-21,15,Primaria 3°,TopKids,297,21,276
2025-08-21,15,Primaria 3°,SuperSchool,252,22,230
2025-08-21,15,Primaria 3°,SuperSchool,205,3,202
2025-08-21,15,Primaria 4°,EduMax,128,9,119
2025-08-21,15,Primaria 4°,TopKids,248,12,236
2025-08-21,15,Primaria 4°,TopKids,76,18,58
2025-08-21,15,Primaria 4°,SuperSchool,156,1,155
2025-08-21,15,Primaria 4°,EduMax,134,2,132
2025-08-21,15,Primaria 4°,SuperSchool,158,19,139
2025-08-21,15,Primaria 4°,SuperSchool,100,23,77
2025-08-21,15,Primaria 4°,SuperSchool,264,8,256
2025-08-21,15,Primaria 4°,TopKids,203,14,189
2025-08-21,15,Primaria 4°,SuperSchool,117,18,99
2025-08-21,15,Primaria 4°,EduMax,204,9,195
2025-08-21,15,Primaria 5°,TopKids,143,4,139
2025-08-21,15,Primaria 5°,TopKids,67,14,53
2025-08-21,15,Primaria 5°,TopKids,153,10,143
2025-08-21,15,Primaria 5°,SuperSchool,218,8,210
2025-08-21,15,Primaria 5°,SuperSchool,218,13,205
2025-08-21,15,Primaria 5°,EduMax,255,5,250
2025-08-21,15,Primaria 5°,SuperSchool,298,16,282
2025-08-21,15,Primaria 5°,TopKids,201,23,178
2025-08-21,15,Primaria 5°,TopKids,280,12,268
2025-08-21,15,Primaria 5°,EduMax,243,18,225
2025-08-21,15,Primaria 5°,EduMax,257,11,246
2025-08-21,15,Primaria 5°,EduMax,127,4,123
2025-08-21,15,Primaria 5°,TopKids,147,21,126
2025-08-21,15,Primaria 5°,EduMax,216,9,207
2025-08-21,15,Primaria 5°,SuperSchool,248,19,229
2025-08-21,15,Primaria 5°,SuperSchool,171,23,148
2025-08-21,15,Primaria 5°,SuperSchool,252,22,230
2025-08-21,15,Primaria 5°,EduMax,98,16,82
2025-08-21,15,Primaria 5°,EduMax,117,4,113
2025-08-21,15,Primaria 6°,TopKids,134,8,126
2025-08-21,15,Primaria 6°,SuperSchool,129,10,119
2025-08-21,15,Primaria 6°,TopKids,250,3,247
2025-08-21,15,Primaria 6°,SuperSchool,83,9,74
2025-08-21,15,Primaria 6°,SuperSchool,247,4,243
2025-08-21,15,Primaria 6°,EduMax,269,11,258
2025-08-21,15,Primaria 6°,EduMax,110,3,107
2025-08-21,15,Primaria 6°,SuperSchool,106,7,99
2025-08-21,15,Primaria 6°,TopKids,61,11,50
2025-08-21,15,Primaria 6°,TopKids,126,4,122
2025-08-21,16,Preescolar,TopKids,51,8,43
2025-08-21,16,Preescolar,EduMax,292,13,279
2025-08-21,16,Preescolar,SuperSchool,262,1,261
2025-08-21,16,Preescolar,SuperSchool,150,22,128
2025-08-21,16,Preescolar,EduMax,267,11,256
2025-08-21,16,Preescolar,TopKids,286,2,284
2025-08-21,16,Preescolar,TopKids,289,5,284
2025-08-21,16,Preescolar,EduMax,206,19,187
2025-08-21,16,Preescolar,SuperSchool,70,24,46
2025-08-21,16,Preescolar,EduMax,282,24,258
2025-08-21,16,Preescolar,TopKids,224,17,207
2025-08-21,16,Preescolar,EduMax,64,3,61
2025-08-21,16,Preescolar,SuperSchool,190,9,181
2025-08-21,16,Preescolar,SuperSchool,257,19,238
2025-08-21,16,Preescolar,EduMax,249,22,227
2025-08-21,16,Preescolar,TopKids,234,24,210
2025-08-21,16,Preescolar,TopKids,136,21,115
2025-08-21,16,Preescolar,EduMax,161,14,147
2025-08-21,16,Kínder,SuperSchool,293,11,282
2025-08-21,16,Kínder,SuperSchool,60,4,56
2025-08-21,16,Kínder,SuperSchool,139,14,125
2025-08-21,16,Kínder,SuperSchool,213,1,212
2025-08-21,16,Kínder,EduMax,81,7,74
2025-08-21,16,Kínder,EduMax,243,10,233
2025-08-21,16,Kínder,TopKids,70,8,62
2025-08-21,16,Kínder,EduMax,121,14,107
2025-08-21,16,Kínder,EduMax,122,22,100
2025-08-21,16,Kínder,SuperSchool,143,4,139
2025-08-21,16,Kínder,TopKids,191,14,177
2025-08-21,16,Kínder,SuperSchool,289,5,284
2025-08-21,16,Primaria 1°,SuperSchool,72,24,48
2025-08-21,16,Primaria 1°,TopKids,134,9,125
2025-08-21,16,Primaria 1°,TopKids,254,23,231
2025-08-21,16,Primaria 1°,EduMax,206,6,200
2025-08-21,16,Primaria 1°,SuperSchool,210,14,196
2025-08-21,16,Primaria 1°,SuperSchool,218,18,200
2025-08-21,16,Primaria 1°,EduMax,160,16,144
2025-08-21,16,Primaria 1°,TopKids,214,14,200
2025-08-21,16,Primaria 2°,EduMax,109,21,88
2025-08-21,16,Primaria 2°,SuperSchool,213,14,199
2025-08-21,16,Primaria 2°,TopKids,225,7,218
2025-08-21,16,Primaria 2°,EduMax,59,4,55
2025-08-21,16,Primaria 2°,EduMax,62,21,41
2025-08-21,16,Primaria 2°,SuperSchool,281,23,258
2025-08-21,16,Primaria 2°,TopKids,97,5,92
2025-08-21,16,Primaria 2°,SuperSchool,171,7,164
2025-08-21,16,Primaria 2°,TopKids,139,3,136
2025-08-21,16,Primaria 2°,SuperSchool,147,2,145
2025-08-21,16,Primaria 2°,TopKids,271,10,261
2025-08-21,16,Primaria 3°,SuperSchool,131,6,125
2025-08-21,16,Primaria 3°,EduMax,171,10,161
2025-08-21,16,Primaria 3°,SuperSchool,90,9,81
2025-08-21,16,Primaria 3°,TopKids,157,11,146
2025-08-21,16,Primaria 3°,EduMax,106,19,87
2025-08-21,16,Primaria 3°,EduMax,228,5,223
2025-08-21,16,Primaria 3°,EduMax,250,1,249
2025-08-21,16,Primaria 3°,TopKids,137,4,133
2025-08-21,16,Primaria 4°,TopKids,247,15,232
2025-08-21,16,Primaria 4°,EduMax,88,20,68
2025-08-21,16,Primaria 4°,EduMax,180,21,159
2025-08-21,16,Primaria 4°,SuperSchool,270,13,257
2025-08-21,16,Primaria 4°,EduMax,276,13,263
2025-08-21,16,Primaria 4°,SuperSchool,71,19,52
2025-08-21,16,Primaria 4°,EduMax,278,10,268
2025-08-21,16,Primaria 4°,EduMax,198,17,181
2025-08-21,16,Primaria 4°,TopKids,56,9,47
2025-08-21,16,Primaria 4°,SuperSchool,85,3,82
2025-08-21,16,Primaria 4°,EduMax,126,9,117
2025-08-21,16,Primaria 4°,EduMax,136,7,129
2025-08-21,16,Primaria 4°,EduMax,206,8,198
2025-08-21,16,Primaria 4°,EduMax,210,20,190
2025-08-21,16,Primaria 5°,SuperSchool,230,21,209
2025-08-21,16,Primaria 5°,SuperSchool,292,2,290
2025-08-21,16,Primaria 5°,TopKids,273,13,260
2025-08-21,16,Primaria 5°,EduMax,214,3,211
2025-08-21,16,Primaria 5°,TopKids,73,17,56
2025-08-21,16,Primaria 5°,SuperSchool,159,6,153
2025-08-21,16,Primaria 5°,SuperSchool,245,6,239
2025-08-21,16,Primaria 5°,SuperSchool,90,4,86
2025-08-21,16,Primaria 5°,SuperSchool,154,22,132
2025-08-21,16,Primaria 5°,SuperSchool,264,17,247
2025-08-21,16,Primaria 5°,SuperSchool,180,6,174
2025-08-21,16,Primaria 5°,TopKids,110,14,96
2025-08-21,16,Primaria 5°,SuperSchool,282,23,259
2025-08-21,16,Primaria 5°,TopKids,287,4,283
2025-08-21,16,Primaria 5°,SuperSchool,252,22,230
2025-08-21,16,Primaria 5°,EduMax,193,19,174
2025-08-21,16,Primaria 5°,TopKids,225,7,218
2025-08-21,16,Primaria 6°,EduMax,97,16,81
2025-08-21,16,Primaria 6°,TopKids,138,13,125
2025-08-21,16,Primaria 6°,SuperSchool,207,1,206
2025-08-21,16,Primaria 6°,SuperSchool,295,14,281
2025-08-21,16,Primaria 6°,TopKids,211,24,187
2025-08-21,16,Primaria 6°,SuperSchool,259,15,244
2025-08-21,16,Primaria 6°,EduMax,202,13,189
2025-08-21,16,Primaria 6°,EduMax,164,8,156
2025-08-21,16,Primaria 6°,TopKids,295,17,278
2025-08-21,16,Primaria 6°,TopKids,81,20,61
2025-08-21,16,Primaria 6°,SuperSchool,255,3,252
2025-08-21,16,Primaria 6°,SuperSchool,244,13,231
2025-08-21,16,Primaria 6°,SuperSchool,131,1,130
2025-08-21,16,Primaria 6°,TopKids,110,23,87
2025-08-21,16,Primaria 6°,SuperSchool,179,17,162
2025-08-22,9,Preescolar,SuperSchool,155,4,151
2025-08-22,9,Preescolar,SuperSchool,241,21,220
2025-08-22,9,Preescolar,TopKids,299,12,287
2025-08-22,9,Preescolar,EduMax,245,9,236
2025-08-22,9,Preescolar,TopKids,297,13,284
2025-08-22,9,Preescolar,EduMax,132,14,118
2025-08-22,9,Preescolar,SuperSchool,268,10,258
2025-08-22,9,Preescolar,SuperSchool,229,16,213
2025-08-22,9,Preescolar,SuperSchool,114,21,93
2025-08-22,9,Preescolar,EduMax,160,17,143
2025-08-22,9,Preescolar,TopKids,71,5,66
2025-08-22,9,Preescolar,EduMax,198,24,174
2025-08-22,9,Preescolar,SuperSchool,140,16,124
2025-08-22,9,Preescolar,EduMax,253,18,235
2025-08-22,9,Preescolar,EduMax,148,15,133
2025-08-22,9,Preescolar,EduMax,93,13,80
2025-08-22,9,Preescolar,SuperSchool,85,8,77
2025-08-22,9,Kínder,SuperSchool,79,21,58
2025-08-22,9,Kínder,SuperSchool,284,24,260
2025-08-22,9,Kínder,SuperSchool,238,17,221
2025-08-22,9,Kínder,SuperSchool,147,24,123
2025-08-22,9,Kínder,EduMax,274,4,270
2025-08-22,9,Kínder,SuperSchool,179,3,176
2025-08-22,9,Kínder,TopKids,87,13,74
2025-08-22,9,Primaria 1°,TopKids,219,3,216
2025-08-22,9,Primaria 1°,TopKids,208,20,188
2025-08-22,9,Primaria 1°,SuperSchool,106,10,96
2025-08-22,9,Primaria 1°,SuperSchool,168,24,144
2025-08-22,9,Primaria 1°,TopKids,136,12,124
2025-08-22,9,Primaria 1°,SuperSchool,134,21,113
2025-08-22,9,Primaria 1°,SuperSchool,231,5,226
2025-08-22,9,Primaria 1°,EduMax,60,22,38
2025-08-22,9,Primaria 1°,TopKids,187,15,172
2025-08-22,9,Primaria 1°,EduMax,164,17,147
2025-08-22,9,Primaria 1°,TopKids,91,5,86
2025-08-22,9,Primaria 1°,EduMax,134,24,110
2025-08-22,9,Primaria 1°,SuperSchool,70,1,69
2025-08-22,9,Primaria 1°,EduMax,278,23,255
2025-08-22,9,Primaria 1°,TopKids,205,15,190
2025-08-22,9,Primaria 1°,SuperSchool,156,18,138
2025-08-22,9,Primaria 1°,TopKids,273,9,264
2025-08-22,9,Primaria 1°,TopKids,181,24,157
2025-08-22,9,Primaria 1°,SuperSchool,90,3,87
2025-08-22,9,Primaria 2°,EduMax,88,23,65
2025-08-22,9,Primaria 2°,SuperSchool,74,16,58
2025-08-22,9,Primaria 2°,SuperSchool,135,18,117
2025-08-22,9,Primaria 2°,TopKids,275,20,255
2025-08-22,9,Primaria 2°,SuperSchool,280,15,265
2025-08-22,9,Primaria 2°,SuperSchool,273,10,263
2025-08-22,9,Primaria 2°,SuperSchool,282,16,266
2025-08-22,9,Primaria 2°,TopKids,167,9,158
2025-08-22,9,Primaria 2°,TopKids,184,17,167
2025-08-22,9,Primaria 2°,TopKids,86,7,79
2025-08-22,9,Primaria 3°,SuperSchool,131,22,109
2025-08-22,9,Primaria 3°,EduMax,131,3,128
2025-08-22,9,Primaria 3°,SuperSchool,68,7,61
2025-08-22,9,Primaria 3°,SuperSchool,85,15,70
2025-08-22,9,Primaria 3°,TopKids,206,24,182
2025-08-22,9,Primaria 3°,SuperSchool,138,16,122
2025-08-22,9,Primaria 3°,EduMax,298,2,296
2025-08-22,9,Primaria 3°,EduMax,153,12,141
2025-08-22,9,Primaria 3°,TopKids,215,19,196
2025-08-22,9,Primaria 3°,EduMax,54,15,39
2025-08-22,9,Primaria 3°,EduMax,125,19,106
2025-08-22,9,Primaria 3°,SuperSchool,297,10,287
2025-08-22,9,Primaria 3°,EduMax,98,18,80
2025-08-22,9,Primaria 3°,EduMax,52,16,36
2025-08-22,9,Primaria 3°,EduMax,113,24,89
2025-08-22,9,Primaria 3°,SuperSchool,279,4,275
2025-08-22,9,Primaria 3°,TopKids,179,23,156
2025-08-22,9,Primaria 3°,EduMax,124,7,117
2025-08-22,9,Primaria 4°,SuperSchool,150,4,146
2025-08-22,9,Primaria 4°,EduMax,279,2,277
2025-08-22,9,Primaria 4°,EduMax,193,23,170
2025-08-22,9,Primaria 4°,TopKids,254,21,233
2025-08-22,9,Primaria 4°,TopKids,202,5,197
2025-08-22,9,Primaria 4°,SuperSchool,226,13,213
2025-08-22,9,Primaria 4°,TopKids,205,3,202
2025-08-22,9,Primaria 4°,TopKids,181,15,166
2025-08-22,9,Primaria 4°,EduMax,237,3,234
2025-08-22,9,Primaria 4°,TopKids,121,11,110
2025-08-22,9,Primaria 4°,SuperSchool,295,9,286
2025-08-22,9,Primaria 4°,SuperSchool,274,14,260
2025-08-22,9,Primaria 4°,SuperSchool,74,3,71
2025-08-22,9,Primaria 4°,SuperSchool,64,10,54
2025-08-22,9,Primaria 5°,EduMax,137,3,134
2025-08-22,9,Primaria 5°,SuperSchool,87,5,82
2025-08-22,9,Primaria 5°,TopKids,223,17,206
2025-08-22,9,Primaria 5°,SuperSchool,203,3,200
2025-08-22,9,Primaria 5°,EduMax,213,14,199
2025-08-22,9,Primaria 5°,EduMax,81,15,66
2025-08-22,9,Primaria 5°,TopKids,226,24,202
2025-08-22,9,Primaria 5°,SuperSchool,174,6,168
2025-08-22,9,Primaria 5°,SuperSchool,235,5,230
2025-08-22,9,Primaria 5°,TopKids,127,4,123
2025-08-22,9,Primaria 5°,SuperSchool,60,2,58
2025-08-22,9,Primaria 5°,EduMax,115,20,95
2025-08-22,9,Primaria 5°,SuperSchool,181,14,167
2025-08-22,9,Primaria 5°,TopKids,128,16,112
2025-08-22,9,Primaria 6°,EduMax,196,1,195
2025-08-22,9,Primaria 6°,TopKids,177,23,154
2025-08-22,9,Primaria 6°,TopKids,107,24,83
2025-08-22,9,Primaria 6°,SuperSchool,266,22,244
2025-08-22,9,Primaria 6°,TopKids,123,18,105
2025-08-22,9,Primaria 6°,SuperSchool,98,16,82
2025-08-22,9,Primaria 6°,EduMax,143,16,127
2025-08-22,9,Primaria 6°,SuperSchool,258,3,255
2025-08-22,9,Primaria 6°,EduMax,224,15,209
2025-08-22,9,Primaria 6°,TopKids,289,20,269
2025-08-22,9,Primaria 6°,SuperSchool,240,1,239
2025-08-22,9,Primaria 6°,SuperSchool,190,4,186
2025-08-22,10,Preescolar,SuperSchool,137,8,129
2025-08-22,10,Preescolar,EduMax,207,1,206
2025-08-22,10,Preescolar,SuperSchool,203,24,179
2025-08-22,10,Preescolar,SuperSchool,88,20,68
2025-08-22,10,Preescolar,SuperSchool,256,9,247
2025-08-22,10,Preescolar,SuperSchool,218,6,212
2025-08-22,10,Preescolar,SuperSchool,64,7,57
2025-08-22,10,Preescolar,EduMax,238,4,234
2025-08-22,10,Preescolar,TopKids,163,1,162
2025-08-22,10,Preescolar,EduMax,190,22,168
2025-08-22,10,Preescolar,EduMax,89,11,78
2025-08-22,10,Kínder,SuperSchool,53,4,49
2025-08-22,10,Kínder,SuperSchool,221,8,213
2025-08-22,10,Kínder,SuperSchool,185,21,164
2025-08-22,10,Kínder,TopKids,221,18,203
2025-08-22,10,Kínder,TopKids,202,14,188
2025-08-22,10,Kínder,SuperSchool,54,15,39
2025-08-22,10,Kínder,TopKids,52,12,40
2025-08-22,10,Kínder,SuperSchool,272,9,263
2025-08-22,10,Kínder,TopKids,136,8,128
2025-08-22,10,Kínder,SuperSchool,254,8,246
2025-08-22,10,Kínder,SuperSchool,74,7,67
2025-08-22,10,Kínder,SuperSchool,174,9,165
2025-08-22,10,Kínder,SuperSchool,185,12,173
2025-08-22,10,Kínder,SuperSchool,109,22,87
2025-08-22,10,Primaria 1°,EduMax,68,13,55
2025-08-22,10,Primaria 1°,TopKids,117,1,116
2025-08-22,10,Primaria 1°,EduMax,242,11,231
2025-08-22,10,Primaria 1°,TopKids,142,7,135
2025-08-22,10,Primaria 1°,EduMax,265,20,245
2025-08-22,10,Primaria 1°,SuperSchool,299,8,291
2025-08-22,10,Primaria 1°,EduMax,128,21,107
2025-08-22,10,Primaria 1°,EduMax,135,5,130
2025-08-22,10,Primaria 1°,TopKids,55,1,54
2025-08-22,10,Primaria 1°,SuperSchool,213,2,211
2025-08-22,10,Primaria 2°,EduMax,180,7,173
2025-08-22,10,Primaria 2°,SuperSchool,241,9,232
2025-08-22,10,Primaria 2°,EduMax,90,19,71
2025-08-22,10,Primaria 2°,SuperSchool,266,6,260
2025-08-22,10,Primaria 2°,EduMax,112,1,111
2025-08-22,10,Primaria 2°,SuperSchool,258,14,244
2025-08-22,10,Primaria 2°,TopKids,246,17,229
2025-08-22,10,Primaria 2°,SuperSchool,230,23,207
2025-08-22,10,Primaria 2°,TopKids,156,10,146
2025-08-22,10,Primaria 2°,SuperSchool,234,1,233
2025-08-22,10,Primaria 3°,TopKids,125,8,117
2025-08-22,10,Primaria 3°,EduMax,50,20,30
2025-08-22,10,Primaria 3°,TopKids,117,12,105
2025-08-22,10,Primaria 3°,EduMax,178,1,177
2025-08-22,10,Primaria 3°,TopKids,166,12,154
2025-08-22,10,Primaria 3°,EduMax,198,13,185
2025-08-22,10,Primaria 3°,SuperSchool,190,21,169
2025-08-22,10,Primaria 3°,SuperSchool,259,1,258
2025-08-22,10,Primaria 3°,EduMax,74,23,51
2025-08-22,10,Primaria 4°,SuperSchool,75,4,71
2025-08-22,10,Primaria 4°,EduMax,212,17,195
2025-08-22,10,Primaria 4°,TopKids,149,20,129
2025-08-22,10,Primaria 4°,SuperSchool,143,4,139
2025-08-22,10,Primaria 4°,TopKids,276,10,266
2025-08-22,10,Primaria 4°,EduMax,144,1,143
2025-08-22,10,Primaria 4°,TopKids,117,19,98
2025-08-22,10,Primaria 4°,EduMax,178,16,162
2025-08-22,10,Primaria 4°,TopKids,176,20,156
2025-08-22,10,Primaria 4°,SuperSchool,199,18,181
2025-08-22,10,Primaria 4°,EduMax,183,21,162
2025-08-22,10,Primaria 4°,SuperSchool,196,5,191
2025-08-22,10,Primaria 5°,SuperSchool,237,2,235
2025-08-22,10,Primaria 5°,SuperSchool,97,21,76
2025-08-22,10,Primaria 5°,EduMax,203,4,199
2025-08-22,10,Primaria 5°,TopKids,200,17,183
2025-08-22,10,Primaria 5°,TopKids,283,12,271
2025-08-22,10,Primaria 5°,TopKids,76,10,66
2025-08-22,10,Primaria 5°,SuperSchool,214,20,194
2025-08-22,10,Primaria 5°,TopKids,141,2,139
2025-08-22,10,Primaria 5°,EduMax,266,10,256
2025-08-22,10,Primaria 5°,SuperSchool,136,19,117
2025-08-22,10,Primaria 5°,TopKids,232,1,231
2025-08-22,10,Primaria 5°,SuperSchool,229,4,225
2025-08-22,10,Primaria 5°,SuperSchool,215,3,212
2025-08-22,10,Primaria 5°,EduMax,243,18,225
2025-08-22,10,Primaria 5°,TopKids,175,19,156
2025-08-22,10,Primaria 5°,TopKids,212,18,194
2025-08-22,10,Primaria 5°,TopKids,133,19,114
2025-08-22,10,Primaria 5°,SuperSchool,257,6,251
2025-08-22,10,Primaria 5°,SuperSchool,142,12,130
2025-08-22,10,Primaria 6°,EduMax,286,24,262
2025-08-22,10,Primaria 6°,SuperSchool,270,13,257
2025-08-22,10,Primaria 6°,TopKids,189,21,168
2025-08-22,10,Primaria 6°,EduMax,182,16,166
2025-08-22,10,Primaria 6°,TopKids,181,8,173
2025-08-22,10,Primaria 6°,SuperSchool,223,12,211
2025-08-22,10,Primaria 6°,TopKids,268,20,248
2025-08-22,10,Primaria 6°,EduMax,239,13,226
2025-08-22,10,Primaria 6°,SuperSchool,284,24,260
2025-08-22,10,Primaria 6°,EduMax,218,7,211
2025-08-22,10,Primaria 6°,EduMax,105,14,91
2025-08-22,10,Primaria 6°,EduMax,255,5,250
2025-08-22,10,Primaria 6°,SuperSchool,50,12,38
2025-08-22,10,Primaria 6°,TopKids,155,24,131
2025-08-22,10,Primaria 6°,SuperSchool,261,6,255
2025-08-22,10,Primaria 6°,SuperSchool,52,14,38
2025-08-22,11,Preescolar,SuperSchool,162,14,148
2025-08-22,11,Preescolar,TopKids,216,4,212
2025-08-22,11,Preescolar,SuperSchool,279,11,268
2025-08-22,11,Preescolar,TopKids,81,12,69
2025-08-22,11,Preescolar,TopKids,268,17,251
2025-08-22,11,Preescolar,SuperSchool,250,11,239
2025-08-22,11,Preescolar,TopKids,280,21,259
2025-08-22,11,Preescolar,TopKids,166,16,150
2025-08-22,11,Preescolar,EduMax,264,7,257
2025-08-22,11,Kínder,TopKids,134,21,113
2025-08-22,11,Kínder,EduMax,253,18,235
2025-08-22,11,Kínder,TopKids,296,9,287
2025-08-22,11,Kínder,SuperSchool,90,4,86
2025-08-22,11,Kínder,SuperSchool,280,7,273
2025-08-22,11,Kínder,TopKids,155,11,144
2025-08-22,11,Kínder,EduMax,189,16,173
2025-08-22,11,Kínder,TopKids,149,17,132
2025-08-22,11,Kínder,SuperSchool,134,23,111
2025-08-22,11,Kínder,SuperSchool,80,13,67
2025-08-22,11,Kínder,TopKids,76,23,53
2025-08-22,11,Kínder,SuperSchool,60,1,59
2025-08-22,11,Kínder,EduMax,98,9,89
2025-08-22,11,Primaria 1°,TopKids,86,16,70
2025-08-22,11,Primaria 1°,TopKids,158,13,145
2025-08-22,11,Primaria 1°,TopKids,72,17,55
2025-08-22,11,Primaria 1°,SuperSchool,172,19,153
2025-08-22,11,Primaria 1°,EduMax,275,14,261
2025-08-22,11,Primaria 1°,TopKids,116,7,109
2025-08-22,11,Primaria 1°,SuperSchool,109,11,98
2025-08-22,11,Primaria 1°,SuperSchool,192,19,173
2025-08-22,11,Primaria 2°,TopKids,192,15,177
2025-08-22,11,Primaria 2°,EduMax,256,9,247
2025-08-22,11,Primaria 2°,SuperSchool,260,24,236
2025-08-22,11,Primaria 2°,SuperSchool,239,5,234
2025-08-22,11,Primaria 2°,TopKids,199,13,186
2025-08-22,11,Primaria 2°,EduMax,165,17,148
2025-08-22,11,Primaria 2°,TopKids,159,16,143
2025-08-22,11,Primaria 2°,SuperSchool,197,14,183
2025-08-22,11,Primaria 2°,EduMax,55,22,33
2025-08-22,11,Primaria 2°,SuperSchool,209,24,185
2025-08-22,11,Primaria 2°,SuperSchool,254,3,251
2025-08-22,11,Primaria 2°,EduMax,98,8,90
2025-08-22,11,Primaria 2°,EduMax,151,16,135
2025-08-22,11,Primaria 2°,SuperSchool,155,18,137
2025-08-22,11,Primaria 2°,EduMax,267,14,253
2025-08-22,11,Primaria 2°,SuperSchool,98,14,84
2025-08-22,11,Primaria 2°,EduMax,99,4,95
2025-08-22,11,Primaria 3°,TopKids,115,7,108
2025-08-22,11,Primaria 3°,TopKids,280,13,267
2025-08-22,11,Primaria 3°,TopKids,263,6,257
2025-08-22,11,Primaria 3°,SuperSchool,234,18,216
2025-08-22,11,Primaria 3°,SuperSchool,265,1,264
2025-08-22,11,Primaria 3°,TopKids,168,13,155
2025-08-22,11,Primaria 3°,EduMax,196,16,180
2025-08-22,11,Primaria 3°,EduMax,190,10,180
2025-08-22,11,Primaria 4°,EduMax,191,9,182
2025-08-22,11,Primaria 4°,SuperSchool,188,3,185
2025-08-22,11,Primaria 4°,TopKids,280,14,266
2025-08-22,11,Primaria 4°,TopKids,209,7,202
2025-08-22,11,Primaria 4°,EduMax,285,1,284
2025-08-22,11,Primaria 4°,TopKids,150,11,139
2025-08-22,11,Primaria 4°,SuperSchool,104,13,91
2025-08-22,11,Primaria 4°,SuperSchool,265,23,242
2025-08-22,11,Primaria 4°,SuperSchool,212,10,202
2025-08-22,11,Primaria 4°,TopKids,144,7,137
2025-08-22,11,Primaria 4°,TopKids,209,22,187
2025-08-22,11,Primaria 4°,EduMax,231,10,221
2025-08-22,11,Primaria 4°,SuperSchool,157,15,142
2025-08-22,11,Primaria 4°,EduMax,260,5,255
2025-08-22,11,Primaria 4°,SuperSchool,197,2,195
2025-08-22,11,Primaria 4°,SuperSchool,164,19,145
2025-08-22,11,Primaria 4°,SuperSchool,216,4,212
2025-08-22,11,Primaria 4°,TopKids,168,3,165
2025-08-22,11,Primaria 5°,TopKids,202,21,181
2025-08-22,11,Primaria 5°,EduMax,291,16,275
2025-08-22,11,Primaria 5°,EduMax,50,23,27
2025-08-22,11,Primaria 5°,TopKids,162,24,138
2025-08-22,11,Primaria 5°,TopKids,138,7,131
2025-08-22,11,Primaria 5°,SuperSchool,299,6,293
2025-08-22,11,Primaria 5°,TopKids,96,7,89
2025-08-22,11,Primaria 5°,TopKids,255,9,246
2025-08-22,11,Primaria 5°,TopKids,151,20,131
2025-08-22,11,Primaria 6°,SuperSchool,154,12,142
2025-08-22,11,Primaria 6°,EduMax,97,5,92
2025-08-22,11,Primaria 6°,TopKids,110,17,93
2025-08-22,11,Primaria 6°,EduMax,194,6,188
2025-08-22,11,Primaria 6°,EduMax,240,15,225
2025-08-22,11,Primaria 6°,SuperSchool,190,16,174
2025-08-22,11,Primaria 6°,EduMax,174,19,155
2025-08-22,11,Primaria 6°,TopKids,113,2,111
2025-08-22,11,Primaria 6°,SuperSchool,106,12,94
2025-08-22,11,Primaria 6°,EduMax,217,12,205
2025-08-22,11,Primaria 6°,TopKids,243,1,242
2025-08-22,11,Primaria 6°,SuperSchool,235,4,231
2025-08-22,11,Primaria 6°,SuperSchool,143,7,136
2025-08-22,12,Preescolar,EduMax,267,10,257
2025-08-22,12,Preescolar,EduMax,274,5,269
2025-08-22,12,Preescolar,SuperSchool,247,22,225
2025-08-22,12,Preescolar,SuperSchool,128,7,121
2025-08-22,12,Preescolar,SuperSchool,179,18,161
2025-08-22,12,Preescolar,TopKids,198,23,175
2025-08-22,12,Preescolar,TopKids,238,20,218
2025-08-22,12,Preescolar,TopKids,225,19,206
2025-08-22,12,Preescolar,SuperSchool,189,14,175
2025-08-22,12,Preescolar,EduMax,248,2,246
2025-08-22,12,Preescolar,SuperSchool,252,18,234
2025-08-22,12,Preescolar,SuperSchool,253,3,250
2025-08-22,12,Preescolar,SuperSchool,127,15,112
2025-08-22,12,Preescolar,TopKids,155,9,146
2025-08-22,12,Preescolar,EduMax,165,23,142
2025-08-22,12,Preescolar,TopKids,123,17,106
2025-08-22,12,Kínder,SuperSchool,110,1,109
2025-08-22,12,Kínder,TopKids,190,1,189
2025-08-22,12,Kínder,TopKids,274,21,253
2025-08-22,12,Kínder,TopKids,264,10,254
2025-08-22,12,Kínder,SuperSchool,135,9,126
2025-08-22,12,Kínder,EduMax,96,4,92
2025-08-22,12,Kínder,TopKids,59,16,43
2025-08-22,12,Kínder,SuperSchool,292,20,272
2025-08-22,12,Kínder,EduMax,206,16,190
2025-08-22,12,Kínder,TopKids,112,15,97
2025-08-22,12,Kínder,TopKids,200,11,189
2025-08-22,12,Kínder,TopKids,233,24,209
2025-08-22,12,Kínder,SuperSchool,150,13,137
2025-08-22,12,Kínder,EduMax,273,5,268
2025-08-22,12,Kínder,EduMax,84,18,66
2025-08-22,12,Kínder,SuperSchool,51,22,29
2025-08-22,12,Kínder,SuperSchool,151,17,134
2025-08-22,12,Kínder,EduMax,121,14,107
2025-08-22,12,Primaria 1°,SuperSchool,178,5,173
2025-08-22,12,Primaria 1°,TopKids,186,14,172
2025-08-22,12,Primaria 1°,TopKids,186,4,182
2025-08-22,12,Primaria 1°,SuperSchool,261,15,246
2025-08-22,12,Primaria 1°,TopKids,297,21,276
2025-08-22,12,Primaria 1°,TopKids,171,22,149
2025-08-22,12,Primaria 1°,EduMax,122,19,103
2025-08-22,12,Primaria 1°,EduMax,116,18,98
2025-08-22,12,Primaria 1°,TopKids,275,2,273
2025-08-22,12,Primaria 1°,EduMax,204,23,181
2025-08-22,12,Primaria 2°,TopKids,276,8,268
2025-08-22,12,Primaria 2°,SuperSchool,67,11,56
2025-08-22,12,Primaria 2°,TopKids,68,7,61
2025-08-22,12,Primaria 2°,TopKids,106,2,104
2025-08-22,12,Primaria 2°,EduMax,182,14,168
2025-08-22,12,Primaria 2°,EduMax,85,4,81
2025-08-22,12,Primaria 2°,SuperSchool,168,21,147
2025-08-22,12,Primaria 2°,SuperSchool,274,20,254
2025-08-22,12,Primaria 2°,SuperSchool,73,3,70
2025-08-22,12,Primaria 2°,EduMax,77,21,56
2025-08-22,12,Primaria 2°,TopKids,158,7,151
2025-08-22,12,Primaria 2°,EduMax,84,23,61
2025-08-22,12,Primaria 2°,EduMax,83,7,76
2025-08-22,12,Primaria 2°,SuperSchool,166,12,154
2025-08-22,12,Primaria 3°,SuperSchool,187,19,168
2025-08-22,12,Primaria 3°,SuperSchool,91,5,86
2025-08-22,12,Primaria 3°,SuperSchool,273,15,258
2025-08-22,12,Primaria 3°,SuperSchool,180,8,172
2025-08-22,12,Primaria 3°,EduMax,270,19,251
2025-08-22,12,Primaria 3°,SuperSchool,59,1,58
2025-08-22,12,Primaria 3°,SuperSchool,268,10,258
2025-08-22,12,Primaria 3°,EduMax,251,21,230
2025-08-22,12,Primaria 3°,TopKids,242,1,241
2025-08-22,12,Primaria 3°,SuperSchool,75,15,60
2025-08-22,12,Primaria 4°,SuperSchool,114,21,93
2025-08-22,12,Primaria 4°,SuperSchool,201,7,194
2025-08-22,12,Primaria 4°,SuperSchool,91,18,73
2025-08-22,12,Primaria 4°,SuperSchool,157,24,133
2025-08-22,12,Primaria 4°,SuperSchool,252,15,237
2025-08-22,12,Primaria 4°,EduMax,91,9,82
2025-08-22,12,Primaria 4°,SuperSchool,170,3,167
2025-08-22,12,Primaria 4°,TopKids,65,12,53
2025-08-22,12,Primaria 4°,SuperSchool,266,15,251
2025-08-22,12,Primaria 4°,SuperSchool,276,5,271
2025-08-22,12,Primaria 5°,SuperSchool,73,6,67
2025-08-22,12,Primaria 5°,EduMax,107,9,98
2025-08-22,12,Primaria 5°,EduMax,238,19,219
2025-08-22,12,Primaria 5°,TopKids,94,22,72
2025-08-22,12,Primaria 5°,EduMax,240,5,235
2025-08-22,12,Primaria 5°,SuperSchool,206,20,186
2025-08-22,12,Primaria 5°,TopKids,200,6,194
2025-08-22,12,Primaria 5°,SuperSchool,210,17,193
2025-08-22,12,Primaria 5°,SuperSchool,129,23,106
2025-08-22,12,Primaria 5°,EduMax,156,5,151
2025-08-22,12,Primaria 5°,SuperSchool,165,17,148
2025-08-22,12,Primaria 5°,SuperSchool,74,15,59
2025-08-22,12,Primaria 5°,EduMax,268,12,256
2025-08-22,12,Primaria 5°,EduMax,69,13,56
2025-08-22,12,Primaria 5°,EduMax,137,15,122
2025-08-22,12,Primaria 5°,TopKids,249,19,230
2025-08-22,12,Primaria 6°,EduMax,88,14,74
2025-08-22,12,Primaria 6°,SuperSchool,224,21,203
2025-08-22,12,Primaria 6°,TopKids,297,4,293
2025-08-22,12,Primaria 6°,SuperSchool,258,20,238
2025-08-22,12,Primaria 6°,SuperSchool,257,13,244
2025-08-22,12,Primaria 6°,EduMax,187,23,164
2025-08-22,12,Primaria 6°,EduMax,290,9,281
2025-08-22,12,Primaria 6°,EduMax,294,13,281
2025-08-22,12,Primaria 6°,TopKids,95,11,84
2025-08-22,12,Primaria 6°,SuperSchool,145,17,128
2025-08-22,12,Primaria 6°,TopKids,110,1,109
2025-08-22,13,Preescolar,SuperSchool,209,13,196
2025-08-22,13,Preescolar,SuperSchool,150,23,127
2025-08-22,13,Preescolar,EduMax,110,23,87
2025-08-22,13,Preescolar,SuperSchool,239,5,234
2025-08-22,13,Preescolar,TopKids,93,15,78
2025-08-22,13,Preescolar,EduMax,62,11,51
2025-08-22,13,Preescolar,EduMax,203,17,186
2025-08-22,13,Preescolar,TopKids,122,16,106
2025-08-22,13,Preescolar,SuperSchool,101,24,77
2025-08-22,13,Kínder,SuperSchool,142,11,131
2025-08-22,13,Kínder,SuperSchool,137,13,124
2025-08-22,13,Kínder,EduMax,126,9,117
2025-08-22,13,Kínder,EduMax,178,9,169
2025-08-22,13,Kínder,SuperSchool,287,9,278
2025-08-22,13,Kínder,TopKids,151,3,148
2025-08-22,13,Primaria 1°,EduMax,295,21,274
2025-08-22,13,Primaria 1°,TopKids,223,20,203
2025-08-22,13,Primaria 1°,EduMax,221,10,211
2025-08-22,13,Primaria 1°,SuperSchool,79,20,59
2025-08-22,13,Primaria 1°,TopKids,71,1,70
2025-08-22,13,Primaria 2°,TopKids,75,16,59
2025-08-22,13,Primaria 2°,TopKids,132,12,120
2025-08-22,13,Primaria 2°,TopKids,296,24,272
2025-08-22,13,Primaria 2°,EduMax,162,5,157
2025-08-22,13,Primaria 2°,EduMax,164,6,158
2025-08-22,13,Primaria 2°,TopKids,119,12,107
2025-08-22,13,Primaria 2°,EduMax,252,7,245
2025-08-22,13,Primaria 2°,TopKids,203,1,202
2025-08-22,13,Primaria 2°,SuperSchool,160,21,139
2025-08-22,13,Primaria 2°,SuperSchool,182,20,162
2025-08-22,13,Primaria 2°,SuperSchool,70,1,69
2025-08-22,13,Primaria 2°,TopKids,156,20,136
2025-08-22,13,Primaria 2°,EduMax,294,13,281
2025-08-22,13,Primaria 3°,SuperSchool,280,11,269
2025-08-22,13,Primaria 3°,EduMax,240,1,239
2025-08-22,13,Primaria 3°,TopKids,235,1,234
2025-08-22,13,Primaria 3°,EduMax,86,11,75
2025-08-22,13,Primaria 3°,TopKids,254,11,243
2025-08-22,13,Primaria 3°,TopKids,215,19,196
2025-08-22,13,Primaria 3°,SuperSchool,256,21,235
2025-08-22,13,Primaria 3°,SuperSchool,283,1,282
2025-08-22,13,Primaria 3°,SuperSchool,87,21,66
2025-08-22,13,Primaria 3°,EduMax,265,20,245
2025-08-22,13,Primaria 4°,SuperSchool,172,18,154
2025-08-22,13,Primaria 4°,EduMax,217,14,203
2025-08-22,13,Primaria 4°,SuperSchool,135,2,133
2025-08-22,13,Primaria 4°,TopKids,269,22,247
2025-08-22,13,Primaria 4°,SuperSchool,156,3,153
2025-08-22,13,Primaria 4°,EduMax,235,16,219
2025-08-22,13,Primaria 4°,SuperSchool,129,9,120
2025-08-22,13,Primaria 4°,SuperSchool,123,17,106
2025-08-22,13,Primaria 4°,SuperSchool,134,17,117
2025-08-22,13,Primaria 4°,EduMax,217,7,210
2025-08-22,13,Primaria 4°,EduMax,199,18,181
2025-08-22,13,Primaria 4°,SuperSchool,228,18,210
2025-08-22,13,Primaria 4°,EduMax,123,1,122
2025-08-22,13,Primaria 4°,SuperSchool,195,13,182
2025-08-22,13,Primaria 4°,TopKids,66,23,43
2025-08-22,13,Primaria 4°,SuperSchool,231,16,215
2025-08-22,13,Primaria 5°,TopKids,124,23,101
2025-08-22,13,Primaria 5°,SuperSchool,152,22,130
2025-08-22,13,Primaria 5°,SuperSchool,154,10,144
2025-08-22,13,Primaria 5°,SuperSchool,67,14,53
2025-08-22,13,Primaria 5°,TopKids,201,4,197
2025-08-22,13,Primaria 5°,EduMax,260,13,247
2025-08-22,13,Primaria 5°,SuperSchool,102,19,83
2025-08-22,13,Primaria 5°,TopKids,101,15,86
2025-08-22,13,Primaria 5°,SuperSchool,124,23,101
2025-08-22,13,Primaria 5°,TopKids,118,24,94
2025-08-22,13,Primaria 5°,EduMax,219,18,201
2025-08-22,13,Primaria 5°,TopKids,82,3,79
2025-08-22,13,Primaria 6°,SuperSchool,175,17,158
2025-08-22,13,Primaria 6°,TopKids,86,22,64
2025-08-22,13,Primaria 6°,TopKids,191,3,188
2025-08-22,13,Primaria 6°,TopKids,274,21,253
2025-08-22,13,Primaria 6°,SuperSchool,75,10,65
2025-08-22,13,Primaria 6°,TopKids,126,6,120
2025-08-22,13,Primaria 6°,TopKids,119,3,116
2025-08-22,13,Primaria 6°,SuperSchool,249,3,246
2025-08-22,13,Primaria 6°,SuperSchool,134,14,120
2025-08-22,13,Primaria 6°,SuperSchool,132,5,127
2025-08-22,13,Primaria 6°,SuperSchool,133,20,113
2025-08-22,13,Primaria 6°,EduMax,170,7,163
2025-08-22,13,Primaria 6°,SuperSchool,102,18,84
2025-08-22,13,Primaria 6°,EduMax,55,7,48
2025-08-22,13,Primaria 6°,EduMax,284,22,262
2025-08-22,13,Primaria 6°,TopKids,206,19,187
2025-08-22,14,Preescolar,TopKids,245,19,226
2025-08-22,14,Preescolar,SuperSchool,209,19,190
2025-08-22,14,Preescolar,EduMax,77,9,68
2025-08-22,14,Preescolar,SuperSchool,159,9,150
2025-08-22,14,Preescolar,SuperSchool,131,6,125
2025-08-22,14,Preescolar,TopKids,71,3,68
2025-08-22,14,Preescolar,EduMax,239,10,229
2025-08-22,14,Preescolar,EduMax,58,12,46
2025-08-22,14,Preescolar,TopKids,217,24,193
2025-08-22,14,Preescolar,SuperSchool,162,8,154
2025-08-22,14,Preescolar,EduMax,197,17,180
2025-08-22,14,Preescolar,EduMax,219,1,218
2025-08-22,14,Preescolar,SuperSchool,112,1,111
2025-08-22,14,Kínder,TopKids,265,6,259
2025-08-22,14,Kínder,TopKids,58,5,53
2025-08-22,14,Kínder,SuperSchool,257,2,255
2025-08-22,14,Kínder,TopKids,148,20,128
2025-08-22,14,Kínder,EduMax,264,10,254
2025-08-22,14,Kínder,EduMax,84,15,69
2025-08-22,14,Kínder,EduMax,136,4,132
2025-08-22,14,Kínder,EduMax,156,11,145
2025-08-22,14,Kínder,TopKids,232,23,209
2025-08-22,14,Kínder,SuperSchool,89,12,77
2025-08-22,14,Kínder,SuperSchool,145,23,122
2025-08-22,14,Kínder,TopKids,164,20,144
2025-08-22,14,Kínder,EduMax,182,8,174
2025-08-22,14,Primaria 1°,SuperSchool,70,15,55
2025-08-22,14,Primaria 1°,TopKids,95,15,80
2025-08-22,14,Primaria 1°,TopKids,286,21,265
2025-08-22,14,Primaria 1°,TopKids,70,9,61
2025-08-22,14,Primaria 1°,TopKids,162,19,143
2025-08-22,14,Primaria 1°,SuperSchool,117,20,97
2025-08-22,14,Primaria 2°,EduMax,244,19,225
2025-08-22,14,Primaria 2°,TopKids,186,5,181
2025-08-22,14,Primaria 2°,EduMax,120,21,99
2025-08-22,14,Primaria 2°,EduMax,265,8,257
2025-08-22,14,Primaria 2°,EduMax,108,14,94
2025-08-22,14,Primaria 2°,EduMax,120,3,117
2025-08-22,14,Primaria 2°,EduMax,232,6,226
2025-08-22,14,Primaria 2°,SuperSchool,287,12,275
2025-08-22,14,Primaria 2°,EduMax,253,7,246
2025-08-22,14,Primaria 2°,SuperSchool,221,9,212
2025-08-22,14,Primaria 2°,SuperSchool,156,4,152
2025-08-22,14,Primaria 2°,EduMax,107,12,95
2025-08-22,14,Primaria 2°,EduMax,56,23,33
2025-08-22,14,Primaria 2°,SuperSchool,239,13,226
2025-08-22,14,Primaria 3°,TopKids,202,9,193
2025-08-22,14,Primaria 3°,TopKids,205,9,196
2025-08-22,14,Primaria 3°,EduMax,268,24,244
2025-08-22,14,Primaria 3°,EduMax,123,17,106
2025-08-22,14,Primaria 3°,TopKids,81,24,57
2025-08-22,14,Primaria 3°,TopKids,225,8,217
2025-08-22,14,Primaria 3°,EduMax,75,24,51
2025-08-22,14,Primaria 3°,TopKids,256,11,245
2025-08-22,14,Primaria 3°,TopKids,115,19,96
2025-08-22,14,Primaria 4°,EduMax,94,23,71
2025-08-22,14,Primaria 4°,SuperSchool,68,13,55
2025-08-22,14,Primaria 4°,EduMax,273,17,256
2025-08-22,14,Primaria 4°,EduMax,197,1,196
2025-08-22,14,Primaria 4°,SuperSchool,175,20,155
2025-08-22,14,Primaria 4°,EduMax,268,18,250
2025-08-22,14,Primaria 4°,SuperSchool,264,12,252
2025-08-22,14,Primaria 4°,TopKids,137,4,133
2025-08-22,14,Primaria 4°,SuperSchool,116,22,94
2025-08-22,14,Primaria 4°,TopKids,79,15,64
2025-08-22,14,Primaria 4°,EduMax,248,7,241
2025-08-22,14,Primaria 4°,EduMax,90,17,73
2025-08-22,14,Primaria 4°,SuperSchool,282,9,273
2025-08-22,14,Primaria 5°,SuperSchool,205,12,193
2025-08-22,14,Primaria 5°,SuperSchool,68,23,45
2025-08-22,14,Primaria 5°,TopKids,163,8,155
2025-08-22,14,Primaria 5°,SuperSchool,215,6,209
2025-08-22,14,Primaria 5°,TopKids,139,3,136
2025-08-22,14,Primaria 5°,EduMax,54,20,34
2025-08-22,14,Primaria 5°,EduMax,257,5,252
2025-08-22,14,Primaria 5°,EduMax,85,14,71
2025-08-22,14,Primaria 6°,TopKids,162,5,157
2025-08-22,14,Primaria 6°,EduMax,198,21,177
2025-08-22,14,Primaria 6°,EduMax,133,4,129
2025-08-22,14,Primaria 6°,TopKids,254,8,246
2025-08-22,14,Primaria 6°,TopKids,137,19,118
2025-08-22,14,Primaria 6°,TopKids,80,5,75
2025-08-22,14,Primaria 6°,SuperSchool,109,3,106
2025-08-22,14,Primaria 6°,EduMax,206,3,203
2025-08-22,14,Primaria 6°,TopKids,120,3,117
2025-08-22,14,Primaria 6°,TopKids,284,16,268
2025-08-22,14,Primaria 6°,SuperSchool,83,20,63
2025-08-22,14,Primaria 6°,SuperSchool,174,7,167
2025-08-22,14,Primaria 6°,SuperSchool,255,24,231
2025-08-22,14,Primaria 6°,EduMax,84,11,73
2025-08-22,14,Primaria 6°,EduMax,133,21,112
2025-08-22,14,Primaria 6°,EduMax,205,15,190
2025-08-22,14,Primaria 6°,EduMax,99,13,86
2025-08-22,15,Preescolar,TopKids,160,24,136
2025-08-22,15,Preescolar,SuperSchool,155,24,131
2025-08-22,15,Preescolar,TopKids,195,8,187
2025-08-22,15,Preescolar,EduMax,182,1,181
2025-08-22,15,Preescolar,SuperSchool,176,17,159
2025-08-22,15,Preescolar,TopKids,213,13,200
2025-08-22,15,Preescolar,SuperSchool,62,2,60
2025-08-22,15,Preescolar,SuperSchool,83,12,71
2025-08-22,15,Preescolar,TopKids,163,10,153
2025-08-22,15,Preescolar,EduMax,86,11,75
2025-08-22,15,Preescolar,SuperSchool,109,3,106
2025-08-22,15,Preescolar,SuperSchool,267,15,252
2025-08-22,15,Preescolar,EduMax,297,15,282
2025-08-22,15,Preescolar,TopKids,137,8,129
2025-08-22,15,Preescolar,EduMax,257,3,254
2025-08-22,15,Preescolar,SuperSchool,54,5,49
2025-08-22,15,Preescolar,SuperSchool,274,7,267
2025-08-22,15,Preescolar,TopKids,155,3,152
2025-08-22,15,Preescolar,SuperSchool,57,23,34
2025-08-22,15,Kínder,TopKids,120,16,104
2025-08-22,15,Kínder,TopKids,190,10,180
2025-08-22,15,Kínder,SuperSchool,237,17,220
2025-08-22,15,Kínder,TopKids,56,11,45
2025-08-22,15,Kínder,SuperSchool,150,23,127
2025-08-22,15,Kínder,TopKids,224,1,223
2025-08-22,15,Kínder,SuperSchool,273,13,260
2025-08-22,15,Kínder,EduMax,174,5,169
2025-08-22,15,Primaria 1°,EduMax,178,10,168
2025-08-22,15,Primaria 1°,EduMax,268,22,246
2025-08-22,15,Primaria 1°,TopKids,132,19,113
2025-08-22,15,Primaria 1°,EduMax,98,16,82
2025-08-22,15,Primaria 1°,SuperSchool,123,21,102
2025-08-22,15,Primaria 1°,SuperSchool,261,3,258
2025-08-22,15,Primaria 1°,TopKids,275,21,254
2025-08-22,15,Primaria 1°,EduMax,67,2,65
2025-08-22,15,Primaria 1°,EduMax,116,21,95
2025-08-22,15,Primaria 1°,TopKids,140,2,138
2025-08-22,15,Primaria 1°,TopKids,258,14,244
2025-08-22,15,Primaria 2°,EduMax,294,6,288
2025-08-22,15,Primaria 2°,TopKids,260,12,248
2025-08-22,15,Primaria 2°,SuperSchool,246,14,232
2025-08-22,15,Primaria 2°,TopKids,98,16,82
2025-08-22,15,Primaria 2°,SuperSchool,153,3,150
2025-08-22,15,Primaria 2°,SuperSchool,54,23,31
2025-08-22,15,Primaria 2°,SuperSchool,216,18,198
2025-08-22,15,Primaria 2°,TopKids,287,18,269
2025-08-22,15,Primaria 2°,SuperSchool,279,13,266
2025-08-22,15,Primaria 2°,EduMax,50,11,39
2025-08-22,15,Primaria 2°,TopKids,187,2,185
2025-08-22,15,Primaria 3°,SuperSchool,65,23,42
2025-08-22,15,Primaria 3°,EduMax,129,15,114
2025-08-22,15,Primaria 3°,SuperSchool,271,1,270
2025-08-22,15,Primaria 3°,SuperSchool,60,5,55
2025-08-22,15,Primaria 3°,EduMax,207,8,199
2025-08-22,15,Primaria 3°,TopKids,236,16,220
2025-08-22,15,Primaria 3°,EduMax,259,12,247
2025-08-22,15,Primaria 3°,TopKids,109,4,105
2025-08-22,15,Primaria 3°,SuperSchool,113,22,91
2025-08-22,15,Primaria 3°,TopKids,252,22,230
2025-08-22,15,Primaria 3°,TopKids,265,22,243
2025-08-22,15,Primaria 3°,TopKids,169,15,154
2025-08-22,15,Primaria 3°,SuperSchool,128,10,118
2025-08-22,15,Primaria 3°,EduMax,194,4,190
2025-08-22,15,Primaria 3°,EduMax,264,22,242
2025-08-22,15,Primaria 3°,TopKids,85,12,73
2025-08-22,15,Primaria 3°,SuperSchool,232,10,222
2025-08-22,15,Primaria 3°,EduMax,67,6,61
2025-08-22,15,Primaria 3°,SuperSchool,83,13,70
2025-08-22,15,Primaria 4°,EduMax,116,23,93
2025-08-22,15,Primaria 4°,TopKids,172,22,150
2025-08-22,15,Primaria 4°,TopKids,245,13,232
2025-08-22,15,Primaria 4°,SuperSchool,145,8,137
2025-08-22,15,Primaria 4°,TopKids,222,23,199
2025-08-22,15,Primaria 4°,EduMax,254,13,241
2025-08-22,15,Primaria 4°,SuperSchool,151,2,149
2025-08-22,15,Primaria 4°,SuperSchool,157,23,134
2025-08-22,15,Primaria 4°,EduMax,214,5,209
2025-08-22,15,Primaria 4°,SuperSchool,122,22,100
2025-08-22,15,Primaria 4°,SuperSchool,240,3,237
2025-08-22,15,Primaria 5°,SuperSchool,216,12,204
2025-08-22,15,Primaria 5°,TopKids,240,10,230
2025-08-22,15,Primaria 5°,SuperSchool,150,15,135
2025-08-22,15,Primaria 5°,SuperSchool,209,23,186
2025-08-22,15,Primaria 5°,TopKids,237,13,224
2025-08-22,15,Primaria 5°,EduMax,290,24,266
2025-08-22,15,Primaria 5°,SuperSchool,155,5,150
2025-08-22,15,Primaria 5°,EduMax,241,11,230
2025-08-22,15,Primaria 5°,EduMax,81,15,66
2025-08-22,15,Primaria 5°,EduMax,172,21,151
2025-08-22,15,Primaria 5°,EduMax,86,24,62
2025-08-22,15,Primaria 6°,EduMax,231,15,216
2025-08-22,15,Primaria 6°,SuperSchool,277,10,267
2025-08-22,15,Primaria 6°,TopKids,292,9,283
2025-08-22,15,Primaria 6°,SuperSchool,299,10,289
2025-08-22,15,Primaria 6°,EduMax,111,4,107
2025-08-22,15,Primaria 6°,TopKids,55,8,47
2025-08-22,15,Primaria 6°,EduMax,226,1,225
2025-08-22,15,Primaria 6°,EduMax,132,18,114
2025-08-22,15,Primaria 6°,SuperSchool,162,12,150
2025-08-22,15,Primaria 6°,EduMax,120,8,112
2025-08-22,16,Preescolar,SuperSchool,70,8,62
2025-08-22,16,Preescolar,TopKids,207,11,196
2025-08-22,16,Preescolar,EduMax,65,13,52
2025-08-22,16,Preescolar,SuperSchool,228,7,221
2025-08-22,16,Preescolar,SuperSchool,290,8,282
2025-08-22,16,Preescolar,SuperSchool,244,16,228
2025-08-22,16,Preescolar,TopKids,230,4,226
2025-08-22,16,Kínder,TopKids,152,11,141
2025-08-22,16,Kínder,SuperSchool,254,11,243
2025-08-22,16,Kínder,SuperSchool,281,21,260
2025-08-22,16,Kínder,SuperSchool,206,17,189
2025-08-22,16,Kínder,TopKids,228,18,210
2025-08-22,16,Kínder,EduMax,182,24,158
2025-08-22,16,Kínder,TopKids,170,1,169
2025-08-22,16,Kínder,SuperSchool,290,1,289
2025-08-22,16,Kínder,SuperSchool,146,23,123
2025-08-22,16,Kínder,EduMax,186,4,182
2025-08-22,16,Kínder,SuperSchool,159,15,144
2025-08-22,16,Primaria 1°,EduMax,263,21,242
2025-08-22,16,Primaria 1°,SuperSchool,240,23,217
2025-08-22,16,Primaria 1°,SuperSchool,230,4,226
2025-08-22,16,Primaria 1°,EduMax,148,21,127
2025-08-22,16,Primaria 1°,SuperSchool,228,16,212
2025-08-22,16,Primaria 1°,SuperSchool,195,10,185
2025-08-22,16,Primaria 1°,SuperSchool,164,22,142
2025-08-22,16,Primaria 1°,TopKids,64,11,53
2025-08-22,16,Primaria 1°,EduMax,161,10,151
2025-08-22,16,Primaria 1°,SuperSchool,96,22,74
2025-08-22,16,Primaria 1°,EduMax,278,20,258
2025-08-22,16,Primaria 1°,EduMax,199,16,183
2025-08-22,16,Primaria 1°,EduMax,65,5,60
2025-08-22,16,Primaria 1°,SuperSchool,260,10,250
2025-08-22,16,Primaria 1°,SuperSchool,110,13,97
2025-08-22,16,Primaria 1°,TopKids,73,23,50
2025-08-22,16,Primaria 1°,TopKids,188,15,173
2025-08-22,16,Primaria 2°,EduMax,102,11,91
2025-08-22,16,Primaria 2°,TopKids,250,12,238
2025-08-22,16,Primaria 2°,EduMax,172,4,168
2025-08-22,16,Primaria 2°,TopKids,204,24,180
2025-08-22,16,Primaria 2°,EduMax,231,3,228
2025-08-22,16,Primaria 2°,TopKids,70,17,53
2025-08-22,16,Primaria 3°,SuperSchool,249,12,237
2025-08-22,16,Primaria 3°,TopKids,177,2,175
2025-08-22,16,Primaria 3°,SuperSchool,219,23,196
2025-08-22,16,Primaria 3°,SuperSchool,178,4,174
2025-08-22,16,Primaria 3°,TopKids,159,16,143
2025-08-22,16,Primaria 3°,SuperSchool,67,2,65
2025-08-22,16,Primaria 3°,EduMax,244,20,224
2025-08-22,16,Primaria 3°,TopKids,62,17,45
2025-08-22,16,Primaria 3°,EduMax,79,22,57
2025-08-22,16,Primaria 3°,TopKids,97,11,86
2025-08-22,16,Primaria 3°,SuperSchool,163,2,161
2025-08-22,16,Primaria 3°,TopKids,102,8,94
2025-08-22,16,Primaria 3°,EduMax,211,13,198
2025-08-22,16,Primaria 3°,EduMax,121,7,114
2025-08-22,16,Primaria 3°,SuperSchool,267,24,243
2025-08-22,16,Primaria 3°,TopKids,81,19,62
2025-08-22,16,Primaria 3°,TopKids,103,2,101
2025-08-22,16,Primaria 3°,EduMax,86,19,67
2025-08-22,16,Primaria 4°,TopKids,163,1,162
2025-08-22,16,Primaria 4°,SuperSchool,177,7,170
2025-08-22,16,Primaria 4°,SuperSchool,106,6,100
2025-08-22,16,Primaria 4°,TopKids,190,12,178
2025-08-22,16,Primaria 4°,EduMax,134,2,132
2025-08-22,16,Primaria 5°,EduMax,77,4,73
2025-08-22,16,Primaria 5°,EduMax,284,21,263
2025-08-22,16,Primaria 5°,EduMax,151,9,142
2025-08-22,16,Primaria 5°,SuperSchool,271,5,266
2025-08-22,16,Primaria 5°,EduMax,245,6,239
2025-08-22,16,Primaria 5°,EduMax,109,13,96
2025-08-22,16,Primaria 5°,TopKids,148,10,138
2025-08-22,16,Primaria 5°,SuperSchool,208,15,193
2025-08-22,16,Primaria 5°,TopKids,238,21,217
2025-08-22,16,Primaria 6°,EduMax,238,10,228
2025-08-22,16,Primaria 6°,EduMax,199,8,191
2025-08-22,16,Primaria 6°,SuperSchool,70,3,67
2025-08-22,16,Primaria 6°,TopKids,131,3,128
2025-08-22,16,Primaria 6°,TopKids,243,15,228
2025-08-22,16,Primaria 6°,SuperSchool,73,20,53
2025-08-22,16,Primaria 6°,EduMax,169,24,145
2025-08-22,16,Primaria 6°,SuperSchool,289,2,287
2025-08-22,16,Primaria 6°,SuperSchool,217,11,206
2025-08-22,16,Primaria 6°,EduMax,50,21,29
2025-08-22,16,Primaria 6°,TopKids,131,21,110
2025-08-22,16,Primaria 6°,SuperSchool,224,24,200
2025-08-22,16,Primaria 6°,SuperSchool,58,1,57
2025-08-25,9,Preescolar,TopKids,233,10,223
2025-08-25,9,Preescolar,TopKids,174,16,158
2025-08-25,9,Preescolar,EduMax,188,19,169
2025-08-25,9,Preescolar,SuperSchool,270,19,251
2025-08-25,9,Preescolar,EduMax,298,15,283
2025-08-25,9,Preescolar,TopKids,78,16,62
2025-08-25,9,Preescolar,EduMax,217,8,209
2025-08-25,9,Preescolar,EduMax,183,13,170
2025-08-25,9,Preescolar,SuperSchool,230,12,218
2025-08-25,9,Preescolar,EduMax,198,20,178
2025-08-25,9,Preescolar,SuperSchool,125,17,108
2025-08-25,9,Kínder,TopKids,240,6,234
2025-08-25,9,Kínder,SuperSchool,181,21,160
2025-08-25,9,Kínder,SuperSchool,118,10,108
2025-08-25,9,Kínder,TopKids,249,23,226
2025-08-25,9,Kínder,EduMax,86,7,79
2025-08-25,9,Kínder,EduMax,286,19,267
2025-08-25,9,Kínder,EduMax,256,3,253
2025-08-25,9,Kínder,EduMax,145,14,131
2025-08-25,9,Kínder,TopKids,60,10,50
2025-08-25,9,Kínder,SuperSchool,258,13,245
2025-08-25,9,Primaria 1°,EduMax,109,13,96
2025-08-25,9,Primaria 1°,TopKids,54,16,38
2025-08-25,9,Primaria 1°,EduMax,209,12,197
2025-08-25,9,Primaria 1°,SuperSchool,134,16,118
2025-08-25,9,Primaria 1°,EduMax,166,1,165
2025-08-25,9,Primaria 1°,EduMax,90,16,74
2025-08-25,9,Primaria 1°,TopKids,224,18,206
2025-08-25,9,Primaria 1°,EduMax,145,12,133
2025-08-25,9,Primaria 1°,EduMax,276,4,272
2025-08-25,9,Primaria 1°,EduMax,289,13,276
2025-08-25,9,Primaria 1°,EduMax,285,2,283
2025-08-25,9,Primaria 1°,SuperSchool,126,3,123
2025-08-25,9,Primaria 1°,SuperSchool,106,2,104
2025-08-25,9,Primaria 2°,SuperSchool,165,1,164
2025-08-25,9,Primaria 2°,TopKids,222,2,220
2025-08-25,9,Primaria 2°,TopKids,260,16,244
2025-08-25,9,Primaria 2°,TopKids,128,6,122
2025-08-25,9,Primaria 2°,EduMax,76,6,70
2025-08-25,9,Primaria 2°,TopKids,214,11,203
2025-08-25,9,Primaria 2°,EduMax,267,9,258
2025-08-25,9,Primaria 3°,SuperSchool,217,15,202
2025-08-25,9,Primaria 3°,SuperSchool,278,4,274
2025-08-25,9,Primaria 3°,EduMax,101,18,83
2025-08-25,9,Primaria 3°,SuperSchool,230,3,227
2025-08-25,9,Primaria 3°,EduMax,218,9,209
2025-08-25,9,Primaria 3°,SuperSchool,166,24,142
2025-08-25,9,Primaria 3°,SuperSchool,216,7,209
2025-08-25,9,Primaria 3°,SuperSchool,200,8,192
2025-08-25,9,Primaria 3°,TopKids,134,1,133
2025-08-25,9,Primaria 3°,TopKids,218,23,195
2025-08-25,9,Primaria 3°,EduMax,94,5,89
2025-08-25,9,Primaria 3°,SuperSchool,272,19,253
2025-08-25,9,Primaria 3°,EduMax,114,22,92
2025-08-25,9,Primaria 4°,EduMax,259,8,251
2025-08-25,9,Primaria 4°,EduMax,217,15,202
2025-08-25,9,Primaria 4°,TopKids,59,24,35
2025-08-25,9,Primaria 4°,TopKids,208,12,196
2025-08-25,9,Primaria 4°,EduMax,197,3,194
2025-08-25,9,Primaria 4°,TopKids,58,8,50
2025-08-25,9,Primaria 4°,EduMax,94,18,76
2025-08-25,9,Primaria 4°,SuperSchool,286,15,271
2025-08-25,9,Primaria 4°,SuperSchool,79,16,63
2025-08-25,9,Primaria 4°,TopKids,140,19,121
2025-08-25,9,Primaria 4°,EduMax,93,14,79
2025-08-25,9,Primaria 4°,EduMax,166,24,142
2025-08-25,9,Primaria 5°,TopKids,56,6,50
2025-08-25,9,Primaria 5°,EduMax,210,21,189
2025-08-25,9,Primaria 5°,EduMax,297,6,291
2025-08-25,9,Primaria 5°,SuperSchool,80,5,75
2025-08-25,9,Primaria 5°,SuperSchool,188,5,183
2025-08-25,9,Primaria 5°,TopKids,105,9,96
2025-08-25,9,Primaria 5°,EduMax,103,2,101
2025-08-25,9,Primaria 5°,EduMax,51,22,29
2025-08-25,9,Primaria 5°,EduMax,154,16,138
2025-08-25,9,Primaria 5°,EduMax,234,15,219
2025-08-25,9,Primaria 5°,EduMax,293,4,289
2025-08-25,9,Primaria 5°,TopKids,294,24,270
2025-08-25,9,Primaria 5°,EduMax,140,5,135
2025-08-25,9,Primaria 6°,EduMax,64,11,53
2025-08-25,9,Primaria 6°,TopKids,297,17,280
2025-08-25,9,Primaria 6°,TopKids,264,3,261
2025-08-25,9,Primaria 6°,EduMax,224,24,200
2025-08-25,9,Primaria 6°,TopKids,109,13,96
2025-08-25,9,Primaria 6°,TopKids,189,17,172
2025-08-25,9,Primaria 6°,SuperSchool,206,6,200
2025-08-25,9,Primaria 6°,TopKids,177,23,154
2025-08-25,9,Primaria 6°,TopKids,286,21,265
2025-08-25,9,Primaria 6°,SuperSchool,199,4,195
2025-08-25,9,Primaria 6°,SuperSchool,275,3,272
2025-08-25,9,Primaria 6°,SuperSchool,169,18,151
2025-08-25,9,Primaria 6°,SuperSchool,159,2,157
2025-08-25,9,Primaria 6°,TopKids,185,16,169
2025-08-25,9,Primaria 6°,TopKids,265,20,245
2025-08-25,9,Primaria 6°,TopKids,86,4,82
2025-08-25,9,Primaria 6°,TopKids,61,19,42
2025-08-25,9,Primaria 6°,TopKids,234,13,221
2025-08-25,10,Preescolar,TopKids,275,7,268
2025-08-25,10,Preescolar,TopKids,77,5,72
2025-08-25,10,Preescolar,SuperSchool,124,18,106
2025-08-25,10,Preescolar,EduMax,216,10,206
2025-08-25,10,Preescolar,TopKids,229,14,215
2025-08-25,10,Preescolar,TopKids,115,13,102
2025-08-25,10,Preescolar,SuperSchool,218,17,201
2025-08-25,10,Preescolar,TopKids,105,22,83
2025-08-25,10,Preescolar,TopKids,238,23,215
2025-08-25,10,Kínder,SuperSchool,263,22,241
2025-08-25,10,Kínder,SuperSchool,257,10,247
2025-08-25,10,Kínder,SuperSchool,261,12,249
2025-08-25,10,Kínder,SuperSchool,182,20,162
2025-08-25,10,Kínder,SuperSchool,155,6,149
2025-08-25,10,Kínder,SuperSchool,229,6,223
2025-08-25,10,Kínder,SuperSchool,164,2,162
2025-08-25,10,Kínder,SuperSchool,231,20,211
2025-08-25,10,Kínder,TopKids,288,13,275
2025-08-25,10,Kínder,EduMax,212,14,198
2025-08-25,10,Kínder,SuperSchool,256,23,233
2025-08-25,10,Kínder,EduMax,121,11,110
2025-08-25,10,Kínder,SuperSchool,246,15,231
2025-08-25,10,Kínder,TopKids,299,7,292
2025-08-25,10,Kínder,SuperSchool,113,18,95
2025-08-25,10,Kínder,SuperSchool,188,21,167
2025-08-25,10,Primaria 1°,SuperSchool,123,15,108
2025-08-25,10,Primaria 1°,SuperSchool,130,3,127
2025-08-25,10,Primaria 1°,SuperSchool,92,18,74
2025-08-25,10,Primaria 1°,EduMax,102,9,93
2025-08-25,10,Primaria 1°,TopKids,156,8,148
2025-08-25,10,Primaria 1°,EduMax,86,9,77
2025-08-25,10,Primaria 1°,SuperSchool,98,10,88
2025-08-25,10,Primaria 1°,EduMax,202,10,192
2025-08-25,10,Primaria 1°,SuperSchool,213,2,211
2025-08-25,10,Primaria 1°,TopKids,251,17,234
2025-08-25,10,Primaria 2°,SuperSchool,196,19,177
2025-08-25,10,Primaria 2°,EduMax,103,19,84
2025-08-25,10,Primaria 2°,TopKids,288,18,270
2025-08-25,10,Primaria 2°,SuperSchool,251,24,227
2025-08-25,10,Primaria 2°,SuperSchool,95,19,76
2025-08-25,10,Primaria 2°,TopKids,99,11,88
2025-08-25,10,Primaria 2°,TopKids,189,8,181
2025-08-25,10,Primaria 3°,EduMax,264,18,246
2025-08-25,10,Primaria 3°,SuperSchool,103,4,99
2025-08-25,10,Primaria 3°,SuperSchool,222,5,217
2025-08-25,10,Primaria 3°,TopKids,58,20,38
2025-08-25,10,Primaria 3°,EduMax,163,20,143
2025-08-25,10,Primaria 3°,TopKids,132,21,111
2025-08-25,10,Primaria 3°,SuperSchool,182,24,158
2025-08-25,10,Primaria 3°,TopKids,256,12,244
2025-08-25,10,Primaria 3°,SuperSchool,141,1,140
2025-08-25,10,Primaria 3°,EduMax,67,18,49
2025-08-25,10,Primaria 3°,EduMax,82,17,65
2025-08-25,10,Primaria 3°,EduMax,192,12,180
2025-08-25,10,Primaria 3°,SuperSchool,229,2,227
2025-08-25,10,Primaria 4°,TopKids,68,8,60
2025-08-25,10,Primaria 4°,EduMax,202,1,201
2025-08-25,10,Primaria 4°,SuperSchool,141,20,121
2025-08-25,10,Primaria 4°,TopKids,175,9,166
2025-08-25,10,Primaria 4°,EduMax,180,5,175
2025-08-25,10,Primaria 4°,EduMax,176,21,155
2025-08-25,10,Primaria 4°,SuperSchool,131,6,125
2025-08-25,10,Primaria 4°,SuperSchool,170,7,163
2025-08-25,10,Primaria 5°,TopKids,270,10,260
2025-08-25,10,Primaria 5°,EduMax,118,11,107
2025-08-25,10,Primaria 5°,SuperSchool,111,21,90
2025-08-25,10,Primaria 5°,SuperSchool,76,20,56
2025-08-25,10,Primaria 5°,EduMax,191,9,182
2025-08-25,10,Primaria 5°,EduMax,123,10,113
2025-08-25,10,Primaria 5°,EduMax,228,11,217
2025-08-25,10,Primaria 5°,TopKids,212,19,193
2025-08-25,10,Primaria 5°,EduMax,114,12,102
2025-08-25,10,Primaria 5°,SuperSchool,96,14,82
2025-08-25,10,Primaria 5°,TopKids,229,13,216
2025-08-25,10,Primaria 5°,EduMax,209,16,193
2025-08-25,10,Primaria 6°,EduMax,173,17,156
2025-08-25,10,Primaria 6°,SuperSchool,217,4,213
2025-08-25,10,Primaria 6°,TopKids,192,1,191
2025-08-25,10,Primaria 6°,TopKids,106,10,96
2025-08-25,10,Primaria 6°,TopKids,146,17,129
2025-08-25,10,Primaria 6°,SuperSchool,160,24,136
2025-08-25,10,Primaria 6°,TopKids,127,3,124
2025-08-25,10,Primaria 6°,TopKids,157,19,138
2025-08-25,10,Primaria 6°,EduMax,143,14,129
2025-08-25,10,Primaria 6°,TopKids,154,3,151
2025-08-25,11,Preescolar,TopKids,125,20,105
2025-08-25,11,Preescolar,SuperSchool,278,8,270
2025-08-25,11,Preescolar,TopKids,267,4,263
2025-08-25,11,Preescolar,TopKids,292,15,277
2025-08-25,11,Preescolar,EduMax,127,16,111
2025-08-25,11,Preescolar,EduMax,73,14,59
2025-08-25,11,Preescolar,TopKids,83,19,64
2025-08-25,11,Preescolar,TopKids,117,11,106
2025-08-25,11,Preescolar,SuperSchool,99,18,81
2025-08-25,11,Preescolar,TopKids,93,1,92
2025-08-25,11,Preescolar,EduMax,52,17,35
2025-08-25,11,Preescolar,TopKids,114,3,111
2025-08-25,11,Preescolar,EduMax,88,23,65
2025-08-25,11,Preescolar,SuperSchool,113,8,105
2025-08-25,11,Kínder,EduMax,124,1,123
2025-08-25,11,Kínder,EduMax,147,8,139
2025-08-25,11,Kínder,SuperSchool,213,17,196
2025-08-25,11,Kínder,TopKids,283,5,278
2025-08-25,11,Kínder,EduMax,236,12,224
2025-08-25,11,Kínder,SuperSchool,197,6,191
2025-08-25,11,Kínder,SuperSchool,276,7,269
2025-08-25,11,Kínder,TopKids,233,12,221
2025-08-25,11,Kínder,SuperSchool,242,4,238
2025-08-25,11,Kínder,EduMax,211,17,194
2025-08-25,11,Kínder,SuperSchool,81,2,79
2025-08-25,11,Kínder,SuperSchool,284,19,265
2025-08-25,11,Kínder,TopKids,297,13,284
2025-08-25,11,Kínder,EduMax,203,21,182
2025-08-25,11,Kínder,EduMax,270,19,251
2025-08-25,11,Kínder,TopKids,141,12,129
2025-08-25,11,Kínder,SuperSchool,188,23,165
2025-08-25,11,Primaria 1°,SuperSchool,215,23,192
2025-08-25,11,Primaria 1°,EduMax,219,2,217
2025-08-25,11,Primaria 1°,SuperSchool,106,3,103
2025-08-25,11,Primaria 1°,EduMax,97,6,91
2025-08-25,11,Primaria 1°,SuperSchool,85,15,70
2025-08-25,11,Primaria 2°,SuperSchool,154,12,142
2025-08-25,11,Primaria 2°,SuperSchool,104,11,93
2025-08-25,11,Primaria 2°,SuperSchool,274,19,255
2025-08-25,11,Primaria 2°,SuperSchool,85,5,80
2025-08-25,11,Primaria 2°,TopKids,74,17,57
2025-08-25,11,Primaria 2°,SuperSchool,68,3,65
2025-08-25,11,Primaria 2°,TopKids,211,22,189
2025-08-25,11,Primaria 2°,EduMax,55,19,36
2025-08-25,11,Primaria 2°,SuperSchool,248,2,246
2025-08-25,11,Primaria 2°,TopKids,146,9,137
2025-08-25,11,Primaria 3°,SuperSchool,219,6,213
2025-08-25,11,Primaria 3°,EduMax,276,20,256
2025-08-25,11,Primaria 3°,TopKids,70,22,48
2025-08-25,11,Primaria 3°,EduMax,197,6,191
2025-08-25,11,Primaria 3°,TopKids,59,12,47
2025-08-25,11,Primaria 3°,SuperSchool,199,16,183
2025-08-25,11,Primaria 3°,SuperSchool,187,12,175
2025-08-25,11,Primaria 3°,TopKids,89,23,66
2025-08-25,11,Primaria 3°,EduMax,123,18,105
2025-08-25,11,Primaria 4°,TopKids,143,4,139
2025-08-25,11,Primaria 4°,SuperSchool,92,19,73
2025-08-25,11,Primaria 4°,SuperSchool,271,8,263
2025-08-25,11,Primaria 4°,EduMax,243,24,219
2025-08-25,11,Primaria 4°,EduMax,90,10,80
2025-08-25,11,Primaria 4°,SuperSchool,206,1,205
2025-08-25,11,Primaria 4°,EduMax,211,4,207
2025-08-25,11,Primaria 4°,TopKids,178,4,174
2025-08-25,11,Primaria 4°,TopKids,62,18,44
2025-08-25,11,Primaria 4°,EduMax,54,1,53
2025-08-25,11,Primaria 4°,EduMax,129,24,105
2025-08-25,11,Primaria 4°,EduMax,209,18,191
2025-08-25,11,Primaria 4°,TopKids,84,3,81
2025-08-25,11,Primaria 4°,TopKids,254,9,245
2025-08-25,11,Primaria 5°,SuperSchool,160,10,150
2025-08-25,11,Primaria 5°,TopKids,178,22,156
2025-08-25,11,Primaria 5°,SuperSchool,187,7,180
2025-08-25,11,Primaria 5°,TopKids,180,7,173
2025-08-25,11,Primaria 5°,SuperSchool,281,3,278
2025-08-25,11,Primaria 5°,EduMax,246,13,233
2025-08-25,11,Primaria 5°,SuperSchool,271,8,263
2025-08-25,11,Primaria 6°,EduMax,111,7,104
2025-08-25,11,Primaria 6°,TopKids,59,10,49
2025-08-25,11,Primaria 6°,TopKids,60,12,48
2025-08-25,11,Primaria 6°,EduMax,126,8,118
2025-08-25,11,Primaria 6°,SuperSchool,105,14,91
2025-08-25,11,Primaria 6°,SuperSchool,292,16,276
2025-08-25,12,Preescolar,EduMax,142,9,133
2025-08-25,12,Preescolar,SuperSchool,137,3,134
2025-08-25,12,Preescolar,TopKids,88,18,70
2025-08-25,12,Preescolar,SuperSchool,296,23,273
2025-08-25,12,Preescolar,SuperSchool,163,16,147
2025-08-25,12,Preescolar,SuperSchool,187,9,178
2025-08-25,12,Preescolar,TopKids,148,24,124
2025-08-25,12,Preescolar,SuperSchool,115,19,96
2025-08-25,12,Preescolar,EduMax,207,8,199
2025-08-25,12,Preescolar,EduMax,89,5,84
2025-08-25,12,Preescolar,EduMax,239,10,229
2025-08-25,12,Preescolar,TopKids,173,4,169
2025-08-25,12,Preescolar,TopKids,73,9,64
2025-08-25,12,Kínder,SuperSchool,97,15,82
2025-08-25,12,Kínder,SuperSchool,162,21,141
2025-08-25,12,Kínder,TopKids,57,14,43
2025-08-25,12,Kínder,TopKids,67,12,55
2025-08-25,12,Kínder,TopKids,287,20,267
2025-08-25,12,Kínder,TopKids,246,1,245
2025-08-25,12,Kínder,SuperSchool,95,2,93
2025-08-25,12,Kínder,SuperSchool,199,1,198
2025-08-25,12,Kínder,TopKids,295,22,273
2025-08-25,12,Kínder,TopKids,155,12,143
2025-08-25,12,Kínder,EduMax,239,19,220
2025-08-25,12,Kínder,SuperSchool,62,7,55
2025-08-25,12,Kínder,TopKids,116,5,111
2025-08-25,12,Kínder,TopKids,130,12,118
2025-08-25,12,Kínder,TopKids,95,4,91
2025-08-25,12,Kínder,SuperSchool,220,6,214
2025-08-25,12,Kínder,SuperSchool,69,15,54
2025-08-25,12,Kínder,EduMax,241,17,224
2025-08-25,12,Kínder,TopKids,219,5,214
2025-08-25,12,Primaria 1°,SuperSchool,271,15,256
2025-08-25,12,Primaria 1°,TopKids,85,8,77
2025-08-25,12,Primaria 1°,EduMax,237,17,220
2025-08-25,12,Primaria 1°,EduMax,215,16,199
2025-08-25,12,Primaria 1°,EduMax,54,14,40
2025-08-25,12,Primaria 1°,EduMax,290,6,284
2025-08-25,12,Primaria 1°,TopKids,51,1,50
2025-08-25,12,Primaria 1°,TopKids,246,8,238
2025-08-25,12,Primaria 1°,TopKids,118,5,113
2025-08-25,12,Primaria 1°,EduMax,240,18,222
2025-08-25,12,Primaria 1°,TopKids,66,3,63
2025-08-25,12,Primaria 1°,EduMax,53,19,34
2025-08-25,12,Primaria 1°,TopKids,144,9,135
2025-08-25,12,Primaria 1°,TopKids,182,4,178
2025-08-25,12,Primaria 1°,EduMax,218,16,202
2025-08-25,12,Primaria 1°,EduMax,79,17,62
2025-08-25,12,Primaria 2°,SuperSchool,99,15,84
2025-08-25,12,Primaria 2°,SuperSchool,215,6,209
2025-08-25,12,Primaria 2°,TopKids,298,20,278
2025-08-25,12,Primaria 2°,TopKids,264,12,252
2025-08-25,12,Primaria 2°,TopKids,280,22,258
2025-08-25,12,Primaria 2°,EduMax,199,15,184
2025-08-25,12,Primaria 2°,EduMax,186,15,171
2025-08-25,12,Primaria 2°,TopKids,150,3,147
2025-08-25,12,Primaria 2°,TopKids,109,2,107
2025-08-25,12,Primaria 2°,EduMax,149,3,146
2025-08-25,12,Primaria 2°,SuperSchool,271,23,248
2025-08-25,12,Primaria 2°,EduMax,177,12,165
2025-08-25,12,Primaria 2°,SuperSchool,68,12,56
2025-08-25,12,Primaria 2°,EduMax,200,1,199
2025-08-25,12,Primaria 2°,EduMax,234,23,211
2025-08-25,12,Primaria 2°,EduMax,175,4,171
2025-08-25,12,Primaria 2°,SuperSchool,272,11,261
2025-08-25,12,Primaria 2°,EduMax,220,11,209
2025-08-25,12,Primaria 2°,EduMax,279,15,264
2025-08-25,12,Primaria 3°,SuperSchool,264,22,242
2025-08-25,12,Primaria 3°,TopKids,172,5,167
2025-08-25,12,Primaria 3°,SuperSchool,145,24,121
2025-08-25,12,Primaria 3°,TopKids,230,12,218
2025-08-25,12,Primaria 3°,EduMax,84,9,75
2025-08-25,12,Primaria 3°,TopKids,116,2,114
2025-08-25,12,Primaria 4°,EduMax,130,8,122
2025-08-25,12,Primaria 4°,SuperSchool,234,8,226
2025-08-25,12,Primaria 4°,EduMax,128,18,110
2025-08-25,12,Primaria 4°,SuperSchool,266,8,258
2025-08-25,12,Primaria 4°,SuperSchool,293,18,275
2025-08-25,12,Primaria 4°,SuperSchool,159,15,144
2025-08-25,12,Primaria 4°,EduMax,146,7,139
2025-08-25,12,Primaria 4°,SuperSchool,96,6,90
2025-08-25,12,Primaria 4°,SuperSchool,93,3,90
2025-08-25,12,Primaria 4°,EduMax,133,14,119
2025-08-25,12,Primaria 5°,EduMax,53,15,38
2025-08-25,12,Primaria 5°,SuperSchool,214,24,190
2025-08-25,12,Primaria 5°,EduMax,155,9,146
2025-08-25,12,Primaria 5°,EduMax,218,8,210
2025-08-25,12,Primaria 5°,TopKids,207,22,185
2025-08-25,12,Primaria 5°,SuperSchool,202,20,182
2025-08-25,12,Primaria 5°,TopKids,79,5,74
2025-08-25,12,Primaria 5°,TopKids,181,23,158
2025-08-25,12,Primaria 5°,TopKids,256,19,237
2025-08-25,12,Primaria 5°,TopKids,129,23,106
2025-08-25,12,Primaria 5°,EduMax,150,1,149
2025-08-25,12,Primaria 5°,TopKids,150,3,147
2025-08-25,12,Primaria 5°,TopKids,143,17,126
2025-08-25,12,Primaria 5°,TopKids,162,13,149
2025-08-25,12,Primaria 5°,EduMax,135,14,121
2025-08-25,12,Primaria 5°,TopKids,285,11,274
2025-08-25,12,Primaria 6°,TopKids,212,12,200
2025-08-25,12,Primaria 6°,SuperSchool,275,14,261
2025-08-25,12,Primaria 6°,SuperSchool,116,12,104
2025-08-25,12,Primaria 6°,SuperSchool,198,7,191
2025-08-25,12,Primaria 6°,SuperSchool,276,11,265
2025-08-25,13,Preescolar,EduMax,296,10,286
2025-08-25,13,Preescolar,TopKids,85,22,63
2025-08-25,13,Preescolar,SuperSchool,252,9,243
2025-08-25,13,Preescolar,SuperSchool,141,17,124
2025-08-25,13,Preescolar,TopKids,190,21,169
2025-08-25,13,Preescolar,TopKids,82,8,74
2025-08-25,13,Preescolar,TopKids,81,5,76
2025-08-25,13,Preescolar,EduMax,225,4,221
2025-08-25,13,Preescolar,SuperSchool,111,19,92
2025-08-25,13,Preescolar,EduMax,264,2,262
2025-08-25,13,Preescolar,SuperSchool,65,22,43
2025-08-25,13,Preescolar,TopKids,57,19,38
2025-08-25,13,Preescolar,TopKids,164,17,147
2025-08-25,13,Preescolar,SuperSchool,262,21,241
2025-08-25,13,Preescolar,TopKids,130,1,129
2025-08-25,13,Preescolar,TopKids,85,23,62
2025-08-25,13,Preescolar,TopKids,288,12,276
2025-08-25,13,Kínder,SuperSchool,93,16,77
2025-08-25,13,Kínder,EduMax,62,11,51
2025-08-25,13,Kínder,TopKids,270,16,254
2025-08-25,13,Kínder,EduMax,140,11,129
2025-08-25,13,Kínder,TopKids,214,3,211
2025-08-25,13,Kínder,EduMax,275,1,274
2025-08-25,13,Kínder,TopKids,115,20,95
2025-08-25,13,Kínder,EduMax,221,21,200
2025-08-25,13,Kínder,EduMax,181,8,173
2025-08-25,13,Kínder,TopKids,95,20,75
2025-08-25,13,Kínder,EduMax,145,13,132
2025-08-25,13,Kínder,SuperSchool,118,12,106
2025-08-25,13,Kínder,EduMax,230,19,211
2025-08-25,13,Primaria 1°,SuperSchool,188,5,183
2025-08-25,13,Primaria 1°,SuperSchool,283,18,265
2025-08-25,13,Primaria 1°,SuperSchool,256,20,236
2025-08-25,13,Primaria 1°,SuperSchool,281,5,276
2025-08-25,13,Primaria 1°,SuperSchool,259,19,240
2025-08-25,13,Primaria 1°,TopKids,81,10,71
2025-08-25,13,Primaria 1°,EduMax,282,1,281
2025-08-25,13,Primaria 1°,EduMax,266,20,246
2025-08-25,13,Primaria 1°,EduMax,212,13,199
2025-08-25,13,Primaria 1°,EduMax,247,18,229
2025-08-25,13,Primaria 1°,TopKids,278,17,261
2025-08-25,13,Primaria 1°,SuperSchool,298,3,295
2025-08-25,13,Primaria 1°,SuperSchool,272,3,269
2025-08-25,13,Primaria 1°,TopKids,94,15,79
2025-08-25,13,Primaria 1°,SuperSchool,192,5,187
2025-08-25,13,Primaria 1°,EduMax,223,11,212
2025-08-25,13,Primaria 1°,EduMax,88,3,85
2025-08-25,13,Primaria 2°,EduMax,252,6,246
2025-08-25,13,Primaria 2°,SuperSchool,101,22,79
2025-08-25,13,Primaria 2°,SuperSchool,93,19,74
2025-08-25,13,Primaria 2°,TopKids,262,5,257
2025-08-25,13,Primaria 2°,SuperSchool,176,20,156
2025-08-25,13,Primaria 2°,SuperSchool,269,9,260
2025-08-25,13,Primaria 2°,SuperSchool,96,3,93
2025-08-25,13,Primaria 2°,TopKids,56,24,32
2025-08-25,13,Primaria 2°,EduMax,95,9,86
2025-08-25,13,Primaria 2°,EduMax,72,3,69
2025-08-25,13,Primaria 2°,TopKids,238,9,229
2025-08-25,13,Primaria 3°,SuperSchool,245,17,228
2025-08-25,13,Primaria 3°,SuperSchool,247,16,231
2025-08-25,13,Primaria 3°,TopKids,131,13,118
2025-08-25,13,Primaria 3°,TopKids,148,6,142
2025-08-25,13,Primaria 3°,TopKids,238,12,226
2025-08-25,13,Primaria 3°,SuperSchool,79,22,57
2025-08-25,13,Primaria 3°,SuperSchool,187,7,180
2025-08-25,13,Primaria 3°,EduMax,76,7,69
2025-08-25,13,Primaria 3°,TopKids,124,21,103
2025-08-25,13,Primaria 3°,SuperSchool,54,7,47
2025-08-25,13,Primaria 3°,EduMax,277,2,275
2025-08-25,13,Primaria 3°,TopKids,243,16,227
2025-08-25,13,Primaria 3°,TopKids,283,23,260
2025-08-25,13,Primaria 3°,EduMax,151,24,127
2025-08-25,13,Primaria 3°,SuperSchool,239,6,233
2025-08-25,13,Primaria 3°,TopKids,51,14,37
2025-08-25,13,Primaria 3°,EduMax,151,19,132
2025-08-25,13,Primaria 4°,EduMax,255,13,242
2025-08-25,13,Primaria 4°,TopKids,86,13,73
2025-08-25,13,Primaria 4°,EduMax,177,22,155
2025-08-25,13,Primaria 4°,TopKids,77,19,58
2025-08-25,13,Primaria 4°,TopKids,236,16,220
2025-08-25,13,Primaria 4°,SuperSchool,93,17,76
2025-08-25,13,Primaria 4°,EduMax,187,15,172
2025-08-25,13,Primaria 4°,TopKids,133,17,116
2025-08-25,13,Primaria 4°,TopKids,292,13,279
2025-08-25,13,Primaria 4°,TopKids,286,16,270
2025-08-25,13,Primaria 4°,EduMax,230,3,227
2025-08-25,13,Primaria 4°,TopKids,88,3,85
2025-08-25,13,Primaria 4°,SuperSchool,281,18,263
2025-08-25,13,Primaria 4°,SuperSchool,95,20,75
2025-08-25,13,Primaria 4°,SuperSchool,54,3,51
2025-08-25,13,Primaria 5°,TopKids,124,17,107
2025-08-25,13,Primaria 5°,SuperSchool,249,20,229
2025-08-25,13,Primaria 5°,EduMax,117,16,101
2025-08-25,13,Primaria 5°,SuperSchool,235,9,226
2025-08-25,13,Primaria 5°,SuperSchool,118,3,115
2025-08-25,13,Primaria 5°,EduMax,192,6,186
2025-08-25,13,Primaria 5°,TopKids,173,10,163
2025-08-25,13,Primaria 5°,EduMax,240,12,228
2025-08-25,13,Primaria 5°,SuperSchool,168,19,149
2025-08-25,13,Primaria 5°,SuperSchool,168,13,155
2025-08-25,13,Primaria 5°,SuperSchool,51,20,31
2025-08-25,13,Primaria 5°,TopKids,144,9,135
2025-08-25,13,Primaria 5°,TopKids,70,8,62
2025-08-25,13,Primaria 5°,TopKids,214,19,195
2025-08-25,13,Primaria 6°,SuperSchool,87,11,76
2025-08-25,13,Primaria 6°,TopKids,117,3,114
2025-08-25,13,Primaria 6°,SuperSchool,160,12,148
2025-08-25,13,Primaria 6°,TopKids,112,11,101
2025-08-25,13,Primaria 6°,TopKids,254,12,242
2025-08-25,13,Primaria 6°,EduMax,78,23,55
2025-08-25,13,Primaria 6°,TopKids,68,3,65
2025-08-25,14,Preescolar,TopKids,268,14,254
2025-08-25,14,Preescolar,EduMax,237,3,234
2025-08-25,14,Preescolar,TopKids,137,20,117
2025-08-25,14,Preescolar,TopKids,100,24,76
2025-08-25,14,Preescolar,TopKids,70,1,69
2025-08-25,14,Preescolar,SuperSchool,55,7,48
2025-08-25,14,Preescolar,EduMax,131,15,116
2025-08-25,14,Preescolar,TopKids,145,10,135
2025-08-25,14,Preescolar,SuperSchool,227,18,209
2025-08-25,14,Preescolar,TopKids,241,15,226
2025-08-25,14,Preescolar,EduMax,72,6,66
2025-08-25,14,Preescolar,SuperSchool,252,15,237
2025-08-25,14,Preescolar,TopKids,52,19,33
2025-08-25,14,Kínder,SuperSchool,124,18,106
2025-08-25,14,Kínder,TopKids,237,7,230
2025-08-25,14,Kínder,SuperSchool,125,4,121
2025-08-25,14,Kínder,SuperSchool,249,15,234
2025-08-25,14,Kínder,TopKids,143,8,135
2025-08-25,14,Primaria 1°,TopKids,262,4,258
2025-08-25,14,Primaria 1°,TopKids,93,8,85
2025-08-25,14,Primaria 1°,TopKids,177,23,154
2025-08-25,14,Primaria 1°,EduMax,72,10,62
2025-08-25,14,Primaria 1°,EduMax,104,1,103
2025-08-25,14,Primaria 1°,SuperSchool,112,7,105
2025-08-25,14,Primaria 1°,TopKids,238,16,222
2025-08-25,14,Primaria 1°,SuperSchool,144,5,139
2025-08-25,14,Primaria 1°,EduMax,153,12,141
2025-08-25,14,Primaria 1°,SuperSchool,70,3,67
2025-08-25,14,Primaria 1°,EduMax,136,17,119
2025-08-25,14,Primaria 1°,EduMax,276,2,274
2025-08-25,14,Primaria 1°,TopKids,223,9,214
2025-08-25,14,Primaria 1°,TopKids,226,4,222
2025-08-25,14,Primaria 1°,EduMax,145,22,123
2025-08-25,14,Primaria 1°,TopKids,126,23,103
2025-08-25,14,Primaria 2°,TopKids,100,9,91
2025-08-25,14,Primaria 2°,SuperSchool,217,15,202
2025-08-25,14,Primaria 2°,EduMax,276,24,252
2025-08-25,14,Primaria 2°,EduMax,207,17,190
2025-08-25,14,Primaria 2°,EduMax,94,15,79
2025-08-25,14,Primaria 2°,TopKids,224,12,212
2025-08-25,14,Primaria 2°,EduMax,105,22,83
2025-08-25,14,Primaria 2°,SuperSchool,58,22,36
2025-08-25,14,Primaria 2°,TopKids,114,12,102
2025-08-25,14,Primaria 2°,EduMax,178,22,156
2025-08-25,14,Primaria 2°,TopKids,295,13,282
2025-08-25,14,Primaria 2°,EduMax,290,13,277
2025-08-25,14,Primaria 2°,SuperSchool,89,15,74
2025-08-25,14,Primaria 2°,EduMax,179,21,158
2025-08-25,14,Primaria 2°,TopKids,203,2,201
2025-08-25,14,Primaria 2°,TopKids,82,18,64
2025-08-25,14,Primaria 2°,SuperSchool,108,7,101
2025-08-25,14,Primaria 2°,SuperSchool,226,16,210
2025-08-25,14,Primaria 2°,TopKids,263,7,256
2025-08-25,14,Primaria 3°,SuperSchool,63,8,55
2025-08-25,14,Primaria 3°,SuperSchool,157,7,150
2025-08-25,14,Primaria 3°,EduMax,222,22,200
2025-08-25,14,Primaria 3°,SuperSchool,129,1,128
2025-08-25,14,Primaria 3°,TopKids,84,6,78
2025-08-25,14,Primaria 3°,SuperSchool,180,22,158
2025-08-25,14,Primaria 4°,EduMax,144,23,121
2025-08-25,14,Primaria 4°,SuperSchool,118,15,103
2025-08-25,14,Primaria 4°,SuperSchool,268,10,258
2025-08-25,14,Primaria 4°,TopKids,108,8,100
2025-08-25,14,Primaria 4°,EduMax,279,17,262
2025-08-25,14,Primaria 4°,EduMax,245,21,224
2025-08-25,14,Primaria 4°,TopKids,91,23,68
2025-08-25,14,Primaria 5°,EduMax,114,22,92
2025-08-25,14,Primaria 5°,EduMax,154,5,149
2025-08-25,14,Primaria 5°,TopKids,112,22,90
2025-08-25,14,Primaria 5°,EduMax,296,21,275
2025-08-25,14,Primaria 5°,SuperSchool,213,20,193
2025-08-25,14,Primaria 5°,SuperSchool,99,8,91
2025-08-25,14,Primaria 5°,EduMax,176,17,159
2025-08-25,14,Primaria 5°,EduMax,62,15,47
2025-08-25,14,Primaria 5°,SuperSchool,76,8,68
2025-08-25,14,Primaria 5°,EduMax,277,18,259
2025-08-25,14,Primaria 5°,TopKids,203,4,199
2025-08-25,14,Primaria 5°,SuperSchool,254,20,234
2025-08-25,14,Primaria 5°,TopKids,57,14,43
2025-08-25,14,Primaria 5°,EduMax,289,14,275
2025-08-25,14,Primaria 5°,SuperSchool,179,20,159
2025-08-25,14,Primaria 5°,SuperSchool,60,6,54
2025-08-25,14,Primaria 5°,TopKids,125,5,120
2025-08-25,14,Primaria 6°,TopKids,93,22,71
2025-08-25,14,Primaria 6°,EduMax,191,19,172
2025-08-25,14,Primaria 6°,SuperSchool,148,18,130
2025-08-25,14,Primaria 6°,EduMax,122,7,115
2025-08-25,14,Primaria 6°,SuperSchool,131,2,129
2025-08-25,14,Primaria 6°,EduMax,285,2,283
2025-08-25,14,Primaria 6°,SuperSchool,185,23,162
2025-08-25,14,Primaria 6°,TopKids,276,23,253
2025-08-25,14,Primaria 6°,SuperSchool,146,15,131
2025-08-25,14,Primaria 6°,SuperSchool,189,11,178
2025-08-25,14,Primaria 6°,EduMax,181,2,179
2025-08-25,14,Primaria 6°,TopKids,81,3,78
2025-08-25,14,Primaria 6°,SuperSchool,163,12,151
2025-08-25,14,Primaria 6°,SuperSchool,180,4,176
2025-08-25,14,Primaria 6°,EduMax,119,17,102
2025-08-25,14,Primaria 6°,EduMax,249,18,231
2025-08-25,14,Primaria 6°,SuperSchool,183,24,159
2025-08-25,15,Preescolar,SuperSchool,205,21,184
2025-08-25,15,Preescolar,SuperSchool,89,21,68
2025-08-25,15,Preescolar,TopKids,178,21,157
2025-08-25,15,Preescolar,SuperSchool,117,10,107
2025-08-25,15,Preescolar,EduMax,217,3,214
2025-08-25,15,Preescolar,EduMax,58,3,55
2025-08-25,15,Preescolar,EduMax,122,2,120
2025-08-25,15,Kínder,EduMax,134,22,112
2025-08-25,15,Kínder,TopKids,84,18,66
2025-08-25,15,Kínder,TopKids,87,1,86
2025-08-25,15,Kínder,SuperSchool,192,11,181
2025-08-25,15,Kínder,EduMax,149,14,135
2025-08-25,15,Kínder,EduMax,94,16,78
2025-08-25,15,Primaria 1°,EduMax,214,19,195
2025-08-25,15,Primaria 1°,SuperSchool,276,21,255
2025-08-25,15,Primaria 1°,SuperSchool,211,17,194
2025-08-25,15,Primaria 1°,SuperSchool,92,1,91
2025-08-25,15,Primaria 1°,TopKids,57,11,46
2025-08-25,15,Primaria 1°,SuperSchool,162,20,142
2025-08-25,15,Primaria 1°,EduMax,184,21,163
2025-08-25,15,Primaria 1°,SuperSchool,216,11,205
2025-08-25,15,Primaria 1°,TopKids,123,8,115
2025-08-25,15,Primaria 1°,EduMax,167,11,156
2025-08-25,15,Primaria 1°,SuperSchool,60,16,44
2025-08-25,15,Primaria 1°,SuperSchool,91,20,71
2025-08-25,15,Primaria 1°,SuperSchool,101,9,92
2025-08-25,15,Primaria 1°,TopKids,244,10,234
2025-08-25,15,Primaria 1°,TopKids,51,8,43
2025-08-25,15,Primaria 1°,EduMax,295,9,286
2025-08-25,15,Primaria 2°,TopKids,229,23,206
2025-08-25,15,Primaria 2°,SuperSchool,254,1,253
2025-08-25,15,Primaria 2°,SuperSchool,173,8,165
2025-08-25,15,Primaria 2°,SuperSchool,87,3,84
2025-08-25,15,Primaria 2°,EduMax,248,22,226
2025-08-25,15,Primaria 2°,SuperSchool,244,14,230
2025-08-25,15,Primaria 2°,TopKids,174,13,161
2025-08-25,15,Primaria 2°,TopKids,108,1,107
2025-08-25,15,Primaria 2°,SuperSchool,86,18,68
2025-08-25,15,Primaria 2°,TopKids,250,7,243
2025-08-25,15,Primaria 2°,EduMax,143,24,119
2025-08-25,15,Primaria 2°,SuperSchool,116,16,100
2025-08-25,15,Primaria 2°,EduMax,152,1,151
2025-08-25,15,Primaria 2°,EduMax,139,6,133
2025-08-25,15,Primaria 2°,TopKids,283,12,271
2025-08-25,15,Primaria 3°,TopKids,215,14,201
2025-08-25,15,Primaria 3°,TopKids,59,9,50
2025-08-25,15,Primaria 3°,TopKids,143,20,123
2025-08-25,15,Primaria 3°,TopKids,71,15,56
2025-08-25,15,Primaria 3°,SuperSchool,132,8,124
2025-08-25,15,Primaria 3°,EduMax,117,5,112
2025-08-25,15,Primaria 3°,TopKids,287,18,269
2025-08-25,15,Primaria 3°,SuperSchool,206,19,187
2025-08-25,15,Primaria 3°,EduMax,118,11,107
2025-08-25,15,Primaria 3°,SuperSchool,121,5,116
2025-08-25,15,Primaria 4°,EduMax,286,6,280
2025-08-25,15,Primaria 4°,TopKids,86,18,68
2025-08-25,15,Primaria 4°,EduMax,219,16,203
2025-08-25,15,Primaria 4°,EduMax,159,23,136
2025-08-25,15,Primaria 4°,TopKids,244,3,241
2025-08-25,15,Primaria 4°,TopKids,160,11,149
2025-08-25,15,Primaria 4°,EduMax,101,15,86
2025-08-25,15,Primaria 4°,EduMax,234,14,220
2025-08-25,15,Primaria 4°,SuperSchool,170,6,164
2025-08-25,15,Primaria 4°,EduMax,193,2,191
2025-08-25,15,Primaria 4°,TopKids,150,11,139
2025-08-25,15,Primaria 4°,TopKids,240,21,219
2025-08-25,15,Primaria 4°,SuperSchool,138,19,119
2025-08-25,15,Primaria 4°,EduMax,171,8,163
2025-08-25,15,Primaria 4°,TopKids,253,9,244
2025-08-25,15,Primaria 5°,EduMax,198,21,177
2025-08-25,15,Primaria 5°,EduMax,297,1,296
2025-08-25,15,Primaria 5°,SuperSchool,276,18,258
2025-08-25,15,Primaria 5°,EduMax,243,4,239
2025-08-25,15,Primaria 5°,SuperSchool,59,5,54
2025-08-25,15,Primaria 5°,SuperSchool,90,14,76
2025-08-25,15,Primaria 5°,SuperSchool,254,13,241
2025-08-25,15,Primaria 6°,EduMax,265,1,264
2025-08-25,15,Primaria 6°,SuperSchool,133,8,125
2025-08-25,15,Primaria 6°,TopKids,98,12,86
2025-08-25,15,Primaria 6°,SuperSchool,298,18,280
2025-08-25,15,Primaria 6°,EduMax,111,11,100
2025-08-25,15,Primaria 6°,TopKids,289,4,285
2025-08-25,15,Primaria 6°,TopKids,291,7,284
2025-08-25,15,Primaria 6°,TopKids,289,16,273
2025-08-25,15,Primaria 6°,TopKids,74,23,51
2025-08-25,15,Primaria 6°,SuperSchool,185,7,178
2025-08-25,15,Primaria 6°,TopKids,298,17,281
2025-08-25,15,Primaria 6°,TopKids,144,4,140
2025-08-25,15,Primaria 6°,SuperSchool,185,10,175
2025-08-25,15,Primaria 6°,SuperSchool,55,9,46
2025-08-25,15,Primaria 6°,EduMax,249,15,234
2025-08-25,16,Preescolar,TopKids,118,18,100
2025-08-25,16,Preescolar,TopKids,274,2,272
2025-08-25,16,Preescolar,TopKids,283,6,277
2025-08-25,16,Preescolar,TopKids,205,24,181
2025-08-25,16,Preescolar,TopKids,198,11,187
2025-08-25,16,Preescolar,EduMax,141,16,125
2025-08-25,16,Kínder,TopKids,155,16,139
2025-08-25,16,Kínder,EduMax,276,11,265
2025-08-25,16,Kínder,TopKids,105,16,89
2025-08-25,16,Kínder,TopKids,77,10,67
2025-08-25,16,Kínder,SuperSchool,134,16,118
2025-08-25,16,Kínder,EduMax,138,7,131
2025-08-25,16,Kínder,TopKids,192,15,177
2025-08-25,16,Kínder,EduMax,276,6,270
2025-08-25,16,Kínder,EduMax,99,22,77
2025-08-25,16,Kínder,SuperSchool,225,13,212
2025-08-25,16,Kínder,TopKids,128,23,105
2025-08-25,16,Kínder,TopKids,293,6,287
2025-08-25,16,Primaria 1°,EduMax,199,4,195
2025-08-25,16,Primaria 1°,TopKids,75,18,57
2025-08-25,16,Primaria 1°,SuperSchool,240,20,220
2025-08-25,16,Primaria 1°,EduMax,112,5,107
2025-08-25,16,Primaria 1°,SuperSchool,183,22,161
2025-08-25,16,Primaria 1°,TopKids,61,15,46
2025-08-25,16,Primaria 1°,EduMax,58,7,51
2025-08-25,16,Primaria 1°,SuperSchool,255,19,236
2025-08-25,16,Primaria 1°,TopKids,273,24,249
2025-08-25,16,Primaria 1°,EduMax,277,12,265
2025-08-25,16,Primaria 1°,EduMax,107,8,99
2025-08-25,16,Primaria 1°,SuperSchool,138,24,114
2025-08-25,16,Primaria 1°,TopKids,75,4,71
2025-08-25,16,Primaria 2°,EduMax,125,16,109
2025-08-25,16,Primaria 2°,TopKids,91,5,86
2025-08-25,16,Primaria 2°,SuperSchool,93,3,90
2025-08-25,16,Primaria 2°,TopKids,177,1,176
2025-08-25,16,Primaria 2°,EduMax,92,12,80
2025-08-25,16,Primaria 2°,TopKids,240,1,239
2025-08-25,16,Primaria 2°,TopKids,254,13,241
2025-08-25,16,Primaria 2°,EduMax,79,10,69
2025-08-25,16,Primaria 2°,TopKids,146,7,139
2025-08-25,16,Primaria 2°,SuperSchool,297,2,295
2025-08-25,16,Primaria 2°,TopKids,258,22,236
2025-08-25,16,Primaria 2°,SuperSchool,188,22,166
2025-08-25,16,Primaria 2°,TopKids,188,17,171
2025-08-25,16,Primaria 2°,TopKids,204,8,196
2025-08-25,16,Primaria 3°,TopKids,191,10,181
2025-08-25,16,Primaria 3°,SuperSchool,88,2,86
2025-08-25,16,Primaria 3°,SuperSchool,50,13,37
2025-08-25,16,Primaria 3°,TopKids,174,14,160
2025-08-25,16,Primaria 3°,TopKids,235,18,217
2025-08-25,16,Primaria 3°,EduMax,160,14,146
2025-08-25,16,Primaria 3°,SuperSchool,65,5,60
2025-08-25,16,Primaria 3°,EduMax,190,16,174
2025-08-25,16,Primaria 4°,TopKids,246,21,225
2025-08-25,16,Primaria 4°,TopKids,207,23,184
2025-08-25,16,Primaria 4°,EduMax,206,13,193
2025-08-25,16,Primaria 4°,EduMax,155,2,153
2025-08-25,16,Primaria 4°,SuperSchool,98,1,97
2025-08-25,16,Primaria 4°,EduMax,247,12,235
2025-08-25,16,Primaria 4°,SuperSchool,235,24,211
2025-08-25,16,Primaria 4°,SuperSchool,269,2,267
2025-08-25,16,Primaria 4°,SuperSchool,136,10,126
2025-08-25,16,Primaria 4°,TopKids,143,22,121
2025-08-25,16,Primaria 4°,SuperSchool,294,12,282
2025-08-25,16,Primaria 4°,EduMax,58,11,47
2025-08-25,16,Primaria 4°,EduMax,114,2,112
2025-08-25,16,Primaria 4°,SuperSchool,241,23,218
2025-08-25,16,Primaria 4°,EduMax,195,16,179
2025-08-25,16,Primaria 4°,TopKids,223,4,219
2025-08-25,16,Primaria 4°,EduMax,243,12,231
2025-08-25,16,Primaria 4°,SuperSchool,78,4,74
2025-08-25,16,Primaria 4°,TopKids,148,22,126
2025-08-25,16,Primaria 5°,SuperSchool,185,20,165
2025-08-25,16,Primaria 5°,SuperSchool,198,6,192
2025-08-25,16,Primaria 5°,SuperSchool,134,8,126
2025-08-25,16,Primaria 5°,EduMax,67,4,63
2025-08-25,16,Primaria 5°,SuperSchool,176,15,161
2025-08-25,16,Primaria 6°,TopKids,262,16,246
2025-08-25,16,Primaria 6°,EduMax,95,16,79
2025-08-25,16,Primaria 6°,TopKids,295,24,271
2025-08-25,16,Primaria 6°,TopKids,68,19,49
2025-08-25,16,Primaria 6°,TopKids,281,10,271
2025-08-25,16,Primaria 6°,SuperSchool,97,3,94
2025-08-25,16,Primaria 6°,EduMax,123,24,99
2025-08-25,16,Primaria 6°,EduMax,270,13,257
2025-08-25,16,Primaria 6°,TopKids,221,23,198
2025-08-25,16,Primaria 6°,EduMax,204,10,194
2025-08-26,9,Preescolar,TopKids,175,13,162
2025-08-26,9,Preescolar,EduMax,108,6,102
2025-08-26,9,Preescolar,SuperSchool,132,7,125
2025-08-26,9,Preescolar,EduMax,246,1,245
2025-08-26,9,Preescolar,EduMax,258,9,249
2025-08-26,9,Preescolar,SuperSchool,177,21,156
2025-08-26,9,Preescolar,EduMax,133,17,116
2025-08-26,9,Preescolar,SuperSchool,78,4,74
2025-08-26,9,Preescolar,TopKids,76,18,58
2025-08-26,9,Preescolar,EduMax,167,9,158
2025-08-26,9,Preescolar,TopKids,184,15,169
2025-08-26,9,Preescolar,EduMax,122,9,113
2025-08-26,9,Preescolar,TopKids,277,18,259
2025-08-26,9,Kínder,SuperSchool,295,21,274
2025-08-26,9,Kínder,EduMax,88,10,78
2025-08-26,9,Kínder,EduMax,108,6,102
2025-08-26,9,Kínder,EduMax,208,19,189
2025-08-26,9,Kínder,SuperSchool,153,9,144
2025-08-26,9,Kínder,SuperSchool,257,6,251
2025-08-26,9,Kínder,TopKids,172,8,164
2025-08-26,9,Kínder,TopKids,125,10,115
2025-08-26,9,Kínder,TopKids,92,24,68
2025-08-26,9,Kínder,TopKids,185,11,174
2025-08-26,9,Kínder,SuperSchool,75,7,68
2025-08-26,9,Kínder,TopKids,64,16,48
2025-08-26,9,Kínder,TopKids,193,15,178
2025-08-26,9,Kínder,SuperSchool,146,14,132
2025-08-26,9,Kínder,EduMax,252,3,249
2025-08-26,9,Kínder,SuperSchool,247,23,224
2025-08-26,9,Kínder,TopKids,291,17,274
2025-08-26,9,Kínder,SuperSchool,52,19,33
2025-08-26,9,Kínder,TopKids,160,10,150
2025-08-26,9,Primaria 1°,SuperSchool,149,8,141
2025-08-26,9,Primaria 1°,EduMax,243,23,220
2025-08-26,9,Primaria 1°,EduMax,74,7,67
2025-08-26,9,Primaria 1°,SuperSchool,227,17,210
2025-08-26,9,Primaria 1°,SuperSchool,140,12,128
2025-08-26,9,Primaria 1°,SuperSchool,56,24,32
2025-08-26,9,Primaria 1°,TopKids,143,1,142
2025-08-26,9,Primaria 1°,TopKids,147,6,141
2025-08-26,9,Primaria 1°,TopKids,232,21,211
2025-08-26,9,Primaria 1°,SuperSchool,284,16,268
2025-08-26,9,Primaria 1°,EduMax,151,11,140
2025-08-26,9,Primaria 1°,SuperSchool,63,21,42
2025-08-26,9,Primaria 2°,SuperSchool,83,6,77
2025-08-26,9,Primaria 2°,EduMax,154,14,140
2025-08-26,9,Primaria 2°,EduMax,217,3,214
2025-08-26,9,Primaria 2°,EduMax,131,20,111
2025-08-26,9,Primaria 2°,SuperSchool,282,19,263
2025-08-26,9,Primaria 2°,SuperSchool,82,17,65
2025-08-26,9,Primaria 2°,TopKids,225,16,209
2025-08-26,9,Primaria 2°,TopKids,75,6,69
2025-08-26,9,Primaria 2°,SuperSchool,199,10,189
2025-08-26,9,Primaria 2°,TopKids,56,10,46
2025-08-26,9,Primaria 2°,EduMax,123,15,108
2025-08-26,9,Primaria 2°,EduMax,73,2,71
2025-08-26,9,Primaria 2°,SuperSchool,293,15,278
2025-08-26,9,Primaria 2°,SuperSchool,134,18,116
2025-08-26,9,Primaria 3°,SuperSchool,85,10,75
2025-08-26,9,Primaria 3°,TopKids,223,23,200
2025-08-26,9,Primaria 3°,SuperSchool,59,22,37
2025-08-26,9,Primaria 3°,EduMax,254,21,233
2025-08-26,9,Primaria 3°,TopKids,167,15,152
2025-08-26,9,Primaria 3°,EduMax,299,15,284
2025-08-26,9,Primaria 3°,TopKids,130,20,110
2025-08-26,9,Primaria 3°,EduMax,55,15,40
2025-08-26,9,Primaria 3°,SuperSchool,194,24,170
2025-08-26,9,Primaria 4°,EduMax,250,12,238
2025-08-26,9,Primaria 4°,EduMax,107,23,84
2025-08-26,9,Primaria 4°,SuperSchool,127,24,103
2025-08-26,9,Primaria 4°,EduMax,273,22,251
2025-08-26,9,Primaria 4°,SuperSchool,250,3,247
2025-08-26,9,Primaria 4°,SuperSchool,152,12,140
2025-08-26,9,Primaria 4°,SuperSchool,244,9,235
2025-08-26,9,Primaria 4°,EduMax,136,23,113
2025-08-26,9,Primaria 4°,TopKids,259,11,248
2025-08-26,9,Primaria 4°,EduMax,249,18,231
2025-08-26,9,Primaria 4°,SuperSchool,213,10,203
2025-08-26,9,Primaria 4°,TopKids,177,12,165
2025-08-26,9,Primaria 4°,TopKids,125,22,103
2025-08-26,9,Primaria 4°,EduMax,105,8,97
2025-08-26,9,Primaria 5°,SuperSchool,146,3,143
2025-08-26,9,Primaria 5°,EduMax,240,2,238
2025-08-26,9,Primaria 5°,TopKids,104,20,84
2025-08-26,9,Primaria 5°,TopKids,143,21,122
2025-08-26,9,Primaria 5°,EduMax,206,15,191
2025-08-26,9,Primaria 5°,EduMax,275,17,258
2025-08-26,9,Primaria 5°,TopKids,201,6,195
2025-08-26,9,Primaria 5°,SuperSchool,111,4,107
2025-08-26,9,Primaria 5°,TopKids,56,23,33
2025-08-26,9,Primaria 5°,EduMax,95,14,81
2025-08-26,9,Primaria 5°,EduMax,77,24,53
2025-08-26,9,Primaria 5°,TopKids,161,4,157
2025-08-26,9,Primaria 5°,TopKids,128,17,111
2025-08-26,9,Primaria 5°,TopKids,289,2,287
2025-08-26,9,Primaria 5°,TopKids,170,16,154
2025-08-26,9,Primaria 5°,SuperSchool,186,12,174
2025-08-26,9,Primaria 6°,SuperSchool,255,11,244
2025-08-26,9,Primaria 6°,EduMax,167,5,162
2025-08-26,9,Primaria 6°,TopKids,172,7,165
2025-08-26,9,Primaria 6°,SuperSchool,191,20,171
2025-08-26,9,Primaria 6°,TopKids,157,18,139
2025-08-26,9,Primaria 6°,TopKids,60,24,36
2025-08-26,9,Primaria 6°,TopKids,93,19,74
2025-08-26,9,Primaria 6°,SuperSchool,174,6,168
2025-08-26,9,Primaria 6°,SuperSchool,57,15,42
2025-08-26,9,Primaria 6°,EduMax,293,10,283
2025-08-26,9,Primaria 6°,TopKids,189,11,178
2025-08-26,9,Primaria 6°,EduMax,169,5,164
2025-08-26,9,Primaria 6°,TopKids,265,5,260
2025-08-26,9,Primaria 6°,EduMax,142,10,132
2025-08-26,9,Primaria 6°,EduMax,129,5,124
2025-08-26,9,Primaria 6°,TopKids,164,8,156
2025-08-26,9,Primaria 6°,TopKids,101,22,79
2025-08-26,10,Preescolar,EduMax,81,23,58
2025-08-26,10,Preescolar,SuperSchool,189,13,176
2025-08-26,10,Preescolar,SuperSchool,198,18,180
2025-08-26,10,Preescolar,TopKids,78,15,63
2025-08-26,10,Preescolar,TopKids,189,9,180
2025-08-26,10,Preescolar,TopKids,189,23,166
2025-08-26,10,Kínder,EduMax,203,21,182
2025-08-26,10,Kínder,TopKids,101,10,91
2025-08-26,10,Kínder,EduMax,216,23,193
2025-08-26,10,Kínder,TopKids,269,8,261
2025-08-26,10,Kínder,SuperSchool,177,7,170
2025-08-26,10,Kínder,EduMax,224,20,204
2025-08-26,10,Kínder,TopKids,282,16,266
2025-08-26,10,Kínder,SuperSchool,276,21,255
2025-08-26,10,Kínder,SuperSchool,126,8,118
2025-08-26,10,Primaria 1°,SuperSchool,151,2,149
2025-08-26,10,Primaria 1°,EduMax,208,22,186
2025-08-26,10,Primaria 1°,EduMax,266,4,262
2025-08-26,10,Primaria 1°,TopKids,90,18,72
2025-08-26,10,Primaria 1°,SuperSchool,236,18,218
2025-08-26,10,Primaria 2°,SuperSchool,108,14,94
2025-08-26,10,Primaria 2°,TopKids,155,3,152
2025-08-26,10,Primaria 2°,SuperSchool,56,18,38
2025-08-26,10,Primaria 2°,SuperSchool,170,6,164
2025-08-26,10,Primaria 2°,SuperSchool,221,19,202
2025-08-26,10,Primaria 2°,TopKids,171,3,168
2025-08-26,10,Primaria 2°,EduMax,78,11,67
2025-08-26,10,Primaria 2°,EduMax,132,5,127
2025-08-26,10,Primaria 2°,SuperSchool,204,5,199
2025-08-26,10,Primaria 2°,EduMax,212,19,193
2025-08-26,10,Primaria 2°,SuperSchool,295,3,292
2025-08-26,10,Primaria 2°,TopKids,162,13,149
2025-08-26,10,Primaria 2°,EduMax,207,16,191
2025-08-26,10,Primaria 2°,SuperSchool,284,17,267
2025-08-26,10,Primaria 2°,SuperSchool,294,15,279
2025-08-26,10,Primaria 2°,EduMax,161,14,147
2025-08-26,10,Primaria 2°,EduMax,222,1,221
2025-08-26,10,Primaria 2°,EduMax,240,23,217
2025-08-26,10,Primaria 3°,TopKids,298,16,282
2025-08-26,10,Primaria 3°,EduMax,116,17,99
2025-08-26,10,Primaria 3°,SuperSchool,135,14,121
2025-08-26,10,Primaria 3°,EduMax,211,9,202
2025-08-26,10,Primaria 3°,SuperSchool,252,7,245
2025-08-26,10,Primaria 3°,EduMax,167,2,165
2025-08-26,10,Primaria 3°,EduMax,245,23,222
2025-08-26,10,Primaria 3°,EduMax,254,22,232
2025-08-26,10,Primaria 3°,SuperSchool,254,13,241
2025-08-26,10,Primaria 3°,SuperSchool,173,12,161
2025-08-26,10,Primaria 3°,EduMax,75,22,53
2025-08-26,10,Primaria 3°,EduMax,185,24,161
2025-08-26,10,Primaria 3°,EduMax,281,7,274
2025-08-26,10,Primaria 3°,SuperSchool,134,11,123
2025-08-26,10,Primaria 3°,TopKids,75,10,65
2025-08-26,10,Primaria 4°,EduMax,166,14,152
2025-08-26,10,Primaria 4°,SuperSchool,248,7,241
2025-08-26,10,Primaria 4°,EduMax,208,18,190
2025-08-26,10,Primaria 4°,TopKids,192,15,177
2025-08-26,10,Primaria 4°,EduMax,154,15,139
2025-08-26,10,Primaria 4°,SuperSchool,120,8,112
2025-08-26,10,Primaria 4°,EduMax,198,16,182
2025-08-26,10,Primaria 4°,TopKids,116,1,115
2025-08-26,10,Primaria 4°,SuperSchool,167,12,155
2025-08-26,10,Primaria 4°,TopKids,90,2,88
2025-08-26,10,Primaria 4°,SuperSchool,185,5,180
2025-08-26,10,Primaria 4°,SuperSchool,179,10,169
2025-08-26,10,Primaria 4°,EduMax,215,7,208
2025-08-26,10,Primaria 4°,TopKids,223,16,207
2025-08-26,10,Primaria 4°,EduMax,199,8,191
2025-08-26,10,Primaria 4°,SuperSchool,293,15,278
2025-08-26,10,Primaria 4°,SuperSchool,169,18,151
2025-08-26,10,Primaria 5°,TopKids,297,6,291
2025-08-26,10,Primaria 5°,SuperSchool,232,13,219
2025-08-26,10,Primaria 5°,TopKids,167,17,150
2025-08-26,10,Primaria 5°,SuperSchool,65,17,48
2025-08-26,10,Primaria 5°,SuperSchool,161,6,155
2025-08-26,10,Primaria 5°,SuperSchool,115,15,100
2025-08-26,10,Primaria 5°,SuperSchool,201,20,181
2025-08-26,10,Primaria 5°,TopKids,111,21,90
2025-08-26,10,Primaria 5°,EduMax,86,3,83
2025-08-26,10,Primaria 5°,EduMax,230,15,215
2025-08-26,10,Primaria 5°,EduMax,287,10,277
2025-08-26,10,Primaria 5°,EduMax,53,11,42
2025-08-26,10,Primaria 6°,TopKids,128,23,105
2025-08-26,10,Primaria 6°,SuperSchool,64,12,52
2025-08-26,10,Primaria 6°,EduMax,247,18,229
2025-08-26,10,Primaria 6°,SuperSchool,291,22,269
2025-08-26,10,Primaria 6°,EduMax,205,15,190
2025-08-26,10,Primaria 6°,TopKids,118,4,114
2025-08-26,10,Primaria 6°,SuperSchool,294,10,284
2025-08-26,10,Primaria 6°,SuperSchool,184,12,172
2025-08-26,11,Preescolar,EduMax,143,20,123
2025-08-26,11,Preescolar,SuperSchool,286,5,281
2025-08-26,11,Preescolar,SuperSchool,197,12,185
2025-08-26,11,Preescolar,TopKids,119,10,109
2025-08-26,11,Preescolar,TopKids,129,2,127
2025-08-26,11,Preescolar,TopKids,149,9,140
2025-08-26,11,Preescolar,EduMax,182,1,181
2025-08-26,11,Preescolar,TopKids,196,23,173
2025-08-26,11,Preescolar,TopKids,178,4,174
2025-08-26,11,Preescolar,SuperSchool,269,16,253
2025-08-26,11,Preescolar,TopKids,182,13,169
2025-08-26,11,Kínder,EduMax,71,17,54
2025-08-26,11,Kínder,TopKids,241,12,229
2025-08-26,11,Kínder,SuperSchool,104,21,83
2025-08-26,11,Kínder,SuperSchool,68,5,63
2025-08-26,11,Kínder,EduMax,249,2,247
2025-08-26,11,Kínder,TopKids,226,2,224
2025-08-26,11,Kínder,TopKids,200,3,197
2025-08-26,11,Kínder,EduMax,299,24,275
2025-08-26,11,Kínder,EduMax,195,15,180
2025-08-26,11,Kínder,SuperSchool,231,17,214
2025-08-26,11,Kínder,TopKids,127,1,126
2025-08-26,11,Kínder,EduMax,154,5,149
2025-08-26,11,Kínder,TopKids,272,4,268
2025-08-26,11,Kínder,EduMax,178,3,175
2025-08-26,11,Kínder,SuperSchool,69,11,58
2025-08-26,11,Primaria 1°,SuperSchool,143,10,133
2025-08-26,11,Primaria 1°,EduMax,246,10,236
2025-08-26,11,Primaria 1°,SuperSchool,164,7,157
2025-08-26,11,Primaria 1°,EduMax,225,6,219
2025-08-26,11,Primaria 1°,EduMax,172,10,162
2025-08-26,11,Primaria 1°,EduMax,220,22,198
2025-08-26,11,Primaria 1°,EduMax,138,14,124
2025-08-26,11,Primaria 1°,TopKids,88,13,75
2025-08-26,11,Primaria 1°,TopKids,216,11,205
2025-08-26,11,Primaria 1°,EduMax,290,16,274
2025-08-26,11,Primaria 1°,SuperSchool,282,9,273
2025-08-26,11,Primaria 1°,TopKids,251,19,232
2025-08-26,11,Primaria 1°,TopKids,257,11,246
2025-08-26,11,Primaria 1°,TopKids,105,17,88
2025-08-26,11,Primaria 1°,EduMax,164,13,151
2025-08-26,11,Primaria 2°,TopKids,161,4,157
2025-08-26,11,Primaria 2°,TopKids,266,7,259
2025-08-26,11,Primaria 2°,TopKids,130,16,114
2025-08-26,11,Primaria 2°,EduMax,179,17,162
2025-08-26,11,Primaria 2°,SuperSchool,53,14,39
2025-08-26,11,Primaria 2°,SuperSchool,182,5,177
2025-08-26,11,Primaria 2°,TopKids,118,3,115
2025-08-26,11,Primaria 2°,EduMax,143,1,142
2025-08-26,11,Primaria 2°,SuperSchool,261,6,255
2025-08-26,11,Primaria 2°,EduMax,227,16,211
2025-08-26,11,Primaria 3°,EduMax,162,8,154
2025-08-26,11,Primaria 3°,TopKids,171,10,161
2025-08-26,11,Primaria 3°,TopKids,210,9,201
2025-08-26,11,Primaria 3°,SuperSchool,101,1,100
2025-08-26,11,Primaria 3°,SuperSchool,255,24,231
2025-08-26,11,Primaria 3°,SuperSchool,247,5,242
2025-08-26,11,Primaria 3°,EduMax,80,14,66
2025-08-26,11,Primaria 3°,SuperSchool,109,4,105
2025-08-26,11,Primaria 3°,EduMax,75,24,51
2025-08-26,11,Primaria 3°,SuperSchool,84,10,74
2025-08-26,11,Primaria 3°,TopKids,73,19,54
2025-08-26,11,Primaria 3°,EduMax,243,9,234
2025-08-26,11,Primaria 4°,SuperSchool,83,7,76
2025-08-26,11,Primaria 4°,TopKids,279,23,256
2025-08-26,11,Primaria 4°,EduMax,221,6,215
2025-08-26,11,Primaria 4°,EduMax,108,22,86
2025-08-26,11,Primaria 4°,SuperSchool,160,24,136
2025-08-26,11,Primaria 4°,EduMax,89,21,68
2025-08-26,11,Primaria 4°,EduMax,293,11,282
2025-08-26,11,Primaria 4°,SuperSchool,58,12,46
2025-08-26,11,Primaria 5°,EduMax,292,3,289
2025-08-26,11,Primaria 5°,EduMax,274,15,259
2025-08-26,11,Primaria 5°,TopKids,182,22,160
2025-08-26,11,Primaria 5°,TopKids,170,23,147
2025-08-26,11,Primaria 5°,SuperSchool,264,10,254
2025-08-26,11,Primaria 5°,SuperSchool,229,11,218
2025-08-26,11,Primaria 5°,TopKids,170,17,153
2025-08-26,11,Primaria 5°,EduMax,266,4,262
2025-08-26,11,Primaria 5°,TopKids,99,12,87
2025-08-26,11,Primaria 5°,TopKids,254,16,238
2025-08-26,11,Primaria 5°,TopKids,172,6,166
2025-08-26,11,Primaria 5°,EduMax,234,10,224
2025-08-26,11,Primaria 5°,SuperSchool,215,8,207
2025-08-26,11,Primaria 5°,EduMax,273,17,256
2025-08-26,11,Primaria 6°,EduMax,115,12,103
2025-08-26,11,Primaria 6°,EduMax,58,16,42
2025-08-26,11,Primaria 6°,TopKids,154,24,130
2025-08-26,11,Primaria 6°,EduMax,207,10,197
2025-08-26,11,Primaria 6°,TopKids,272,18,254
2025-08-26,11,Primaria 6°,TopKids,82,21,61
2025-08-26,11,Primaria 6°,TopKids,136,5,131
2025-08-26,11,Primaria 6°,EduMax,206,24,182
2025-08-26,11,Primaria 6°,EduMax,231,7,224
2025-08-26,11,Primaria 6°,TopKids,53,16,37
2025-08-26,11,Primaria 6°,EduMax,75,15,60
2025-08-26,11,Primaria 6°,SuperSchool,217,22,195
2025-08-26,11,Primaria 6°,TopKids,254,24,230
2025-08-26,11,Primaria 6°,TopKids,130,4,126
2025-08-26,12,Preescolar,SuperSchool,211,21,190
2025-08-26,12,Preescolar,SuperSchool,138,22,116
2025-08-26,12,Preescolar,TopKids,202,14,188
2025-08-26,12,Preescolar,EduMax,203,8,195
2025-08-26,12,Preescolar,EduMax,267,6,261
2025-08-26,12,Preescolar,EduMax,280,7,273
2025-08-26,12,Preescolar,EduMax,266,4,262
2025-08-26,12,Preescolar,SuperSchool,270,10,260
2025-08-26,12,Preescolar,SuperSchool,192,12,180
2025-08-26,12,Preescolar,TopKids,144,10,134
2025-08-26,12,Preescolar,TopKids,166,5,161
2025-08-26,12,Kínder,TopKids,225,13,212
2025-08-26,12,Kínder,SuperSchool,144,1,143
2025-08-26,12,Kínder,EduMax,181,15,166
2025-08-26,12,Kínder,EduMax,267,21,246
2025-08-26,12,Kínder,EduMax,208,16,192
2025-08-26,12,Kínder,SuperSchool,208,11,197
2025-08-26,12,Kínder,SuperSchool,150,13,137
2025-08-26,12,Kínder,SuperSchool,108,23,85
2025-08-26,12,Kínder,TopKids,117,10,107
2025-08-26,12,Kínder,SuperSchool,91,13,78
2025-08-26,12,Kínder,SuperSchool,253,11,242
2025-08-26,12,Primaria 1°,EduMax,296,14,282
2025-08-26,12,Primaria 1°,EduMax,165,23,142
2025-08-26,12,Primaria 1°,SuperSchool,199,19,180
2025-08-26,12,Primaria 1°,SuperSchool,166,17,149
2025-08-26,12,Primaria 1°,EduMax,191,18,173
2025-08-26,12,Primaria 1°,SuperSchool,87,5,82
2025-08-26,12,Primaria 1°,SuperSchool,161,21,140
2025-08-26,12,Primaria 1°,SuperSchool,221,10,211
2025-08-26,12,Primaria 1°,EduMax,126,19,107
2025-08-26,12,Primaria 2°,EduMax,209,14,195
2025-08-26,12,Primaria 2°,TopKids,125,5,120
2025-08-26,12,Primaria 2°,TopKids,246,24,222
2025-08-26,12,Primaria 2°,TopKids,275,19,256
2025-08-26,12,Primaria 2°,EduMax,75,17,58
2025-08-26,12,Primaria 3°,TopKids,93,20,73
2025-08-26,12,Primaria 3°,TopKids,200,5,195
2025-08-26,12,Primaria 3°,SuperSchool,51,10,41
2025-08-26,12,Primaria 3°,EduMax,81,10,71
2025-08-26,12,Primaria 3°,TopKids,227,1,226
2025-08-26,12,Primaria 3°,SuperSchool,253,17,236
2025-08-26,12,Primaria 3°,SuperSchool,164,18,146
2025-08-26,12,Primaria 3°,EduMax,190,22,168
2025-08-26,12,Primaria 3°,TopKids,262,10,252
2025-08-26,12,Primaria 3°,EduMax,89,10,79
2025-08-26,12,Primaria 3°,EduMax,109,13,96
2025-08-26,12,Primaria 3°,SuperSchool,60,24,36
2025-08-26,12,Primaria 3°,SuperSchool,203,10,193
2025-08-26,12,Primaria 3°,EduMax,172,13,159
2025-08-26,12,Primaria 3°,SuperSchool,111,10,101
2025-08-26,12,Primaria 3°,EduMax,204,3,201
2025-08-26,12,Primaria 3°,EduMax,205,19,186
2025-08-26,12,Primaria 3°,TopKids,156,21,135
2025-08-26,12,Primaria 3°,TopKids,291,14,277
2025-08-26,12,Primaria 4°,EduMax,175,7,168
2025-08-26,12,Primaria 4°,TopKids,122,23,99
2025-08-26,12,Primaria 4°,EduMax,61,6,55
2025-08-26,12,Primaria 4°,EduMax,233,7,226
2025-08-26,12,Primaria 4°,EduMax,53,16,37
2025-08-26,12,Primaria 4°,TopKids,109,8,101
2025-08-26,12,Primaria 4°,EduMax,234,3,231
2025-08-26,12,Primaria 4°,SuperSchool,164,13,151
2025-08-26,12,Primaria 4°,TopKids,133,21,112
2025-08-26,12,Primaria 4°,SuperSchool,96,19,77
2025-08-26,12,Primaria 4°,EduMax,93,8,85
2025-08-26,12,Primaria 5°,TopKids,177,23,154
2025-08-26,12,Primaria 5°,SuperSchool,146,24,122
2025-08-26,12,Primaria 5°,EduMax,77,21,56
2025-08-26,12,Primaria 5°,SuperSchool,142,2,140
2025-08-26,12,Primaria 5°,TopKids,199,14,185
2025-08-26,12,Primaria 5°,EduMax,123,8,115
2025-08-26,12,Primaria 5°,EduMax,94,6,88
2025-08-26,12,Primaria 5°,SuperSchool,111,13,98
2025-08-26,12,Primaria 5°,TopKids,261,13,248
2025-08-26,12,Primaria 5°,TopKids,136,19,117
2025-08-26,12,Primaria 5°,TopKids,96,15,81
2025-08-26,12,Primaria 5°,EduMax,103,7,96
2025-08-26,12,Primaria 5°,SuperSchool,121,23,98
2025-08-26,12,Primaria 5°,EduMax,207,1,206
2025-08-26,12,Primaria 5°,TopKids,212,21,191
2025-08-26,12,Primaria 5°,TopKids,96,17,79
2025-08-26,12,Primaria 5°,EduMax,57,23,34
2025-08-26,12,Primaria 5°,SuperSchool,219,3,216
2025-08-26,12,Primaria 6°,EduMax,222,3,219
2025-08-26,12,Primaria 6°,SuperSchool,197,24,173
2025-08-26,12,Primaria 6°,SuperSchool,104,9,95
2025-08-26,12,Primaria 6°,EduMax,266,16,250
2025-08-26,12,Primaria 6°,TopKids,232,8,224
2025-08-26,12,Primaria 6°,EduMax,113,12,101
2025-08-26,12,Primaria 6°,TopKids,265,17,248
2025-08-26,12,Primaria 6°,SuperSchool,256,22,234
2025-08-26,13,Preescolar,TopKids,126,19,107
2025-08-26,13,Preescolar,TopKids,171,5,166
2025-08-26,13,Preescolar,EduMax,51,1,50
2025-08-26,13,Preescolar,SuperSchool,138,7,131
2025-08-26,13,Preescolar,EduMax,90,4,86
2025-08-26,13,Preescolar,TopKids,268,20,248
2025-08-26,13,Kínder,TopKids,73,18,55
2025-08-26,13,Kínder,SuperSchool,230,13,217
2025-08-26,13,Kínder,TopKids,141,6,135
2025-08-26,13,Kínder,TopKids,107,12,95
2025-08-26,13,Kínder,SuperSchool,163,18,145
2025-08-26,13,Kínder,TopKids,264,14,250
2025-08-26,13,Kínder,EduMax,178,11,167
2025-08-26,13,Kínder,EduMax,108,9,99
2025-08-26,13,Kínder,EduMax,237,5,232
2025-08-26,13,Kínder,EduMax,128,10,118
2025-08-26,13,Kínder,EduMax,151,23,128
2025-08-26,13,Kínder,TopKids,173,13,160
2025-08-26,13,Kínder,TopKids,220,2,218
2025-08-26,13,Kínder,TopKids,224,24,200
2025-08-26,13,Kínder,SuperSchool,298,10,288
2025-08-26,13,Kínder,SuperSchool,177,24,153
2025-08-26,13,Kínder,EduMax,252,23,229
2025-08-26,13,Kínder,EduMax,205,20,185
2025-08-26,13,Kínder,TopKids,222,3,219
2025-08-26,13,Primaria 1°,TopKids,296,1,295
2025-08-26,13,Primaria 1°,EduMax,122,21,101
2025-08-26,13,Primaria 1°,SuperSchool,218,1,217
2025-08-26,13,Primaria 1°,SuperSchool,271,11,260
2025-08-26,13,Primaria 1°,EduMax,130,18,112
2025-08-26,13,Primaria 1°,TopKids,195,5,190
2025-08-26,13,Primaria 1°,TopKids,74,5,69
2025-08-26,13,Primaria 1°,TopKids,76,13,63
2025-08-26,13,Primaria 1°,EduMax,184,14,170
2025-08-26,13,Primaria 1°,TopKids,171,8,163
2025-08-26,13,Primaria 1°,TopKids,276,4,272
2025-08-26,13,Primaria 1°,EduMax,53,18,35
2025-08-26,13,Primaria 1°,TopKids,136,12,124
2025-08-26,13,Primaria 2°,TopKids,240,13,227
2025-08-26,13,Primaria 2°,EduMax,71,9,62
2025-08-26,13,Primaria 2°,SuperSchool,130,1,129
2025-08-26,13,Primaria 2°,TopKids,104,6,98
2025-08-26,13,Primaria 2°,TopKids,58,10,48
2025-08-26,13,Primaria 2°,SuperSchool,244,9,235
2025-08-26,13,Primaria 2°,SuperSchool,66,14,52
2025-08-26,13,Primaria 2°,SuperSchool,75,21,54
2025-08-26,13,Primaria 3°,SuperSchool,84,9,75
2025-08-26,13,Primaria 3°,TopKids,87,9,78
2025-08-26,13,Primaria 3°,TopKids,278,5,273
2025-08-26,13,Primaria 3°,EduMax,155,23,132
2025-08-26,13,Primaria 3°,TopKids,240,6,234
2025-08-26,13,Primaria 4°,TopKids,95,18,77
2025-08-26,13,Primaria 4°,SuperSchool,269,9,260
2025-08-26,13,Primaria 4°,TopKids,99,10,89
2025-08-26,13,Primaria 4°,EduMax,254,6,248
2025-08-26,13,Primaria 4°,TopKids,296,9,287
2025-08-26,13,Primaria 4°,TopKids,197,8,189
2025-08-26,13,Primaria 4°,EduMax,251,16,235
2025-08-26,13,Primaria 4°,TopKids,62,18,44
2025-08-26,13,Primaria 5°,SuperSchool,227,7,220
2025-08-26,13,Primaria 5°,TopKids,137,5,132
2025-08-26,13,Primaria 5°,TopKids,286,3,283
2025-08-26,13,Primaria 5°,SuperSchool,149,19,130
2025-08-26,13,Primaria 5°,EduMax,247,23,224
2025-08-26,13,Primaria 5°,EduMax,184,12,172
2025-08-26,13,Primaria 5°,SuperSchool,143,18,125
2025-08-26,13,Primaria 5°,EduMax,252,10,242
2025-08-26,13,Primaria 5°,SuperSchool,87,13,74
2025-08-26,13,Primaria 5°,EduMax,155,12,143
2025-08-26,13,Primaria 6°,EduMax,190,24,166
2025-08-26,13,Primaria 6°,SuperSchool,277,6,271
2025-08-26,13,Primaria 6°,EduMax,141,5,136
2025-08-26,13,Primaria 6°,EduMax,240,5,235
2025-08-26,13,Primaria 6°,TopKids,232,9,223
2025-08-26,14,Preescolar,SuperSchool,95,8,87
2025-08-26,14,Preescolar,TopKids,201,9,192
2025-08-26,14,Preescolar,SuperSchool,186,7,179
2025-08-26,14,Preescolar,EduMax,165,22,143
2025-08-26,14,Preescolar,TopKids,194,1,193
2025-08-26,14,Preescolar,SuperSchool,224,24,200
2025-08-26,14,Preescolar,TopKids,270,1,269
2025-08-26,14,Kínder,TopKids,76,2,74
2025-08-26,14,Kínder,SuperSchool,245,17,228
2025-08-26,14,Kínder,EduMax,262,16,246
2025-08-26,14,Kínder,EduMax,240,22,218
2025-08-26,14,Kínder,EduMax,292,13,279
2025-08-26,14,Kínder,EduMax,167,21,146
2025-08-26,14,Kínder,EduMax,172,6,166
2025-08-26,14,Kínder,SuperSchool,50,22,28
2025-08-26,14,Kínder,SuperSchool,201,9,192
2025-08-26,14,Kínder,EduMax,199,12,187
2025-08-26,14,Kínder,EduMax,181,19,162
2025-08-26,14,Kínder,EduMax,177,12,165
2025-08-26,14,Kínder,SuperSchool,296,21,275
2025-08-26,14,Kínder,SuperSchool,280,10,270
2025-08-26,14,Kínder,SuperSchool,121,20,101
2025-08-26,14,Kínder,EduMax,145,10,135
2025-08-26,14,Kínder,TopKids,274,15,259
2025-08-26,14,Primaria 1°,SuperSchool,62,12,50
2025-08-26,14,Primaria 1°,TopKids,168,19,149
2025-08-26,14,Primaria 1°,SuperSchool,105,5,100
2025-08-26,14,Primaria 1°,TopKids,102,5,97
2025-08-26,14,Primaria 1°,SuperSchool,183,16,167
2025-08-26,14,Primaria 1°,EduMax,129,3,126
2025-08-26,14,Primaria 1°,EduMax,60,19,41
2025-08-26,14,Primaria 1°,SuperSchool,72,15,57
2025-08-26,14,Primaria 1°,TopKids,236,22,214
2025-08-26,14,Primaria 1°,EduMax,204,9,195
2025-08-26,14,Primaria 1°,TopKids,232,9,223
2025-08-26,14,Primaria 1°,EduMax,93,23,70
2025-08-26,14,Primaria 2°,SuperSchool,204,13,191
2025-08-26,14,Primaria 2°,TopKids,107,8,99
2025-08-26,14,Primaria 2°,TopKids,87,8,79
2025-08-26,14,Primaria 2°,TopKids,137,24,113
2025-08-26,14,Primaria 2°,SuperSchool,149,23,126
2025-08-26,14,Primaria 2°,SuperSchool,207,17,190
2025-08-26,14,Primaria 2°,TopKids,164,22,142
2025-08-26,14,Primaria 2°,SuperSchool,124,7,117
2025-08-26,14,Primaria 2°,TopKids,188,17,171
2025-08-26,14,Primaria 3°,TopKids,164,8,156
2025-08-26,14,Primaria 3°,SuperSchool,96,3,93
2025-08-26,14,Primaria 3°,EduMax,265,6,259
2025-08-26,14,Primaria 3°,TopKids,116,5,111
2025-08-26,14,Primaria 3°,SuperSchool,199,14,185
2025-08-26,14,Primaria 3°,SuperSchool,63,12,51
2025-08-26,14,Primaria 3°,TopKids,240,13,227
2025-08-26,14,Primaria 3°,EduMax,166,15,151
2025-08-26,14,Primaria 3°,EduMax,232,16,216
2025-08-26,14,Primaria 3°,SuperSchool,249,5,244
2025-08-26,14,Primaria 3°,TopKids,248,24,224
2025-08-26,14,Primaria 3°,SuperSchool,65,24,41
2025-08-26,14,Primaria 3°,TopKids,184,11,173
2025-08-26,14,Primaria 3°,EduMax,147,6,141
2025-08-26,14,Primaria 3°,TopKids,178,24,154
2025-08-26,14,Primaria 4°,EduMax,81,17,64
2025-08-26,14,Primaria 4°,EduMax,298,4,294
2025-08-26,14,Primaria 4°,TopKids,153,4,149
2025-08-26,14,Primaria 4°,TopKids,256,13,243
2025-08-26,14,Primaria 4°,EduMax,191,5,186
2025-08-26,14,Primaria 4°,SuperSchool,199,13,186
2025-08-26,14,Primaria 4°,EduMax,151,5,146
2025-08-26,14,Primaria 4°,TopKids,197,3,194
2025-08-26,14,Primaria 4°,TopKids,261,2,259
2025-08-26,14,Primaria 4°,EduMax,195,10,185
2025-08-26,14,Primaria 4°,EduMax,241,21,220
2025-08-26,14,Primaria 5°,TopKids,172,20,152
2025-08-26,14,Primaria 5°,EduMax,71,14,57
2025-08-26,14,Primaria 5°,EduMax,133,16,117
2025-08-26,14,Primaria 5°,EduMax,130,6,124
2025-08-26,14,Primaria 5°,EduMax,131,10,121
2025-08-26,14,Primaria 5°,EduMax,90,22,68
2025-08-26,14,Primaria 5°,TopKids,284,7,277
2025-08-26,14,Primaria 5°,EduMax,83,2,81
2025-08-26,14,Primaria 5°,EduMax,158,11,147
2025-08-26,14,Primaria 5°,SuperSchool,68,20,48
2025-08-26,14,Primaria 5°,SuperSchool,258,20,238
2025-08-26,14,Primaria 5°,EduMax,131,8,123
2025-08-26,14,Primaria 5°,SuperSchool,53,19,34
2025-08-26,14,Primaria 5°,TopKids,279,6,273
2025-08-26,14,Primaria 5°,EduMax,183,24,159
2025-08-26,14,Primaria 5°,SuperSchool,130,10,120
2025-08-26,14,Primaria 5°,SuperSchool,132,11,121
2025-08-26,14,Primaria 6°,TopKids,263,24,239
2025-08-26,14,Primaria 6°,EduMax,179,9,170
2025-08-26,14,Primaria 6°,SuperSchool,166,17,149
2025-08-26,14,Primaria 6°,EduMax,156,5,151
2025-08-26,14,Primaria 6°,TopKids,184,4,180
2025-08-26,14,Primaria 6°,SuperSchool,283,24,259
2025-08-26,14,Primaria 6°,EduMax,146,14,132
2025-08-26,14,Primaria 6°,EduMax,252,14,238
2025-08-26,14,Primaria 6°,SuperSchool,235,3,232
2025-08-26,14,Primaria 6°,TopKids,89,4,85
2025-08-26,14,Primaria 6°,TopKids,219,12,207
2025-08-26,14,Primaria 6°,TopKids,92,15,77
2025-08-26,14,Primaria 6°,EduMax,142,11,131
2025-08-26,14,Primaria 6°,TopKids,243,24,219
2025-08-26,15,Preescolar,TopKids,58,11,47
2025-08-26,15,Preescolar,SuperSchool,254,22,232
2025-08-26,15,Preescolar,EduMax,67,21,46
2025-08-26,15,Preescolar,SuperSchool,146,20,126
2025-08-26,15,Preescolar,EduMax,235,19,216
2025-08-26,15,Preescolar,SuperSchool,50,1,49
2025-08-26,15,Preescolar,SuperSchool,128,2,126
2025-08-26,15,Preescolar,TopKids,230,2,228
2025-08-26,15,Preescolar,SuperSchool,68,2,66
2025-08-26,15,Preescolar,SuperSchool,229,21,208
2025-08-26,15,Kínder,SuperSchool,297,13,284
2025-08-26,15,Kínder,TopKids,197,2,195
2025-08-26,15,Kínder,EduMax,138,24,114
2025-08-26,15,Kínder,SuperSchool,261,1,260
2025-08-26,15,Kínder,TopKids,232,17,215
2025-08-26,15,Kínder,TopKids,73,8,65
2025-08-26,15,Kínder,SuperSchool,253,11,242
2025-08-26,15,Kínder,EduMax,109,13,96
2025-08-26,15,Primaria 1°,SuperSchool,293,17,276
2025-08-26,15,Primaria 1°,TopKids,292,20,272
2025-08-26,15,Primaria 1°,TopKids,59,17,42
2025-08-26,15,Primaria 1°,EduMax,158,16,142
2025-08-26,15,Primaria 1°,TopKids,293,20,273
2025-08-26,15,Primaria 1°,SuperSchool,54,9,45
2025-08-26,15,Primaria 1°,EduMax,112,24,88
2025-08-26,15,Primaria 1°,TopKids,117,9,108
2025-08-26,15,Primaria 1°,TopKids,223,14,209
2025-08-26,15,Primaria 1°,TopKids,265,16,249
2025-08-26,15,Primaria 1°,EduMax,215,7,208
2025-08-26,15,Primaria 1°,TopKids,281,1,280
2025-08-26,15,Primaria 1°,SuperSchool,139,19,120
2025-08-26,15,Primaria 1°,EduMax,152,18,134
2025-08-26,15,Primaria 1°,EduMax,87,21,66
2025-08-26,15,Primaria 1°,TopKids,279,1,278
2025-08-26,15,Primaria 1°,EduMax,219,23,196
2025-08-26,15,Primaria 1°,EduMax,280,9,271
2025-08-26,15,Primaria 1°,SuperSchool,299,11,288
2025-08-26,15,Primaria 2°,SuperSchool,144,3,141
2025-08-26,15,Primaria 2°,EduMax,279,11,268
2025-08-26,15,Primaria 2°,SuperSchool,144,20,124
2025-08-26,15,Primaria 2°,EduMax,212,13,199
2025-08-26,15,Primaria 2°,SuperSchool,182,8,174
2025-08-26,15,Primaria 2°,TopKids,131,1,130
2025-08-26,15,Primaria 2°,SuperSchool,53,18,35
2025-08-26,15,Primaria 2°,EduMax,201,11,190
2025-08-26,15,Primaria 2°,SuperSchool,80,9,71
2025-08-26,15,Primaria 2°,SuperSchool,139,17,122
2025-08-26,15,Primaria 2°,TopKids,51,6,45
2025-08-26,15,Primaria 2°,SuperSchool,203,7,196
2025-08-26,15,Primaria 2°,EduMax,233,13,220
2025-08-26,15,Primaria 2°,EduMax,161,9,152
2025-08-26,15,Primaria 2°,SuperSchool,224,22,202
2025-08-26,15,Primaria 3°,TopKids,199,23,176
2025-08-26,15,Primaria 3°,TopKids,149,9,140
2025-08-26,15,Primaria 3°,TopKids,51,7,44
2025-08-26,15,Primaria 3°,EduMax,292,6,286
2025-08-26,15,Primaria 3°,TopKids,120,6,114
2025-08-26,15,Primaria 3°,SuperSchool,255,1,254
2025-08-26,15,Primaria 3°,SuperSchool,119,18,101
2025-08-26,15,Primaria 3°,TopKids,268,17,251
2025-08-26,15,Primaria 3°,TopKids,173,2,171
2025-08-26,15,Primaria 3°,SuperSchool,136,23,113
2025-08-26,15,Primaria 3°,EduMax,129,4,125
2025-08-26,15,Primaria 3°,EduMax,296,5,291
2025-08-26,15,Primaria 3°,SuperSchool,275,22,253
2025-08-26,15,Primaria 3°,EduMax,197,7,190
2025-08-26,15,Primaria 3°,TopKids,291,13,278
2025-08-26,15,Primaria 4°,EduMax,221,6,215
2025-08-26,15,Primaria 4°,SuperSchool,274,21,253
2025-08-26,15,Primaria 4°,SuperSchool,288,16,272
2025-08-26,15,Primaria 4°,EduMax,56,22,34
2025-08-26,15,Primaria 4°,EduMax,238,19,219
2025-08-26,15,Primaria 4°,TopKids,76,23,53
2025-08-26,15,Primaria 4°,EduMax,94,21,73
2025-08-26,15,Primaria 4°,SuperSchool,178,12,166
2025-08-26,15,Primaria 4°,EduMax,110,15,95
2025-08-26,15,Primaria 4°,SuperSchool,161,15,146
2025-08-26,15,Primaria 4°,TopKids,160,18,142
2025-08-26,15,Primaria 4°,TopKids,90,1,89
2025-08-26,15,Primaria 4°,SuperSchool,264,12,252
2025-08-26,15,Primaria 4°,EduMax,156,21,135
2025-08-26,15,Primaria 4°,EduMax,83,15,68
2025-08-26,15,Primaria 4°,SuperSchool,241,23,218
2025-08-26,15,Primaria 5°,EduMax,191,21,170
2025-08-26,15,Primaria 5°,EduMax,95,22,73
2025-08-26,15,Primaria 5°,TopKids,54,2,52
2025-08-26,15,Primaria 5°,EduMax,119,12,107
2025-08-26,15,Primaria 5°,EduMax,78,4,74
2025-08-26,15,Primaria 5°,TopKids,193,1,192
2025-08-26,15,Primaria 5°,SuperSchool,63,11,52
2025-08-26,15,Primaria 5°,TopKids,119,23,96
2025-08-26,15,Primaria 5°,SuperSchool,80,12,68
2025-08-26,15,Primaria 6°,TopKids,101,19,82
2025-08-26,15,Primaria 6°,TopKids,223,4,219
2025-08-26,15,Primaria 6°,SuperSchool,268,8,260
2025-08-26,15,Primaria 6°,SuperSchool,110,8,102
2025-08-26,15,Primaria 6°,SuperSchool,201,7,194
2025-08-26,15,Primaria 6°,SuperSchool,132,4,128
2025-08-26,15,Primaria 6°,TopKids,173,23,150
2025-08-26,15,Primaria 6°,EduMax,253,18,235
2025-08-26,15,Primaria 6°,EduMax,52,10,42
2025-08-26,15,Primaria 6°,TopKids,148,19,129
2025-08-26,15,Primaria 6°,SuperSchool,175,4,171
2025-08-26,15,Primaria 6°,TopKids,155,6,149
2025-08-26,15,Primaria 6°,SuperSchool,183,8,175
2025-08-26,15,Primaria 6°,TopKids,272,8,264
2025-08-26,16,Preescolar,EduMax,78,19,59
2025-08-26,16,Preescolar,EduMax,83,7,76
2025-08-26,16,Preescolar,EduMax,190,22,168
2025-08-26,16,Preescolar,SuperSchool,165,1,164
2025-08-26,16,Preescolar,SuperSchool,172,10,162
2025-08-26,16,Preescolar,EduMax,165,11,154
2025-08-26,16,Preescolar,SuperSchool,99,7,92
2025-08-26,16,Preescolar,TopKids,271,16,255
2025-08-26,16,Preescolar,TopKids,281,20,261
2025-08-26,16,Preescolar,TopKids,86,3,83
2025-08-26,16,Kínder,TopKids,150,9,141
2025-08-26,16,Kínder,TopKids,81,16,65
2025-08-26,16,Kínder,SuperSchool,95,18,77
2025-08-26,16,Kínder,TopKids,144,15,129
2025-08-26,16,Kínder,EduMax,89,3,86
2025-08-26,16,Kínder,TopKids,165,18,147
2025-08-26,16,Kínder,TopKids,59,3,56
2025-08-26,16,Kínder,TopKids,170,23,147
2025-08-26,16,Kínder,EduMax,124,11,113
2025-08-26,16,Kínder,TopKids,204,23,181
2025-08-26,16,Kínder,TopKids,172,3,169
2025-08-26,16,Kínder,SuperSchool,108,22,86
2025-08-26,16,Kínder,SuperSchool,92,11,81
2025-08-26,16,Kínder,SuperSchool,116,6,110
2025-08-26,16,Kínder,TopKids,201,10,191
2025-08-26,16,Kínder,TopKids,253,14,239
2025-08-26,16,Kínder,TopKids,76,21,55
2025-08-26,16,Primaria 1°,EduMax,143,10,133
2025-08-26,16,Primaria 1°,TopKids,254,18,236
2025-08-26,16,Primaria 1°,TopKids,222,24,198
2025-08-26,16,Primaria 1°,EduMax,175,14,161
2025-08-26,16,Primaria 1°,TopKids,221,4,217
2025-08-26,16,Primaria 1°,TopKids,123,16,107
2025-08-26,16,Primaria 1°,SuperSchool,268,16,252
2025-08-26,16,Primaria 1°,SuperSchool,246,13,233
2025-08-26,16,Primaria 1°,SuperSchool,180,17,163
2025-08-26,16,Primaria 1°,TopKids,214,5,209
2025-08-26,16,Primaria 1°,TopKids,283,12,271
2025-08-26,16,Primaria 1°,TopKids,210,23,187
2025-08-26,16,Primaria 1°,SuperSchool,244,4,240
2025-08-26,16,Primaria 2°,TopKids,195,3,192
2025-08-26,16,Primaria 2°,TopKids,103,21,82
2025-08-26,16,Primaria 2°,TopKids,114,19,95
2025-08-26,16,Primaria 2°,EduMax,275,12,263
2025-08-26,16,Primaria 2°,SuperSchool,262,21,241
2025-08-26,16,Primaria 2°,TopKids,157,12,145
2025-08-26,16,Primaria 2°,EduMax,239,10,229
2025-08-26,16,Primaria 3°,EduMax,299,6,293
2025-08-26,16,Primaria 3°,EduMax,275,11,264
2025-08-26,16,Primaria 3°,TopKids,171,8,163
2025-08-26,16,Primaria 3°,EduMax,190,19,171
2025-08-26,16,Primaria 3°,EduMax,90,18,72
2025-08-26,16,Primaria 3°,TopKids,180,12,168
2025-08-26,16,Primaria 3°,TopKids,231,21,210
2025-08-26,16,Primaria 3°,SuperSchool,215,8,207
2025-08-26,16,Primaria 3°,EduMax,148,16,132
2025-08-26,16,Primaria 3°,EduMax,201,17,184
2025-08-26,16,Primaria 3°,EduMax,91,17,74
2025-08-26,16,Primaria 3°,SuperSchool,265,2,263
2025-08-26,16,Primaria 3°,TopKids,268,7,261
2025-08-26,16,Primaria 3°,SuperSchool,202,19,183
2025-08-26,16,Primaria 3°,EduMax,91,21,70
2025-08-26,16,Primaria 3°,SuperSchool,236,1,235
2025-08-26,16,Primaria 3°,TopKids,267,21,246
2025-08-26,16,Primaria 3°,SuperSchool,265,5,260
2025-08-26,16,Primaria 4°,TopKids,155,7,148
2025-08-26,16,Primaria 4°,SuperSchool,143,7,136
2025-08-26,16,Primaria 4°,TopKids,258,23,235
2025-08-26,16,Primaria 4°,TopKids,212,5,207
2025-08-26,16,Primaria 4°,EduMax,118,24,94
2025-08-26,16,Primaria 4°,TopKids,248,22,226
2025-08-26,16,Primaria 4°,TopKids,191,23,168
2025-08-26,16,Primaria 4°,TopKids,54,5,49
2025-08-26,16,Primaria 4°,EduMax,261,21,240
2025-08-26,16,Primaria 4°,EduMax,122,12,110
2025-08-26,16,Primaria 5°,SuperSchool,157,20,137
2025-08-26,16,Primaria 5°,SuperSchool,120,21,99
2025-08-26,16,Primaria 5°,TopKids,148,1,147
2025-08-26,16,Primaria 5°,TopKids,122,2,120
2025-08-26,16,Primaria 5°,TopKids,219,2,217
2025-08-26,16,Primaria 5°,SuperSchool,206,3,203
2025-08-26,16,Primaria 5°,SuperSchool,251,12,239
2025-08-26,16,Primaria 5°,EduMax,148,20,128
2025-08-26,16,Primaria 5°,EduMax,52,2,50
2025-08-26,16,Primaria 5°,TopKids,199,14,185
2025-08-26,16,Primaria 6°,EduMax,204,19,185
2025-08-26,16,Primaria 6°,EduMax,251,20,231
2025-08-26,16,Primaria 6°,SuperSchool,226,19,207
2025-08-26,16,Primaria 6°,TopKids,85,11,74
2025-08-26,16,Primaria 6°,SuperSchool,105,10,95
2025-08-26,16,Primaria 6°,EduMax,130,12,118
2025-08-26,16,Primaria 6°,EduMax,251,6,245
2025-08-26,16,Primaria 6°,SuperSchool,176,19,157
2025-08-26,16,Primaria 6°,EduMax,181,18,163
2025-08-26,16,Primaria 6°,TopKids,110,21,89
2025-08-26,16,Primaria 6°,EduMax,95,7,88
2025-08-26,16,Primaria 6°,EduMax,195,24,171
2025-08-26,16,Primaria 6°,SuperSchool,62,5,57
2025-08-26,16,Primaria 6°,TopKids,206,12,194
2025-08-26,16,Primaria 6°,SuperSchool,223,1,222
2025-08-26,16,Primaria 6°,EduMax,235,9,226
2025-08-26,16,Primaria 6°,EduMax,88,16,72
2025-08-26,16,Primaria 6°,EduMax,81,19,62
2025-08-26,16,Primaria 6°,SuperSchool,94,21,73
2025-08-27,9,Preescolar,EduMax,204,3,201
2025-08-27,9,Preescolar,EduMax,88,1,87
2025-08-27,9,Preescolar,TopKids,102,14,88
2025-08-27,9,Preescolar,TopKids,71,6,65
2025-08-27,9,Preescolar,SuperSchool,124,22,102
2025-08-27,9,Preescolar,TopKids,122,11,111
2025-08-27,9,Preescolar,EduMax,251,2,249
2025-08-27,9,Preescolar,TopKids,135,14,121
2025-08-27,9,Preescolar,EduMax,182,14,168
2025-08-27,9,Preescolar,TopKids,196,6,190
2025-08-27,9,Preescolar,TopKids,256,14,242
2025-08-27,9,Preescolar,SuperSchool,279,11,268
2025-08-27,9,Preescolar,TopKids,295,7,288
2025-08-27,9,Preescolar,SuperSchool,213,15,198
2025-08-27,9,Preescolar,SuperSchool,144,9,135
2025-08-27,9,Preescolar,TopKids,229,8,221
2025-08-27,9,Preescolar,TopKids,237,18,219
2025-08-27,9,Kínder,SuperSchool,280,14,266
2025-08-27,9,Kínder,EduMax,114,13,101
2025-08-27,9,Kínder,TopKids,278,5,273
2025-08-27,9,Kínder,EduMax,255,14,241
2025-08-27,9,Kínder,SuperSchool,124,19,105
2025-08-27,9,Primaria 1°,TopKids,230,7,223
2025-08-27,9,Primaria 1°,SuperSchool,271,15,256
2025-08-27,9,Primaria 1°,EduMax,127,24,103
2025-08-27,9,Primaria 1°,TopKids,118,12,106
2025-08-27,9,Primaria 1°,EduMax,175,5,170
2025-08-27,9,Primaria 1°,SuperSchool,97,7,90
2025-08-27,9,Primaria 1°,TopKids,270,22,248
2025-08-27,9,Primaria 1°,SuperSchool,268,4,264
2025-08-27,9,Primaria 1°,EduMax,215,3,212
2025-08-27,9,Primaria 2°,SuperSchool,180,24,156
2025-08-27,9,Primaria 2°,EduMax,88,18,70
2025-08-27,9,Primaria 2°,SuperSchool,180,18,162
2025-08-27,9,Primaria 2°,SuperSchool,50,21,29
2025-08-27,9,Primaria 2°,EduMax,229,16,213
2025-08-27,9,Primaria 2°,EduMax,134,9,125
2025-08-27,9,Primaria 2°,SuperSchool,62,24,38
2025-08-27,9,Primaria 2°,SuperSchool,195,19,176
2025-08-27,9,Primaria 2°,TopKids,292,6,286
2025-08-27,9,Primaria 2°,TopKids,120,23,97
2025-08-27,9,Primaria 2°,TopKids,257,17,240
2025-08-27,9,Primaria 2°,EduMax,132,16,116
2025-08-27,9,Primaria 2°,SuperSchool,225,19,206
2025-08-27,9,Primaria 2°,TopKids,148,15,133
2025-08-27,9,Primaria 2°,SuperSchool,109,16,93
2025-08-27,9,Primaria 2°,TopKids,197,5,192
2025-08-27,9,Primaria 2°,TopKids,91,13,78
2025-08-27,9,Primaria 2°,TopKids,125,17,108
2025-08-27,9,Primaria 3°,TopKids,258,11,247
2025-08-27,9,Primaria 3°,TopKids,136,15,121
2025-08-27,9,Primaria 3°,TopKids,294,7,287
2025-08-27,9,Primaria 3°,SuperSchool,231,13,218
2025-08-27,9,Primaria 3°,EduMax,59,18,41
2025-08-27,9,Primaria 3°,SuperSchool,229,19,210
2025-08-27,9,Primaria 3°,TopKids,211,4,207
2025-08-27,9,Primaria 3°,EduMax,65,21,44
2025-08-27,9,Primaria 3°,SuperSchool,256,13,243
2025-08-27,9,Primaria 3°,SuperSchool,231,5,226
2025-08-27,9,Primaria 3°,TopKids,101,1,100
2025-08-27,9,Primaria 3°,EduMax,200,15,185
2025-08-27,9,Primaria 3°,TopKids,271,16,255
2025-08-27,9,Primaria 3°,TopKids,67,17,50
2025-08-27,9,Primaria 3°,TopKids,101,13,88
2025-08-27,9,Primaria 3°,SuperSchool,231,9,222
2025-08-27,9,Primaria 3°,SuperSchool,194,5,189
2025-08-27,9,Primaria 3°,EduMax,121,3,118
2025-08-27,9,Primaria 3°,EduMax,148,8,140
2025-08-27,9,Primaria 4°,TopKids,140,4,136
2025-08-27,9,Primaria 4°,EduMax,202,10,192
2025-08-27,9,Primaria 4°,TopKids,62,24,38
2025-08-27,9,Primaria 4°,TopKids,167,19,148
2025-08-27,9,Primaria 4°,EduMax,254,20,234
2025-08-27,9,Primaria 4°,SuperSchool,144,16,128
2025-08-27,9,Primaria 4°,EduMax,217,23,194
2025-08-27,9,Primaria 4°,EduMax,52,20,32
2025-08-27,9,Primaria 4°,EduMax,72,2,70
2025-08-27,9,Primaria 4°,EduMax,288,10,278
2025-08-27,9,Primaria 4°,SuperSchool,71,20,51
2025-08-27,9,Primaria 4°,TopKids,233,1,232
2025-08-27,9,Primaria 4°,SuperSchool,263,16,247
2025-08-27,9,Primaria 4°,EduMax,259,24,235
2025-08-27,9,Primaria 4°,SuperSchool,102,5,97
2025-08-27,9,Primaria 4°,TopKids,72,10,62
2025-08-27,9,Primaria 5°,TopKids,253,10,243
2025-08-27,9,Primaria 5°,EduMax,169,1,168
2025-08-27,9,Primaria 5°,SuperSchool,111,18,93
2025-08-27,9,Primaria 5°,TopKids,56,4,52
2025-08-27,9,Primaria 5°,TopKids,123,10,113
2025-08-27,9,Primaria 5°,SuperSchool,252,3,249
2025-08-27,9,Primaria 5°,SuperSchool,63,13,50
2025-08-27,9,Primaria 5°,TopKids,202,10,192
2025-08-27,9,Primaria 5°,TopKids,269,8,261
2025-08-27,9,Primaria 5°,SuperSchool,87,7,80
2025-08-27,9,Primaria 5°,EduMax,207,8,199
2025-08-27,9,Primaria 5°,EduMax,191,1,190
2025-08-27,9,Primaria 5°,SuperSchool,67,19,48
2025-08-27,9,Primaria 5°,EduMax,209,8,201
2025-08-27,9,Primaria 5°,SuperSchool,224,20,204
2025-08-27,9,Primaria 6°,EduMax,214,16,198
2025-08-27,9,Primaria 6°,SuperSchool,266,6,260
2025-08-27,9,Primaria 6°,SuperSchool,155,10,145
2025-08-27,9,Primaria 6°,SuperSchool,57,1,56
2025-08-27,9,Primaria 6°,SuperSchool,50,7,43
2025-08-27,10,Preescolar,TopKids,136,24,112
2025-08-27,10,Preescolar,EduMax,136,9,127
2025-08-27,10,Preescolar,TopKids,176,20,156
2025-08-27,10,Preescolar,SuperSchool,215,2,213
2025-08-27,10,Preescolar,TopKids,186,14,172
2025-08-27,10,Preescolar,SuperSchool,226,11,215
2025-08-27,10,Preescolar,SuperSchool,139,6,133
2025-08-27,10,Preescolar,SuperSchool,82,19,63
2025-08-27,10,Preescolar,EduMax,163,11,152
2025-08-27,10,Preescolar,SuperSchool,273,21,252
2025-08-27,10,Preescolar,EduMax,211,8,203
2025-08-27,10,Preescolar,EduMax,97,8,89
2025-08-27,10,Preescolar,EduMax,208,1,207
2025-08-27,10,Preescolar,TopKids,275,15,260
2025-08-27,10,Preescolar,TopKids,73,18,55
2025-08-27,10,Preescolar,EduMax,270,23,247
2025-08-27,10,Preescolar,SuperSchool,238,16,222
2025-08-27,10,Preescolar,SuperSchool,76,9,67
2025-08-27,10,Kínder,TopKids,249,18,231
2025-08-27,10,Kínder,TopKids,247,11,236
2025-08-27,10,Kínder,TopKids,223,24,199
2025-08-27,10,Kínder,TopKids,292,7,285
2025-08-27,10,Kínder,EduMax,256,6,250
2025-08-27,10,Kínder,SuperSchool,247,16,231
2025-08-27,10,Kínder,SuperSchool,292,18,274
2025-08-27,10,Kínder,SuperSchool,225,7,218
2025-08-27,10,Kínder,TopKids,54,20,34
2025-08-27,10,Primaria 1°,TopKids,291,7,284
2025-08-27,10,Primaria 1°,EduMax,116,5,111
2025-08-27,10,Primaria 1°,TopKids,126,16,110
2025-08-27,10,Primaria 1°,EduMax,61,7,54
2025-08-27,10,Primaria 1°,TopKids,295,13,282
2025-08-27,10,Primaria 1°,SuperSchool,256,21,235
2025-08-27,10,Primaria 1°,SuperSchool,104,20,84
2025-08-27,10,Primaria 1°,SuperSchool,162,24,138
2025-08-27,10,Primaria 1°,TopKids,133,19,114
2025-08-27,10,Primaria 1°,SuperSchool,245,3,242
2025-08-27,10,Primaria 1°,SuperSchool,285,5,280
2025-08-27,10,Primaria 1°,SuperSchool,178,23,155
2025-08-27,10,Primaria 1°,TopKids,79,7,72
2025-08-27,10,Primaria 1°,EduMax,197,14,183
2025-08-27,10,Primaria 1°,TopKids,268,11,257
2025-08-27,10,Primaria 2°,TopKids,259,19,240
2025-08-27,10,Primaria 2°,EduMax,151,15,136
2025-08-27,10,Primaria 2°,EduMax,184,5,179
2025-08-27,10,Primaria 2°,SuperSchool,120,22,98
2025-08-27,10,Primaria 2°,SuperSchool,259,18,241
2025-08-27,10,Primaria 3°,SuperSchool,264,11,253
2025-08-27,10,Primaria 3°,TopKids,207,20,187
2025-08-27,10,Primaria 3°,TopKids,170,6,164
2025-08-27,10,Primaria 3°,TopKids,238,7,231
2025-08-27,10,Primaria 3°,TopKids,116,10,106
2025-08-27,10,Primaria 3°,TopKids,254,19,235
2025-08-27,10,Primaria 3°,EduMax,80,5,75
2025-08-27,10,Primaria 3°,SuperSchool,280,5,275
2025-08-27,10,Primaria 3°,SuperSchool,164,17,147
2025-08-27,10,Primaria 3°,TopKids,181,22,159
2025-08-27,10,Primaria 3°,EduMax,201,7,194
2025-08-27,10,Primaria 3°,EduMax,87,14,73
2025-08-27,10,Primaria 3°,EduMax,196,20,176
2025-08-27,10,Primaria 3°,TopKids,167,7,160
2025-08-27,10,Primaria 3°,TopKids,293,22,271
2025-08-27,10,Primaria 3°,SuperSchool,188,15,173
2025-08-27,10,Primaria 3°,TopKids,238,15,223
2025-08-27,10,Primaria 3°,TopKids,98,11,87
2025-08-27,10,Primaria 3°,SuperSchool,173,12,161
2025-08-27,10,Primaria 4°,EduMax,60,11,49
2025-08-27,10,Primaria 4°,SuperSchool,171,9,162
2025-08-27,10,Primaria 4°,TopKids,298,4,294
2025-08-27,10,Primaria 4°,EduMax,136,4,132
2025-08-27,10,Primaria 4°,EduMax,278,17,261
2025-08-27,10,Primaria 4°,TopKids,189,6,183
2025-08-27,10,Primaria 4°,TopKids,72,19,53
2025-08-27,10,Primaria 4°,EduMax,147,12,135
2025-08-27,10,Primaria 4°,EduMax,184,1,183
2025-08-27,10,Primaria 4°,EduMax,276,20,256
2025-08-27,10,Primaria 4°,TopKids,246,20,226
2025-08-27,10,Primaria 4°,TopKids,219,19,200
2025-08-27,10,Primaria 4°,SuperSchool,240,7,233
2025-08-27,10,Primaria 4°,EduMax,135,18,117
2025-08-27,10,Primaria 4°,EduMax,100,24,76
2025-08-27,10,Primaria 4°,EduMax,160,10,150
2025-08-27,10,Primaria 4°,EduMax,81,10,71
2025-08-27,10,Primaria 5°,EduMax,61,8,53
2025-08-27,10,Primaria 5°,TopKids,127,2,125
2025-08-27,10,Primaria 5°,SuperSchool,119,8,111
2025-08-27,10,Primaria 5°,SuperSchool,276,15,261
2025-08-27,10,Primaria 5°,SuperSchool,75,7,68
2025-08-27,10,Primaria 5°,EduMax,265,3,262
2025-08-27,10,Primaria 5°,EduMax,236,18,218
2025-08-27,10,Primaria 5°,EduMax,246,20,226
2025-08-27,10,Primaria 5°,EduMax,96,6,90
2025-08-27,10,Primaria 5°,TopKids,207,18,189
2025-08-27,10,Primaria 5°,SuperSchool,73,20,53
2025-08-27,10,Primaria 5°,EduMax,116,8,108
2025-08-27,10,Primaria 5°,TopKids,227,15,212
2025-08-27,10,Primaria 5°,TopKids,95,16,79
2025-08-27,10,Primaria 5°,TopKids,238,15,223
2025-08-27,10,Primaria 6°,TopKids,185,2,183
2025-08-27,10,Primaria 6°,SuperSchool,162,12,150
2025-08-27,10,Primaria 6°,TopKids,92,18,74
2025-08-27,10,Primaria 6°,SuperSchool,223,12,211
2025-08-27,10,Primaria 6°,TopKids,136,21,115
2025-08-27,10,Primaria 6°,TopKids,153,2,151
2025-08-27,10,Primaria 6°,TopKids,236,5,231
2025-08-27,11,Preescolar,EduMax,204,23,181
2025-08-27,11,Preescolar,EduMax,53,4,49
2025-08-27,11,Preescolar,EduMax,266,15,251
2025-08-27,11,Preescolar,EduMax,166,22,144
2025-08-27,11,Preescolar,TopKids,56,23,33
2025-08-27,11,Preescolar,SuperSchool,292,2,290
2025-08-27,11,Kínder,SuperSchool,221,19,202
2025-08-27,11,Kínder,SuperSchool,204,12,192
2025-08-27,11,Kínder,SuperSchool,86,2,84
2025-08-27,11,Kínder,EduMax,213,6,207
2025-08-27,11,Kínder,SuperSchool,171,22,149
2025-08-27,11,Kínder,EduMax,78,11,67
2025-08-27,11,Kínder,EduMax,105,21,84
2025-08-27,11,Kínder,SuperSchool,144,9,135
2025-08-27,11,Kínder,SuperSchool,66,9,57
2025-08-27,11,Kínder,SuperSchool,121,5,116
2025-08-27,11,Kínder,SuperSchool,203,6,197
2025-08-27,11,Kínder,SuperSchool,186,21,165
2025-08-27,11,Kínder,TopKids,156,15,141
2025-08-27,11,Kínder,SuperSchool,228,6,222
2025-08-27,11,Kínder,TopKids,206,14,192
2025-08-27,11,Kínder,SuperSchool,223,11,212
2025-08-27,11,Kínder,TopKids,187,2,185
2025-08-27,11,Primaria 1°,EduMax,274,14,260
2025-08-27,11,Primaria 1°,EduMax,125,19,106
2025-08-27,11,Primaria 1°,TopKids,157,5,152
2025-08-27,11,Primaria 1°,SuperSchool,195,12,183
2025-08-27,11,Primaria 1°,EduMax,289,23,266
2025-08-27,11,Primaria 1°,EduMax,269,7,262
2025-08-27,11,Primaria 1°,SuperSchool,123,5,118
2025-08-27,11,Primaria 1°,TopKids,70,4,66
2025-08-27,11,Primaria 1°,TopKids,100,7,93
2025-08-27,11,Primaria 1°,SuperSchool,158,21,137
2025-08-27,11,Primaria 1°,TopKids,240,18,222
2025-08-27,11,Primaria 1°,SuperSchool,202,9,193
2025-08-27,11,Primaria 1°,SuperSchool,190,5,185
2025-08-27,11,Primaria 2°,EduMax,189,1,188
2025-08-27,11,Primaria 2°,EduMax,171,21,150
2025-08-27,11,Primaria 2°,SuperSchool,167,24,143
2025-08-27,11,Primaria 2°,SuperSchool,155,9,146
2025-08-27,11,Primaria 2°,TopKids,126,21,105
2025-08-27,11,Primaria 2°,SuperSchool,175,9,166
2025-08-27,11,Primaria 2°,SuperSchool,143,11,132
2025-08-27,11,Primaria 2°,EduMax,85,24,61
2025-08-27,11,Primaria 2°,SuperSchool,248,20,228
2025-08-27,11,Primaria 2°,TopKids,295,3,292
2025-08-27,11,Primaria 2°,EduMax,276,1,275
2025-08-27,11,Primaria 2°,EduMax,94,5,89
2025-08-27,11,Primaria 2°,EduMax,297,23,274
2025-08-27,11,Primaria 2°,EduMax,73,4,69
2025-08-27,11,Primaria 2°,TopKids,246,11,235
2025-08-27,11,Primaria 2°,SuperSchool,281,21,260
2025-08-27,11,Primaria 2°,SuperSchool,209,6,203
2025-08-27,11,Primaria 2°,TopKids,209,15,194
2025-08-27,11,Primaria 3°,SuperSchool,225,11,214
2025-08-27,11,Primaria 3°,TopKids,215,12,203
2025-08-27,11,Primaria 3°,EduMax,149,14,135
2025-08-27,11,Primaria 3°,TopKids,139,12,127
2025-08-27,11,Primaria 3°,EduMax,92,13,79
2025-08-27,11,Primaria 3°,TopKids,112,9,103
2025-08-27,11,Primaria 3°,EduMax,166,16,150
2025-08-27,11,Primaria 3°,SuperSchool,268,12,256
2025-08-27,11,Primaria 3°,TopKids,142,16,126
2025-08-27,11,Primaria 3°,TopKids,226,11,215
2025-08-27,11,Primaria 3°,SuperSchool,100,18,82
2025-08-27,11,Primaria 4°,SuperSchool,190,6,184
2025-08-27,11,Primaria 4°,TopKids,264,12,252
2025-08-27,11,Primaria 4°,SuperSchool,154,15,139
2025-08-27,11,Primaria 4°,SuperSchool,112,18,94
2025-08-27,11,Primaria 4°,TopKids,57,11,46
2025-08-27,11,Primaria 4°,SuperSchool,204,14,190
2025-08-27,11,Primaria 4°,TopKids,172,23,149
2025-08-27,11,Primaria 4°,SuperSchool,143,2,141
2025-08-27,11,Primaria 4°,TopKids,68,16,52
2025-08-27,11,Primaria 4°,SuperSchool,204,7,197
2025-08-27,11,Primaria 4°,SuperSchool,162,19,143
2025-08-27,11,Primaria 4°,SuperSchool,152,12,140
2025-08-27,11,Primaria 4°,SuperSchool,206,13,193
2025-08-27,11,Primaria 4°,EduMax,160,2,158
2025-08-27,11,Primaria 4°,EduMax,58,15,43
2025-08-27,11,Primaria 5°,EduMax,51,3,48
2025-08-27,11,Primaria 5°,TopKids,229,23,206
2025-08-27,11,Primaria 5°,SuperSchool,143,8,135
2025-08-27,11,Primaria 5°,SuperSchool,88,11,77
2025-08-27,11,Primaria 5°,EduMax,190,8,182
2025-08-27,11,Primaria 5°,SuperSchool,289,5,284
2025-08-27,11,Primaria 5°,TopKids,209,14,195
2025-08-27,11,Primaria 5°,SuperSchool,204,24,180
2025-08-27,11,Primaria 6°,SuperSchool,71,14,57
2025-08-27,11,Primaria 6°,SuperSchool,185,3,182
2025-08-27,11,Primaria 6°,SuperSchool,164,15,149
2025-08-27,11,Primaria 6°,SuperSchool,209,8,201
2025-08-27,11,Primaria 6°,SuperSchool,94,12,82
2025-08-27,11,Primaria 6°,SuperSchool,145,20,125
2025-08-27,11,Primaria 6°,TopKids,150,19,131
2025-08-27,12,Preescolar,EduMax,188,11,177
2025-08-27,12,Preescolar,EduMax,242,22,220
2025-08-27,12,Preescolar,SuperSchool,198,9,189
2025-08-27,12,Preescolar,SuperSchool,239,7,232
2025-08-27,12,Preescolar,EduMax,272,23,249
2025-08-27,12,Preescolar,EduMax,273,5,268
2025-08-27,12,Preescolar,SuperSchool,64,5,59
2025-08-27,12,Preescolar,EduMax,150,17,133
2025-08-27,12,Preescolar,EduMax,53,24,29
2025-08-27,12,Kínder,TopKids,83,8,75
2025-08-27,12,Kínder,SuperSchool,245,22,223
2025-08-27,12,Kínder,TopKids,191,4,187
2025-08-27,12,Kínder,TopKids,223,18,205
2025-08-27,12,Kínder,TopKids,143,12,131
2025-08-27,12,Kínder,TopKids,293,20,273
2025-08-27,12,Kínder,EduMax,282,2,280
2025-08-27,12,Kínder,SuperSchool,288,23,265
2025-08-27,12,Kínder,TopKids,269,8,261
2025-08-27,12,Primaria 1°,EduMax,241,4,237
2025-08-27,12,Primaria 1°,EduMax,189,18,171
2025-08-27,12,Primaria 1°,SuperSchool,59,21,38
2025-08-27,12,Primaria 1°,SuperSchool,163,17,146
2025-08-27,12,Primaria 1°,TopKids,247,14,233
2025-08-27,12,Primaria 1°,SuperSchool,217,8,209
2025-08-27,12,Primaria 1°,EduMax,79,9,70
2025-08-27,12,Primaria 2°,EduMax,229,14,215
2025-08-27,12,Primaria 2°,SuperSchool,111,2,109
2025-08-27,12,Primaria 2°,EduMax,199,21,178
2025-08-27,12,Primaria 2°,TopKids,298,16,282
2025-08-27,12,Primaria 2°,EduMax,215,18,197
2025-08-27,12,Primaria 2°,TopKids,243,13,230
2025-08-27,12,Primaria 2°,TopKids,57,12,45
2025-08-27,12,Primaria 2°,SuperSchool,282,8,274
2025-08-27,12,Primaria 2°,SuperSchool,54,13,41
2025-08-27,12,Primaria 2°,EduMax,213,17,196
2025-08-27,12,Primaria 2°,SuperSchool,207,20,187
2025-08-27,12,Primaria 2°,TopKids,197,4,193
2025-08-27,12,Primaria 2°,EduMax,222,4,218
2025-08-27,12,Primaria 2°,EduMax,137,16,121
2025-08-27,12,Primaria 2°,TopKids,108,10,98
2025-08-27,12,Primaria 2°,EduMax,95,2,93
2025-08-27,12,Primaria 2°,EduMax,178,13,165
2025-08-27,12,Primaria 2°,EduMax,71,17,54
2025-08-27,12,Primaria 3°,SuperSchool,135,11,124
2025-08-27,12,Primaria 3°,EduMax,165,3,162
2025-08-27,12,Primaria 3°,EduMax,298,6,292
2025-08-27,12,Primaria 3°,SuperSchool,276,17,259
2025-08-27,12,Primaria 3°,TopKids,227,5,222
2025-08-27,12,Primaria 3°,TopKids,84,23,61
2025-08-27,12,Primaria 3°,TopKids,99,10,89
2025-08-27,12,Primaria 3°,EduMax,232,10,222
2025-08-27,12,Primaria 3°,TopKids,72,1,71
2025-08-27,12,Primaria 3°,EduMax,269,1,268
2025-08-27,12,Primaria 3°,SuperSchool,174,15,159
2025-08-27,12,Primaria 3°,EduMax,131,22,109
2025-08-27,12,Primaria 3°,TopKids,255,18,237
2025-08-27,12,Primaria 3°,EduMax,165,19,146
2025-08-27,12,Primaria 3°,SuperSchool,182,9,173
2025-08-27,12,Primaria 4°,SuperSchool,118,24,94
2025-08-27,12,Primaria 4°,EduMax,229,15,214
2025-08-27,12,Primaria 4°,EduMax,137,19,118
2025-08-27,12,Primaria 4°,TopKids,122,21,101
2025-08-27,12,Primaria 4°,EduMax,141,16,125
2025-08-27,12,Primaria 4°,TopKids,147,8,139
2025-08-27,12,Primaria 5°,SuperSchool,198,5,193
2025-08-27,12,Primaria 5°,TopKids,284,9,275
2025-08-27,12,Primaria 5°,TopKids,278,9,269
2025-08-27,12,Primaria 5°,SuperSchool,240,10,230
2025-08-27,12,Primaria 5°,TopKids,281,19,262
2025-08-27,12,Primaria 5°,SuperSchool,105,5,100
2025-08-27,12,Primaria 5°,EduMax,282,4,278
2025-08-27,12,Primaria 5°,EduMax,79,7,72
2025-08-27,12,Primaria 5°,TopKids,156,22,134
2025-08-27,12,Primaria 5°,TopKids,79,7,72
2025-08-27,12,Primaria 5°,EduMax,98,5,93
2025-08-27,12,Primaria 6°,EduMax,55,21,34
2025-08-27,12,Primaria 6°,EduMax,171,5,166
2025-08-27,12,Primaria 6°,EduMax,77,3,74
2025-08-27,12,Primaria 6°,SuperSchool,225,15,210
2025-08-27,12,Primaria 6°,EduMax,175,3,172
2025-08-27,12,Primaria 6°,EduMax,111,20,91
2025-08-27,12,Primaria 6°,TopKids,231,5,226
2025-08-27,12,Primaria 6°,TopKids,156,23,133
2025-08-27,12,Primaria 6°,TopKids,282,7,275
2025-08-27,12,Primaria 6°,TopKids,81,2,79
2025-08-27,12,Primaria 6°,TopKids,285,16,269
2025-08-27,12,Primaria 6°,EduMax,65,16,49
2025-08-27,13,Preescolar,TopKids,141,22,119
2025-08-27,13,Preescolar,SuperSchool,263,8,255
2025-08-27,13,Preescolar,TopKids,201,21,180
2025-08-27,13,Preescolar,EduMax,167,5,162
2025-08-27,13,Preescolar,EduMax,208,22,186
2025-08-27,13,Preescolar,TopKids,87,5,82
2025-08-27,13,Preescolar,TopKids,63,11,52
2025-08-27,13,Kínder,EduMax,87,11,76
2025-08-27,13,Kínder,SuperSchool,214,10,204
2025-08-27,13,Kínder,TopKids,81,20,61
2025-08-27,13,Kínder,EduMax,279,4,275
2025-08-27,13,Kínder,TopKids,294,10,284
2025-08-27,13,Kínder,EduMax,156,16,140
2025-08-27,13,Kínder,TopKids,145,18,127
2025-08-27,13,Kínder,SuperSchool,56,24,32
2025-08-27,13,Kínder,EduMax,294,15,279
2025-08-27,13,Kínder,TopKids,259,15,244
2025-08-27,13,Kínder,EduMax,180,1,179
2025-08-27,13,Kínder,SuperSchool,248,10,238
2025-08-27,13,Kínder,TopKids,121,22,99
2025-08-27,13,Primaria 1°,SuperSchool,255,17,238
2025-08-27,13,Primaria 1°,SuperSchool,198,23,175
2025-08-27,13,Primaria 1°,EduMax,133,17,116
2025-08-27,13,Primaria 1°,EduMax,203,8,195
2025-08-27,13,Primaria 1°,SuperSchool,161,12,149
2025-08-27,13,Primaria 1°,TopKids,78,17,61
2025-08-27,13,Primaria 1°,EduMax,217,18,199
2025-08-27,13,Primaria 1°,TopKids,222,12,210
2025-08-27,13,Primaria 1°,TopKids,139,3,136
2025-08-27,13,Primaria 1°,TopKids,215,3,212
2025-08-27,13,Primaria 1°,SuperSchool,156,8,148
2025-08-27,13,Primaria 2°,EduMax,297,20,277
2025-08-27,13,Primaria 2°,TopKids,142,5,137
2025-08-27,13,Primaria 2°,TopKids,89,7,82
2025-08-27,13,Primaria 2°,SuperSchool,167,5,162
2025-08-27,13,Primaria 2°,TopKids,240,4,236
2025-08-27,13,Primaria 2°,EduMax,98,12,86
2025-08-27,13,Primaria 2°,EduMax,58,6,52
2025-08-27,13,Primaria 2°,SuperSchool,151,18,133
2025-08-27,13,Primaria 3°,TopKids,64,7,57
2025-08-27,13,Primaria 3°,SuperSchool,155,4,151
2025-08-27,13,Primaria 3°,SuperSchool,70,10,60
2025-08-27,13,Primaria 3°,TopKids,66,1,65
2025-08-27,13,Primaria 3°,SuperSchool,85,15,70
2025-08-27,13,Primaria 3°,EduMax,283,20,263
2025-08-27,13,Primaria 3°,SuperSchool,153,20,133
2025-08-27,13,Primaria 3°,EduMax,72,10,62
2025-08-27,13,Primaria 3°,SuperSchool,54,14,40
2025-08-27,13,Primaria 3°,SuperSchool,124,4,120
2025-08-27,13,Primaria 4°,TopKids,162,2,160
2025-08-27,13,Primaria 4°,SuperSchool,199,1,198
2025-08-27,13,Primaria 4°,EduMax,77,18,59
2025-08-27,13,Primaria 4°,TopKids,231,6,225
2025-08-27,13,Primaria 4°,EduMax,63,23,40
2025-08-27,13,Primaria 4°,EduMax,93,14,79
2025-08-27,13,Primaria 4°,EduMax,93,9,84
2025-08-27,13,Primaria 4°,SuperSchool,272,2,270
2025-08-27,13,Primaria 4°,EduMax,54,23,31
2025-08-27,13,Primaria 4°,EduMax,176,13,163
2025-08-27,13,Primaria 4°,TopKids,96,15,81
2025-08-27,13,Primaria 5°,TopKids,128,19,109
2025-08-27,13,Primaria 5°,TopKids,62,23,39
2025-08-27,13,Primaria 5°,TopKids,207,10,197
2025-08-27,13,Primaria 5°,EduMax,188,22,166
2025-08-27,13,Primaria 5°,EduMax,196,9,187
2025-08-27,13,Primaria 5°,SuperSchool,215,10,205
2025-08-27,13,Primaria 5°,EduMax,265,8,257
2025-08-27,13,Primaria 6°,EduMax,56,20,36
2025-08-27,13,Primaria 6°,SuperSchool,213,8,205
2025-08-27,13,Primaria 6°,SuperSchool,137,14,123
2025-08-27,13,Primaria 6°,EduMax,113,23,90
2025-08-27,13,Primaria 6°,SuperSchool,258,18,240
2025-08-27,13,Primaria 6°,EduMax,265,11,254
2025-08-27,13,Primaria 6°,EduMax,144,13,131
2025-08-27,13,Primaria 6°,SuperSchool,197,16,181
2025-08-27,13,Primaria 6°,EduMax,52,18,34
2025-08-27,13,Primaria 6°,TopKids,247,20,227
2025-08-27,13,Primaria 6°,TopKids,196,3,193
2025-08-27,13,Primaria 6°,SuperSchool,106,5,101
2025-08-27,13,Primaria 6°,SuperSchool,59,21,38
2025-08-27,13,Primaria 6°,SuperSchool,154,13,141
2025-08-27,13,Primaria 6°,EduMax,206,8,198
2025-08-27,13,Primaria 6°,TopKids,147,2,145
2025-08-27,13,Primaria 6°,EduMax,117,9,108
2025-08-27,13,Primaria 6°,EduMax,266,14,252
2025-08-27,13,Primaria 6°,TopKids,144,21,123
2025-08-27,14,Preescolar,TopKids,141,19,122
2025-08-27,14,Preescolar,EduMax,273,23,250
2025-08-27,14,Preescolar,EduMax,102,23,79
2025-08-27,14,Preescolar,TopKids,102,18,84
2025-08-27,14,Preescolar,SuperSchool,184,11,173
2025-08-27,14,Preescolar,EduMax,188,23,165
2025-08-27,14,Preescolar,SuperSchool,84,24,60
2025-08-27,14,Preescolar,SuperSchool,136,1,135
2025-08-27,14,Preescolar,SuperSchool,133,5,128
2025-08-27,14,Preescolar,SuperSchool,203,19,184
2025-08-27,14,Preescolar,EduMax,52,21,31
2025-08-27,14,Preescolar,TopKids,62,17,45
2025-08-27,14,Preescolar,TopKids,136,3,133
2025-08-27,14,Preescolar,SuperSchool,104,13,91
2025-08-27,14,Preescolar,EduMax,244,20,224
2025-08-27,14,Preescolar,SuperSchool,221,9,212
2025-08-27,14,Preescolar,EduMax,74,20,54
2025-08-27,14,Preescolar,EduMax,171,1,170
2025-08-27,14,Kínder,EduMax,250,14,236
2025-08-27,14,Kínder,SuperSchool,69,21,48
2025-08-27,14,Kínder,EduMax,262,10,252
2025-08-27,14,Kínder,SuperSchool,216,23,193
2025-08-27,14,Kínder,EduMax,231,18,213
2025-08-27,14,Kínder,EduMax,221,11,210
2025-08-27,14,Kínder,EduMax,158,9,149
2025-08-27,14,Kínder,EduMax,262,22,240
2025-08-27,14,Kínder,SuperSchool,177,5,172
2025-08-27,14,Kínder,EduMax,251,11,240
2025-08-27,14,Kínder,EduMax,120,14,106
2025-08-27,14,Primaria 1°,SuperSchool,132,21,111
2025-08-27,14,Primaria 1°,EduMax,155,6,149
2025-08-27,14,Primaria 1°,EduMax,244,15,229
2025-08-27,14,Primaria 1°,EduMax,290,7,283
2025-08-27,14,Primaria 1°,SuperSchool,115,7,108
2025-08-27,14,Primaria 1°,TopKids,116,5,111
2025-08-27,14,Primaria 1°,EduMax,89,4,85
2025-08-27,14,Primaria 1°,EduMax,164,8,156
2025-08-27,14,Primaria 2°,EduMax,214,5,209
2025-08-27,14,Primaria 2°,SuperSchool,111,6,105
2025-08-27,14,Primaria 2°,SuperSchool,218,24,194
2025-08-27,14,Primaria 2°,EduMax,80,1,79
2025-08-27,14,Primaria 2°,TopKids,142,6,136
2025-08-27,14,Primaria 2°,TopKids,87,9,78
2025-08-27,14,Primaria 2°,EduMax,240,8,232
2025-08-27,14,Primaria 2°,EduMax,224,22,202
2025-08-27,14,Primaria 2°,EduMax,145,23,122
2025-08-27,14,Primaria 2°,TopKids,110,10,100
2025-08-27,14,Primaria 2°,TopKids,181,13,168
2025-08-27,14,Primaria 3°,TopKids,69,15,54
2025-08-27,14,Primaria 3°,TopKids,114,9,105
2025-08-27,14,Primaria 3°,TopKids,89,2,87
2025-08-27,14,Primaria 3°,EduMax,127,12,115
2025-08-27,14,Primaria 3°,TopKids,203,23,180
2025-08-27,14,Primaria 3°,SuperSchool,132,6,126
2025-08-27,14,Primaria 3°,SuperSchool,54,6,48
2025-08-27,14,Primaria 3°,TopKids,65,18,47
2025-08-27,14,Primaria 3°,EduMax,74,15,59
2025-08-27,14,Primaria 3°,EduMax,277,11,266
2025-08-27,14,Primaria 3°,SuperSchool,154,5,149
2025-08-27,14,Primaria 3°,TopKids,195,18,177
2025-08-27,14,Primaria 4°,EduMax,203,23,180
2025-08-27,14,Primaria 4°,SuperSchool,62,17,45
2025-08-27,14,Primaria 4°,SuperSchool,235,22,213
2025-08-27,14,Primaria 4°,TopKids,194,6,188
2025-08-27,14,Primaria 4°,EduMax,294,14,280
2025-08-27,14,Primaria 4°,SuperSchool,278,4,274
2025-08-27,14,Primaria 4°,TopKids,240,13,227
2025-08-27,14,Primaria 4°,EduMax,193,18,175
2025-08-27,14,Primaria 5°,TopKids,117,20,97
2025-08-27,14,Primaria 5°,SuperSchool,229,6,223
2025-08-27,14,Primaria 5°,EduMax,261,7,254
2025-08-27,14,Primaria 5°,SuperSchool,154,2,152
2025-08-27,14,Primaria 5°,EduMax,103,24,79
2025-08-27,14,Primaria 5°,EduMax,143,1,142
2025-08-27,14,Primaria 6°,SuperSchool,90,9,81
2025-08-27,14,Primaria 6°,TopKids,209,2,207
2025-08-27,14,Primaria 6°,SuperSchool,194,11,183
2025-08-27,14,Primaria 6°,TopKids,115,4,111
2025-08-27,14,Primaria 6°,EduMax,50,23,27
2025-08-27,14,Primaria 6°,EduMax,65,2,63
2025-08-27,14,Primaria 6°,EduMax,165,12,153
2025-08-27,14,Primaria 6°,TopKids,68,3,65
2025-08-27,14,Primaria 6°,TopKids,284,4,280
2025-08-27,14,Primaria 6°,SuperSchool,290,7,283
2025-08-27,14,Primaria 6°,SuperSchool,164,21,143
2025-08-27,15,Preescolar,TopKids,90,17,73
2025-08-27,15,Preescolar,EduMax,218,14,204
2025-08-27,15,Preescolar,SuperSchool,231,2,229
2025-08-27,15,Preescolar,TopKids,97,19,78
2025-08-27,15,Preescolar,SuperSchool,104,12,92
2025-08-27,15,Preescolar,TopKids,293,15,278
2025-08-27,15,Preescolar,SuperSchool,50,11,39
2025-08-27,15,Preescolar,TopKids,250,7,243
2025-08-27,15,Preescolar,EduMax,270,17,253
2025-08-27,15,Preescolar,EduMax,236,2,234
2025-08-27,15,Preescolar,TopKids,205,3,202
2025-08-27,15,Preescolar,SuperSchool,106,19,87
2025-08-27,15,Preescolar,EduMax,117,8,109
2025-08-27,15,Preescolar,SuperSchool,85,7,78
2025-08-27,15,Kínder,SuperSchool,242,24,218
2025-08-27,15,Kínder,EduMax,181,20,161
2025-08-27,15,Kínder,EduMax,249,18,231
2025-08-27,15,Kínder,TopKids,212,21,191
2025-08-27,15,Kínder,EduMax,93,15,78
2025-08-27,15,Kínder,TopKids,246,17,229
2025-08-27,15,Kínder,SuperSchool,123,11,112
2025-08-27,15,Kínder,TopKids,65,16,49
2025-08-27,15,Kínder,TopKids,118,10,108
2025-08-27,15,Kínder,EduMax,90,18,72
2025-08-27,15,Kínder,EduMax,124,21,103
2025-08-27,15,Kínder,SuperSchool,154,3,151
2025-08-27,15,Kínder,EduMax,265,22,243
2025-08-27,15,Primaria 1°,EduMax,261,17,244
2025-08-27,15,Primaria 1°,TopKids,69,16,53
2025-08-27,15,Primaria 1°,TopKids,102,17,85
2025-08-27,15,Primaria 1°,SuperSchool,53,18,35
2025-08-27,15,Primaria 1°,SuperSchool,84,22,62
2025-08-27,15,Primaria 1°,TopKids,131,21,110
2025-08-27,15,Primaria 1°,SuperSchool,174,9,165
2025-08-27,15,Primaria 1°,EduMax,136,24,112
2025-08-27,15,Primaria 1°,TopKids,218,14,204
2025-08-27,15,Primaria 1°,SuperSchool,169,2,167
2025-08-27,15,Primaria 1°,EduMax,74,18,56
2025-08-27,15,Primaria 1°,SuperSchool,144,21,123
2025-08-27,15,Primaria 1°,EduMax,225,4,221
2025-08-27,15,Primaria 1°,EduMax,208,19,189
2025-08-27,15,Primaria 1°,TopKids,206,5,201
2025-08-27,15,Primaria 1°,EduMax,244,8,236
2025-08-27,15,Primaria 1°,TopKids,262,19,243
2025-08-27,15,Primaria 1°,SuperSchool,138,3,135
2025-08-27,15,Primaria 1°,TopKids,139,23,116
2025-08-27,15,Primaria 2°,SuperSchool,260,6,254
2025-08-27,15,Primaria 2°,SuperSchool,61,19,42
2025-08-27,15,Primaria 2°,SuperSchool,131,3,128
2025-08-27,15,Primaria 2°,TopKids,207,14,193
2025-08-27,15,Primaria 2°,EduMax,137,21,116
2025-08-27,15,Primaria 2°,SuperSchool,278,4,274
2025-08-27,15,Primaria 2°,SuperSchool,231,16,215
2025-08-27,15,Primaria 2°,SuperSchool,249,24,225
2025-08-27,15,Primaria 2°,SuperSchool,97,2,95
2025-08-27,15,Primaria 2°,EduMax,153,3,150
2025-08-27,15,Primaria 2°,TopKids,206,9,197
2025-08-27,15,Primaria 2°,EduMax,60,21,39
2025-08-27,15,Primaria 3°,TopKids,201,20,181
2025-08-27,15,Primaria 3°,TopKids,143,1,142
2025-08-27,15,Primaria 3°,SuperSchool,231,8,223
2025-08-27,15,Primaria 3°,EduMax,83,16,67
2025-08-27,15,Primaria 3°,TopKids,245,19,226
2025-08-27,15,Primaria 3°,SuperSchool,282,3,279
2025-08-27,15,Primaria 3°,TopKids,185,7,178
2025-08-27,15,Primaria 3°,SuperSchool,185,24,161
2025-08-27,15,Primaria 3°,EduMax,203,17,186
2025-08-27,15,Primaria 3°,TopKids,140,11,129
2025-08-27,15,Primaria 3°,TopKids,122,14,108
2025-08-27,15,Primaria 3°,SuperSchool,227,24,203
2025-08-27,15,Primaria 3°,TopKids,106,23,83
2025-08-27,15,Primaria 3°,SuperSchool,214,8,206
2025-08-27,15,Primaria 3°,TopKids,295,4,291
2025-08-27,15,Primaria 3°,SuperSchool,183,24,159
2025-08-27,15,Primaria 3°,TopKids,253,7,246
2025-08-27,15,Primaria 3°,SuperSchool,141,7,134
2025-08-27,15,Primaria 3°,SuperSchool,114,21,93
2025-08-27,15,Primaria 4°,SuperSchool,238,19,219
2025-08-27,15,Primaria 4°,SuperSchool,209,1,208
2025-08-27,15,Primaria 4°,SuperSchool,197,21,176
2025-08-27,15,Primaria 4°,TopKids,271,18,253
2025-08-27,15,Primaria 4°,EduMax,136,5,131
2025-08-27,15,Primaria 4°,TopKids,267,3,264
2025-08-27,15,Primaria 4°,TopKids,115,22,93
2025-08-27,15,Primaria 4°,EduMax,215,19,196
2025-08-27,15,Primaria 4°,TopKids,78,17,61
2025-08-27,15,Primaria 4°,TopKids,94,17,77
2025-08-27,15,Primaria 4°,TopKids,195,11,184
2025-08-27,15,Primaria 4°,TopKids,173,20,153
2025-08-27,15,Primaria 5°,EduMax,190,24,166
2025-08-27,15,Primaria 5°,TopKids,133,19,114
2025-08-27,15,Primaria 5°,EduMax,141,3,138
2025-08-27,15,Primaria 5°,SuperSchool,55,7,48
2025-08-27,15,Primaria 5°,SuperSchool,102,23,79
2025-08-27,15,Primaria 5°,SuperSchool,135,9,126
2025-08-27,15,Primaria 5°,EduMax,251,14,237
2025-08-27,15,Primaria 5°,TopKids,162,11,151
2025-08-27,15,Primaria 6°,EduMax,92,13,79
2025-08-27,15,Primaria 6°,TopKids,292,6,286
2025-08-27,15,Primaria 6°,EduMax,95,16,79
2025-08-27,15,Primaria 6°,TopKids,50,2,48
2025-08-27,15,Primaria 6°,SuperSchool,234,23,211
2025-08-27,15,Primaria 6°,EduMax,294,20,274
2025-08-27,15,Primaria 6°,EduMax,259,10,249
2025-08-27,15,Primaria 6°,SuperSchool,121,2,119
2025-08-27,15,Primaria 6°,EduMax,60,11,49
2025-08-27,15,Primaria 6°,TopKids,92,10,82
2025-08-27,15,Primaria 6°,TopKids,249,19,230
2025-08-27,16,Preescolar,TopKids,229,3,226
2025-08-27,16,Preescolar,SuperSchool,93,16,77
2025-08-27,16,Preescolar,EduMax,193,17,176
2025-08-27,16,Preescolar,SuperSchool,295,19,276
2025-08-27,16,Preescolar,SuperSchool,202,18,184
2025-08-27,16,Kínder,EduMax,55,6,49
2025-08-27,16,Kínder,TopKids,220,6,214
2025-08-27,16,Kínder,EduMax,241,18,223
2025-08-27,16,Kínder,SuperSchool,114,6,108
2025-08-27,16,Kínder,EduMax,194,13,181
2025-08-27,16,Kínder,SuperSchool,122,6,116
2025-08-27,16,Kínder,EduMax,170,5,165
2025-08-27,16,Kínder,SuperSchool,102,14,88
2025-08-27,16,Kínder,EduMax,181,2,179
2025-08-27,16,Kínder,EduMax,240,17,223
2025-08-27,16,Kínder,EduMax,127,19,108
2025-08-27,16,Kínder,SuperSchool,238,22,216
2025-08-27,16,Kínder,EduMax,220,7,213
2025-08-27,16,Kínder,SuperSchool,223,23,200
2025-08-27,16,Kínder,EduMax,197,24,173
2025-08-27,16,Kínder,SuperSchool,209,19,190
2025-08-27,16,Kínder,EduMax,98,14,84
2025-08-27,16,Kínder,TopKids,222,14,208
2025-08-27,16,Primaria 1°,SuperSchool,141,15,126
2025-08-27,16,Primaria 1°,EduMax,266,19,247
2025-08-27,16,Primaria 1°,EduMax,188,12,176
2025-08-27,16,Primaria 1°,TopKids,77,23,54
2025-08-27,16,Primaria 1°,SuperSchool,269,8,261
2025-08-27,16,Primaria 1°,EduMax,177,6,171
2025-08-27,16,Primaria 1°,EduMax,254,7,247
2025-08-27,16,Primaria 1°,SuperSchool,211,23,188
2025-08-27,16,Primaria 1°,SuperSchool,158,17,141
2025-08-27,16,Primaria 1°,SuperSchool,161,1,160
2025-08-27,16,Primaria 1°,TopKids,62,14,48
2025-08-27,16,Primaria 1°,SuperSchool,258,16,242
2025-08-27,16,Primaria 1°,TopKids,174,17,157
2025-08-27,16,Primaria 1°,EduMax,140,12,128
2025-08-27,16,Primaria 2°,SuperSchool,119,6,113
2025-08-27,16,Primaria 2°,TopKids,235,8,227
2025-08-27,16,Primaria 2°,TopKids,80,3,77
2025-08-27,16,Primaria 2°,TopKids,231,6,225
2025-08-27,16,Primaria 2°,TopKids,79,3,76
2025-08-27,16,Primaria 2°,EduMax,92,8,84
2025-08-27,16,Primaria 2°,SuperSchool,264,10,254
2025-08-27,16,Primaria 3°,EduMax,168,3,165
2025-08-27,16,Primaria 3°,EduMax,127,19,108
2025-08-27,16,Primaria 3°,SuperSchool,173,21,152
2025-08-27,16,Primaria 3°,SuperSchool,126,9,117
2025-08-27,16,Primaria 3°,EduMax,102,12,90
2025-08-27,16,Primaria 3°,EduMax,86,6,80
2025-08-27,16,Primaria 3°,SuperSchool,158,24,134
2025-08-27,16,Primaria 3°,EduMax,287,11,276
2025-08-27,16,Primaria 3°,SuperSchool,222,12,210
2025-08-27,16,Primaria 3°,EduMax,161,6,155
2025-08-27,16,Primaria 3°,SuperSchool,258,20,238
2025-08-27,16,Primaria 3°,EduMax,110,12,98
2025-08-27,16,Primaria 3°,EduMax,186,3,183
2025-08-27,16,Primaria 3°,EduMax,156,2,154
2025-08-27,16,Primaria 3°,TopKids,195,20,175
2025-08-27,16,Primaria 3°,TopKids,80,14,66
2025-08-27,16,Primaria 3°,TopKids,146,12,134
2025-08-27,16,Primaria 3°,SuperSchool,276,2,274
2025-08-27,16,Primaria 3°,TopKids,209,4,205
2025-08-27,16,Primaria 4°,TopKids,163,23,140
2025-08-27,16,Primaria 4°,TopKids,118,15,103
2025-08-27,16,Primaria 4°,SuperSchool,235,8,227
2025-08-27,16,Primaria 4°,EduMax,202,7,195
2025-08-27,16,Primaria 4°,EduMax,248,23,225
2025-08-27,16,Primaria 4°,TopKids,135,22,113
2025-08-27,16,Primaria 4°,TopKids,170,1,169
2025-08-27,16,Primaria 4°,SuperSchool,209,7,202
2025-08-27,16,Primaria 4°,SuperSchool,251,13,238
2025-08-27,16,Primaria 4°,SuperSchool,184,6,178
2025-08-27,16,Primaria 4°,EduMax,230,11,219
2025-08-27,16,Primaria 4°,TopKids,122,22,100
2025-08-27,16,Primaria 4°,EduMax,280,9,271
2025-08-27,16,Primaria 4°,TopKids,279,19,260
2025-08-27,16,Primaria 4°,EduMax,146,16,130
2025-08-27,16,Primaria 4°,SuperSchool,264,15,249
2025-08-27,16,Primaria 4°,TopKids,283,16,267
2025-08-27,16,Primaria 4°,SuperSchool,148,19,129
2025-08-27,16,Primaria 5°,EduMax,56,2,54
2025-08-27,16,Primaria 5°,EduMax,127,23,104
2025-08-27,16,Primaria 5°,TopKids,194,13,181
2025-08-27,16,Primaria 5°,EduMax,76,2,74
2025-08-27,16,Primaria 5°,SuperSchool,207,4,203
2025-08-27,16,Primaria 5°,EduMax,116,14,102
2025-08-27,16,Primaria 5°,TopKids,89,23,66
2025-08-27,16,Primaria 5°,SuperSchool,289,3,286
2025-08-27,16,Primaria 5°,EduMax,50,9,41
2025-08-27,16,Primaria 5°,SuperSchool,173,12,161
2025-08-27,16,Primaria 5°,SuperSchool,193,8,185
2025-08-27,16,Primaria 5°,EduMax,95,10,85
2025-08-27,16,Primaria 5°,SuperSchool,151,9,142
2025-08-27,16,Primaria 5°,TopKids,71,16,55
2025-08-27,16,Primaria 5°,TopKids,252,21,231
2025-08-27,16,Primaria 5°,TopKids,63,7,56
2025-08-27,16,Primaria 5°,TopKids,203,12,191
2025-08-27,16,Primaria 6°,TopKids,182,1,181
2025-08-27,16,Primaria 6°,TopKids,96,10,86
2025-08-27,16,Primaria 6°,SuperSchool,160,13,147
2025-08-27,16,Primaria 6°,TopKids,211,22,189
2025-08-27,16,Primaria 6°,SuperSchool,285,23,262
2025-08-27,16,Primaria 6°,TopKids,125,15,110
2025-08-27,16,Primaria 6°,SuperSchool,243,20,223
2025-08-27,16,Primaria 6°,EduMax,230,2,228
2025-08-28,9,Preescolar,TopKids,254,6,248
2025-08-28,9,Preescolar,SuperSchool,242,9,233
2025-08-28,9,Preescolar,SuperSchool,131,11,120
2025-08-28,9,Preescolar,EduMax,147,20,127
2025-08-28,9,Preescolar,TopKids,115,4,111
2025-08-28,9,Kínder,TopKids,158,6,152
2025-08-28,9,Kínder,TopKids,135,20,115
2025-08-28,9,Kínder,EduMax,276,4,272
2025-08-28,9,Kínder,SuperSchool,69,3,66
2025-08-28,9,Kínder,SuperSchool,292,21,271
2025-08-28,9,Kínder,SuperSchool,63,22,41
2025-08-28,9,Kínder,EduMax,78,4,74
2025-08-28,9,Kínder,SuperSchool,91,7,84
2025-08-28,9,Kínder,SuperSchool,298,13,285
2025-08-28,9,Kínder,EduMax,191,6,185
2025-08-28,9,Kínder,SuperSchool,229,16,213
2025-08-28,9,Kínder,SuperSchool,294,12,282
2025-08-28,9,Kínder,SuperSchool,201,11,190
2025-08-28,9,Kínder,SuperSchool,59,11,48
2025-08-28,9,Kínder,TopKids,299,3,296
2025-08-28,9,Kínder,TopKids,169,15,154
2025-08-28,9,Kínder,TopKids,58,2,56
2025-08-28,9,Kínder,EduMax,193,24,169
2025-08-28,9,Kínder,SuperSchool,114,16,98
2025-08-28,9,Primaria 1°,EduMax,170,11,159
2025-08-28,9,Primaria 1°,SuperSchool,229,17,212
2025-08-28,9,Primaria 1°,TopKids,228,2,226
2025-08-28,9,Primaria 1°,EduMax,217,23,194
2025-08-28,9,Primaria 1°,EduMax,267,6,261
2025-08-28,9,Primaria 1°,SuperSchool,86,5,81
2025-08-28,9,Primaria 1°,EduMax,199,14,185
2025-08-28,9,Primaria 1°,EduMax,55,4,51
2025-08-28,9,Primaria 1°,TopKids,288,23,265
2025-08-28,9,Primaria 1°,TopKids,113,17,96
2025-08-28,9,Primaria 2°,EduMax,240,21,219
2025-08-28,9,Primaria 2°,EduMax,153,9,144
2025-08-28,9,Primaria 2°,TopKids,299,1,298
2025-08-28,9,Primaria 2°,TopKids,158,12,146
2025-08-28,9,Primaria 2°,SuperSchool,262,7,255
2025-08-28,9,Primaria 2°,EduMax,146,20,126
2025-08-28,9,Primaria 2°,TopKids,117,17,100
2025-08-28,9,Primaria 3°,SuperSchool,196,4,192
2025-08-28,9,Primaria 3°,SuperSchool,66,22,44
2025-08-28,9,Primaria 3°,EduMax,219,12,207
2025-08-28,9,Primaria 3°,SuperSchool,60,21,39
2025-08-28,9,Primaria 3°,SuperSchool,69,5,64
2025-08-28,9,Primaria 3°,SuperSchool,83,12,71
2025-08-28,9,Primaria 4°,EduMax,55,22,33
2025-08-28,9,Primaria 4°,TopKids,61,13,48
2025-08-28,9,Primaria 4°,SuperSchool,125,3,122
2025-08-28,9,Primaria 4°,TopKids,139,13,126
2025-08-28,9,Primaria 4°,SuperSchool,52,1,51
2025-08-28,9,Primaria 4°,TopKids,99,20,79
2025-08-28,9,Primaria 4°,TopKids,238,15,223
2025-08-28,9,Primaria 4°,TopKids,231,5,226
2025-08-28,9,Primaria 4°,SuperSchool,155,7,148
2025-08-28,9,Primaria 4°,TopKids,170,8,162
2025-08-28,9,Primaria 4°,TopKids,195,17,178
2025-08-28,9,Primaria 4°,TopKids,241,16,225
2025-08-28,9,Primaria 4°,EduMax,71,13,58
2025-08-28,9,Primaria 4°,TopKids,252,2,250
2025-08-28,9,Primaria 4°,EduMax,204,4,200
2025-08-28,9,Primaria 4°,SuperSchool,247,10,237
2025-08-28,9,Primaria 5°,SuperSchool,235,18,217
2025-08-28,9,Primaria 5°,SuperSchool,266,10,256
2025-08-28,9,Primaria 5°,SuperSchool,257,10,247
2025-08-28,9,Primaria 5°,EduMax,277,21,256
2025-08-28,9,Primaria 5°,EduMax,121,1,120
2025-08-28,9,Primaria 5°,EduMax,98,10,88
2025-08-28,9,Primaria 5°,EduMax,152,18,134
2025-08-28,9,Primaria 5°,EduMax,102,9,93
2025-08-28,9,Primaria 5°,SuperSchool,89,24,65
2025-08-28,9,Primaria 5°,SuperSchool,105,15,90
2025-08-28,9,Primaria 5°,TopKids,54,5,49
2025-08-28,9,Primaria 5°,SuperSchool,122,2,120
2025-08-28,9,Primaria 5°,SuperSchool,199,21,178
2025-08-28,9,Primaria 5°,TopKids,64,1,63
2025-08-28,9,Primaria 5°,TopKids,200,19,181
2025-08-28,9,Primaria 6°,TopKids,55,20,35
2025-08-28,9,Primaria 6°,EduMax,203,10,193
2025-08-28,9,Primaria 6°,SuperSchool,288,19,269
2025-08-28,9,Primaria 6°,SuperSchool,126,2,124
2025-08-28,9,Primaria 6°,EduMax,144,11,133
2025-08-28,9,Primaria 6°,SuperSchool,245,2,243
2025-08-28,9,Primaria 6°,TopKids,257,7,250
2025-08-28,9,Primaria 6°,EduMax,192,5,187
2025-08-28,9,Primaria 6°,TopKids,251,9,242
2025-08-28,9,Primaria 6°,SuperSchool,231,20,211
2025-08-28,9,Primaria 6°,SuperSchool,196,13,183
2025-08-28,9,Primaria 6°,TopKids,95,8,87
2025-08-28,10,Preescolar,EduMax,237,22,215
2025-08-28,10,Preescolar,SuperSchool,210,19,191
2025-08-28,10,Preescolar,TopKids,68,17,51
2025-08-28,10,Preescolar,TopKids,166,10,156
2025-08-28,10,Preescolar,SuperSchool,199,7,192
2025-08-28,10,Preescolar,SuperSchool,276,12,264
2025-08-28,10,Preescolar,EduMax,176,20,156
2025-08-28,10,Preescolar,SuperSchool,216,18,198
2025-08-28,10,Preescolar,TopKids,199,4,195
2025-08-28,10,Preescolar,TopKids,131,23,108
2025-08-28,10,Preescolar,TopKids,134,3,131
2025-08-28,10,Preescolar,SuperSchool,86,18,68
2025-08-28,10,Preescolar,SuperSchool,79,17,62
2025-08-28,10,Preescolar,SuperSchool,193,15,178
2025-08-28,10,Preescolar,SuperSchool,280,3,277
2025-08-28,10,Preescolar,TopKids,108,13,95
2025-08-28,10,Preescolar,TopKids,114,1,113
2025-08-28,10,Preescolar,EduMax,115,18,97
2025-08-28,10,Kínder,SuperSchool,113,23,90
2025-08-28,10,Kínder,EduMax,67,5,62
2025-08-28,10,Kínder,SuperSchool,185,9,176
2025-08-28,10,Kínder,EduMax,190,18,172
2025-08-28,10,Kínder,EduMax,71,20,51
2025-08-28,10,Kínder,TopKids,56,13,43
2025-08-28,10,Kínder,EduMax,154,5,149
2025-08-28,10,Kínder,SuperSchool,237,19,218
2025-08-28,10,Kínder,TopKids,113,22,91
2025-08-28,10,Kínder,SuperSchool,286,6,280
2025-08-28,10,Kínder,EduMax,206,11,195
2025-08-28,10,Kínder,TopKids,79,16,63
2025-08-28,10,Kínder,EduMax,106,23,83
2025-08-28,10,Kínder,TopKids,240,1,239
2025-08-28,10,Kínder,TopKids,86,6,80
2025-08-28,10,Primaria 1°,SuperSchool,55,13,42
2025-08-28,10,Primaria 1°,EduMax,274,1,273
2025-08-28,10,Primaria 1°,SuperSchool,127,8,119
2025-08-28,10,Primaria 1°,SuperSchool,168,10,158
2025-08-28,10,Primaria 1°,EduMax,186,18,168
2025-08-28,10,Primaria 1°,TopKids,181,2,179
2025-08-28,10,Primaria 1°,EduMax,87,17,70
2025-08-28,10,Primaria 1°,TopKids,273,23,250
2025-08-28,10,Primaria 1°,TopKids,175,20,155
2025-08-28,10,Primaria 1°,TopKids,233,21,212
2025-08-28,10,Primaria 2°,SuperSchool,125,10,115
2025-08-28,10,Primaria 2°,SuperSchool,171,17,154
2025-08-28,10,Primaria 2°,TopKids,291,16,275
2025-08-28,10,Primaria 2°,EduMax,121,21,100
2025-08-28,10,Primaria 2°,SuperSchool,135,13,122
2025-08-28,10,Primaria 2°,TopKids,253,17,236
2025-08-28,10,Primaria 3°,SuperSchool,228,17,211
2025-08-28,10,Primaria 3°,SuperSchool,113,6,107
2025-08-28,10,Primaria 3°,SuperSchool,205,10,195
2025-08-28,10,Primaria 3°,SuperSchool,205,4,201
2025-08-28,10,Primaria 3°,TopKids,70,22,48
2025-08-28,10,Primaria 3°,EduMax,203,18,185
2025-08-28,10,Primaria 3°,SuperSchool,64,23,41
2025-08-28,10,Primaria 3°,SuperSchool,183,11,172
2025-08-28,10,Primaria 3°,TopKids,298,14,284
2025-08-28,10,Primaria 3°,TopKids,101,9,92
2025-08-28,10,Primaria 3°,TopKids,164,12,152
2025-08-28,10,Primaria 3°,EduMax,220,8,212
2025-08-28,10,Primaria 3°,TopKids,100,3,97
2025-08-28,10,Primaria 4°,EduMax,79,3,76
2025-08-28,10,Primaria 4°,EduMax,188,20,168
2025-08-28,10,Primaria 4°,EduMax,80,2,78
2025-08-28,10,Primaria 4°,TopKids,166,16,150
2025-08-28,10,Primaria 4°,EduMax,229,5,224
2025-08-28,10,Primaria 4°,SuperSchool,61,1,60
2025-08-28,10,Primaria 4°,TopKids,299,19,280
2025-08-28,10,Primaria 4°,SuperSchool,112,15,97
2025-08-28,10,Primaria 4°,EduMax,161,7,154
2025-08-28,10,Primaria 4°,EduMax,266,16,250
2025-08-28,10,Primaria 4°,SuperSchool,269,7,262
2025-08-28,10,Primaria 4°,TopKids,98,5,93
2025-08-28,10,Primaria 4°,SuperSchool,116,16,100
2025-08-28,10,Primaria 5°,SuperSchool,192,4,188
2025-08-28,10,Primaria 5°,SuperSchool,290,24,266
2025-08-28,10,Primaria 5°,TopKids,175,24,151
2025-08-28,10,Primaria 5°,TopKids,197,10,187
2025-08-28,10,Primaria 5°,TopKids,131,2,129
2025-08-28,10,Primaria 5°,EduMax,257,24,233
2025-08-28,10,Primaria 5°,TopKids,168,19,149
2025-08-28,10,Primaria 5°,EduMax,283,7,276
2025-08-28,10,Primaria 5°,TopKids,149,17,132
2025-08-28,10,Primaria 5°,SuperSchool,117,21,96
2025-08-28,10,Primaria 5°,SuperSchool,274,19,255
2025-08-28,10,Primaria 5°,EduMax,139,23,116
2025-08-28,10,Primaria 6°,TopKids,242,8,234
2025-08-28,10,Primaria 6°,SuperSchool,138,22,116
2025-08-28,10,Primaria 6°,TopKids,226,18,208
2025-08-28,10,Primaria 6°,TopKids,67,7,60
2025-08-28,10,Primaria 6°,SuperSchool,202,18,184
2025-08-28,10,Primaria 6°,TopKids,116,7,109
2025-08-28,10,Primaria 6°,TopKids,251,12,239
2025-08-28,10,Primaria 6°,TopKids,132,15,117
2025-08-28,10,Primaria 6°,SuperSchool,70,5,65
2025-08-28,10,Primaria 6°,SuperSchool,81,9,72
2025-08-28,10,Primaria 6°,EduMax,204,23,181
2025-08-28,10,Primaria 6°,EduMax,89,9,80
2025-08-28,10,Primaria 6°,EduMax,73,18,55
2025-08-28,10,Primaria 6°,EduMax,233,15,218
2025-08-28,10,Primaria 6°,SuperSchool,284,2,282
2025-08-28,11,Preescolar,EduMax,212,23,189
2025-08-28,11,Preescolar,TopKids,138,3,135
2025-08-28,11,Preescolar,SuperSchool,170,7,163
2025-08-28,11,Preescolar,EduMax,227,21,206
2025-08-28,11,Preescolar,SuperSchool,58,18,40
2025-08-28,11,Preescolar,SuperSchool,53,4,49
2025-08-28,11,Preescolar,SuperSchool,139,23,116
2025-08-28,11,Preescolar,EduMax,204,15,189
2025-08-28,11,Preescolar,SuperSchool,81,9,72
2025-08-28,11,Preescolar,TopKids,238,12,226
2025-08-28,11,Preescolar,EduMax,72,15,57
2025-08-28,11,Preescolar,SuperSchool,209,9,200
2025-08-28,11,Kínder,SuperSchool,193,2,191
2025-08-28,11,Kínder,EduMax,202,18,184
2025-08-28,11,Kínder,SuperSchool,275,13,262
2025-08-28,11,Kínder,TopKids,111,15,96
2025-08-28,11,Kínder,TopKids,232,10,222
2025-08-28,11,Kínder,EduMax,232,22,210
2025-08-28,11,Kínder,EduMax,250,18,232
2025-08-28,11,Kínder,TopKids,151,15,136
2025-08-28,11,Kínder,EduMax,192,20,172
2025-08-28,11,Kínder,EduMax,103,12,91
2025-08-28,11,Kínder,EduMax,196,8,188
2025-08-28,11,Kínder,SuperSchool,76,10,66
2025-08-28,11,Kínder,TopKids,229,14,215
2025-08-28,11,Kínder,EduMax,113,2,111
2025-08-28,11,Primaria 1°,EduMax,226,15,211
2025-08-28,11,Primaria 1°,SuperSchool,296,3,293
2025-08-28,11,Primaria 1°,TopKids,212,3,209
2025-08-28,11,Primaria 1°,EduMax,247,14,233
2025-08-28,11,Primaria 1°,EduMax,180,1,179
2025-08-28,11,Primaria 1°,EduMax,62,9,53
2025-08-28,11,Primaria 1°,EduMax,135,2,133
2025-08-28,11,Primaria 1°,EduMax,74,12,62
2025-08-28,11,Primaria 1°,TopKids,180,19,161
2025-08-28,11,Primaria 1°,SuperSchool,299,15,284
2025-08-28,11,Primaria 1°,TopKids,203,13,190
2025-08-28,11,Primaria 1°,TopKids,211,22,189
2025-08-28,11,Primaria 1°,TopKids,72,16,56
2025-08-28,11,Primaria 1°,EduMax,143,23,120
2025-08-28,11,Primaria 1°,TopKids,101,19,82
2025-08-28,11,Primaria 1°,TopKids,90,4,86
2025-08-28,11,Primaria 1°,EduMax,200,10,190
2025-08-28,11,Primaria 1°,TopKids,134,1,133
2025-08-28,11,Primaria 2°,SuperSchool,296,15,281
2025-08-28,11,Primaria 2°,SuperSchool,92,20,72
2025-08-28,11,Primaria 2°,SuperSchool,126,6,120
2025-08-28,11,Primaria 2°,SuperSchool,51,17,34
2025-08-28,11,Primaria 2°,EduMax,127,7,120
2025-08-28,11,Primaria 2°,EduMax,267,14,253
2025-08-28,11,Primaria 2°,TopKids,122,14,108
2025-08-28,11,Primaria 2°,SuperSchool,258,17,241
2025-08-28,11,Primaria 2°,SuperSchool,102,13,89
2025-08-28,11,Primaria 2°,SuperSchool,270,18,252
2025-08-28,11,Primaria 3°,TopKids,130,6,124
2025-08-28,11,Primaria 3°,EduMax,52,15,37
2025-08-28,11,Primaria 3°,TopKids,232,15,217
2025-08-28,11,Primaria 3°,SuperSchool,294,3,291
2025-08-28,11,Primaria 3°,SuperSchool,108,14,94
2025-08-28,11,Primaria 3°,EduMax,269,9,260
2025-08-28,11,Primaria 3°,EduMax,283,8,275
2025-08-28,11,Primaria 3°,EduMax,126,2,124
2025-08-28,11,Primaria 3°,SuperSchool,69,7,62
2025-08-28,11,Primaria 3°,TopKids,246,18,228
2025-08-28,11,Primaria 3°,TopKids,171,10,161
2025-08-28,11,Primaria 3°,EduMax,148,23,125
2025-08-28,11,Primaria 3°,SuperSchool,129,10,119
2025-08-28,11,Primaria 3°,TopKids,196,16,180
2025-08-28,11,Primaria 3°,EduMax,220,22,198
2025-08-28,11,Primaria 3°,EduMax,82,24,58
2025-08-28,11,Primaria 3°,SuperSchool,198,14,184
2025-08-28,11,Primaria 3°,EduMax,280,5,275
2025-08-28,11,Primaria 3°,SuperSchool,160,5,155
2025-08-28,11,Primaria 4°,TopKids,270,2,268
2025-08-28,11,Primaria 4°,SuperSchool,139,5,134
2025-08-28,11,Primaria 4°,EduMax,225,2,223
2025-08-28,11,Primaria 4°,SuperSchool,288,1,287
2025-08-28,11,Primaria 4°,TopKids,212,19,193
2025-08-28,11,Primaria 4°,TopKids,276,8,268
2025-08-28,11,Primaria 4°,TopKids,114,6,108
2025-08-28,11,Primaria 4°,EduMax,66,16,50
2025-08-28,11,Primaria 4°,SuperSchool,178,3,175
2025-08-28,11,Primaria 4°,TopKids,177,24,153
2025-08-28,11,Primaria 4°,EduMax,101,21,80
2025-08-28,11,Primaria 4°,EduMax,52,15,37
2025-08-28,11,Primaria 4°,EduMax,96,11,85
2025-08-28,11,Primaria 4°,TopKids,135,6,129
2025-08-28,11,Primaria 4°,EduMax,282,14,268
2025-08-28,11,Primaria 4°,TopKids,299,11,288
2025-08-28,11,Primaria 4°,EduMax,163,20,143
2025-08-28,11,Primaria 5°,EduMax,218,11,207
2025-08-28,11,Primaria 5°,EduMax,80,6,74
2025-08-28,11,Primaria 5°,EduMax,140,23,117
2025-08-28,11,Primaria 5°,EduMax,159,24,135
2025-08-28,11,Primaria 5°,SuperSchool,138,5,133
2025-08-28,11,Primaria 5°,SuperSchool,202,11,191
2025-08-28,11,Primaria 5°,TopKids,179,24,155
2025-08-28,11,Primaria 5°,SuperSchool,238,24,214
2025-08-28,11,Primaria 5°,EduMax,127,7,120
2025-08-28,11,Primaria 5°,SuperSchool,85,10,75
2025-08-28,11,Primaria 5°,SuperSchool,129,6,123
2025-08-28,11,Primaria 5°,SuperSchool,151,9,142
2025-08-28,11,Primaria 5°,SuperSchool,142,16,126
2025-08-28,11,Primaria 5°,TopKids,258,13,245
2025-08-28,11,Primaria 5°,EduMax,243,8,235
2025-08-28,11,Primaria 5°,TopKids,167,4,163
2025-08-28,11,Primaria 5°,SuperSchool,200,7,193
2025-08-28,11,Primaria 5°,TopKids,70,1,69
2025-08-28,11,Primaria 5°,EduMax,111,2,109
2025-08-28,11,Primaria 6°,TopKids,150,18,132
2025-08-28,11,Primaria 6°,SuperSchool,137,20,117
2025-08-28,11,Primaria 6°,TopKids,54,7,47
2025-08-28,11,Primaria 6°,EduMax,258,13,245
2025-08-28,11,Primaria 6°,TopKids,150,13,137
2025-08-28,11,Primaria 6°,SuperSchool,168,13,155
2025-08-28,11,Primaria 6°,TopKids,185,10,175
2025-08-28,11,Primaria 6°,SuperSchool,236,11,225
2025-08-28,11,Primaria 6°,SuperSchool,88,8,80
2025-08-28,11,Primaria 6°,EduMax,75,14,61
2025-08-28,11,Primaria 6°,TopKids,84,2,82
2025-08-28,11,Primaria 6°,EduMax,291,22,269
2025-08-28,12,Preescolar,TopKids,95,18,77
2025-08-28,12,Preescolar,SuperSchool,57,4,53
2025-08-28,12,Preescolar,TopKids,93,14,79
2025-08-28,12,Preescolar,TopKids,169,12,157
2025-08-28,12,Preescolar,SuperSchool,250,10,240
2025-08-28,12,Preescolar,EduMax,261,2,259
2025-08-28,12,Preescolar,EduMax,161,21,140
2025-08-28,12,Preescolar,TopKids,67,20,47
2025-08-28,12,Preescolar,EduMax,265,10,255
2025-08-28,12,Preescolar,SuperSchool,279,6,273
2025-08-28,12,Preescolar,EduMax,229,13,216
2025-08-28,12,Preescolar,TopKids,130,2,128
2025-08-28,12,Preescolar,EduMax,235,7,228
2025-08-28,12,Preescolar,TopKids,127,22,105
2025-08-28,12,Kínder,SuperSchool,262,11,251
2025-08-28,12,Kínder,TopKids,229,14,215
2025-08-28,12,Kínder,TopKids,185,3,182
2025-08-28,12,Kínder,EduMax,232,14,218
2025-08-28,12,Kínder,SuperSchool,121,17,104
2025-08-28,12,Kínder,SuperSchool,285,2,283
2025-08-28,12,Kínder,SuperSchool,126,22,104
2025-08-28,12,Kínder,EduMax,218,9,209
2025-08-28,12,Kínder,SuperSchool,76,20,56
2025-08-28,12,Kínder,EduMax,189,10,179
2025-08-28,12,Kínder,EduMax,150,18,132
2025-08-28,12,Kínder,TopKids,80,13,67
2025-08-28,12,Kínder,SuperSchool,279,21,258
2025-08-28,12,Kínder,SuperSchool,89,9,80
2025-08-28,12,Kínder,TopKids,187,8,179
2025-08-28,12,Kínder,EduMax,179,18,161
2025-08-28,12,Kínder,TopKids,81,24,57
2025-08-28,12,Kínder,EduMax,297,14,283
2025-08-28,12,Kínder,SuperSchool,138,22,116
2025-08-28,12,Primaria 1°,TopKids,163,24,139
2025-08-28,12,Primaria 1°,TopKids,79,1,78
2025-08-28,12,Primaria 1°,TopKids,113,1,112
2025-08-28,12,Primaria 1°,EduMax,268,1,267
2025-08-28,12,Primaria 1°,SuperSchool,245,12,233
2025-08-28,12,Primaria 1°,TopKids,206,4,202
2025-08-28,12,Primaria 1°,EduMax,155,11,144
2025-08-28,12,Primaria 1°,EduMax,283,12,271
2025-08-28,12,Primaria 1°,TopKids,192,16,176
2025-08-28,12,Primaria 1°,EduMax,135,23,112
2025-08-28,12,Primaria 1°,TopKids,65,17,48
2025-08-28,12,Primaria 1°,EduMax,129,14,115
2025-08-28,12,Primaria 2°,EduMax,194,23,171
2025-08-28,12,Primaria 2°,TopKids,91,21,70
2025-08-28,12,Primaria 2°,EduMax,223,20,203
2025-08-28,12,Primaria 2°,SuperSchool,58,15,43
2025-08-28,12,Primaria 2°,TopKids,51,4,47
2025-08-28,12,Primaria 2°,EduMax,188,5,183
2025-08-28,12,Primaria 2°,EduMax,249,22,227
2025-08-28,12,Primaria 2°,SuperSchool,179,5,174
2025-08-28,12,Primaria 2°,TopKids,209,12,197
2025-08-28,12,Primaria 2°,TopKids,152,19,133
2025-08-28,12,Primaria 3°,TopKids,95,19,76
2025-08-28,12,Primaria 3°,EduMax,299,18,281
2025-08-28,12,Primaria 3°,EduMax,120,15,105
2025-08-28,12,Primaria 3°,SuperSchool,146,12,134
2025-08-28,12,Primaria 3°,EduMax,238,24,214
2025-08-28,12,Primaria 3°,TopKids,236,23,213
2025-08-28,12,Primaria 3°,EduMax,75,13,62
2025-08-28,12,Primaria 3°,TopKids,175,6,169
2025-08-28,12,Primaria 4°,TopKids,160,16,144
2025-08-28,12,Primaria 4°,SuperSchool,286,20,266
2025-08-28,12,Primaria 4°,TopKids,258,3,255
2025-08-28,12,Primaria 4°,TopKids,98,6,92
2025-08-28,12,Primaria 4°,TopKids,271,12,259
2025-08-28,12,Primaria 4°,SuperSchool,296,12,284
2025-08-28,12,Primaria 4°,TopKids,71,2,69
2025-08-28,12,Primaria 4°,TopKids,65,24,41
2025-08-28,12,Primaria 4°,EduMax,93,16,77
2025-08-28,12,Primaria 4°,EduMax,114,22,92
2025-08-28,12,Primaria 4°,TopKids,122,7,115
2025-08-28,12,Primaria 4°,SuperSchool,238,10,228
2025-08-28,12,Primaria 4°,TopKids,123,18,105
2025-08-28,12,Primaria 4°,TopKids,106,18,88
2025-08-28,12,Primaria 4°,SuperSchool,124,10,114
2025-08-28,12,Primaria 4°,EduMax,272,9,263
2025-08-28,12,Primaria 4°,TopKids,191,3,188
2025-08-28,12,Primaria 5°,EduMax,102,16,86
2025-08-28,12,Primaria 5°,TopKids,238,3,235
2025-08-28,12,Primaria 5°,EduMax,110,24,86
2025-08-28,12,Primaria 5°,EduMax,104,18,86
2025-08-28,12,Primaria 5°,TopKids,98,6,92
2025-08-28,12,Primaria 5°,EduMax,56,4,52
2025-08-28,12,Primaria 5°,TopKids,257,17,240
2025-08-28,12,Primaria 5°,EduMax,197,19,178
2025-08-28,12,Primaria 5°,EduMax,134,18,116
2025-08-28,12,Primaria 5°,TopKids,211,19,192
2025-08-28,12,Primaria 5°,TopKids,279,12,267
2025-08-28,12,Primaria 5°,EduMax,210,23,187
2025-08-28,12,Primaria 6°,TopKids,92,19,73
2025-08-28,12,Primaria 6°,EduMax,272,4,268
2025-08-28,12,Primaria 6°,SuperSchool,260,21,239
2025-08-28,12,Primaria 6°,EduMax,89,22,67
2025-08-28,12,Primaria 6°,SuperSchool,144,10,134
2025-08-28,12,Primaria 6°,EduMax,207,10,197
2025-08-28,12,Primaria 6°,EduMax,85,18,67
2025-08-28,12,Primaria 6°,SuperSchool,92,16,76
2025-08-28,12,Primaria 6°,TopKids,156,23,133
2025-08-28,12,Primaria 6°,SuperSchool,201,13,188
2025-08-28,12,Primaria 6°,TopKids,151,7,144
2025-08-28,12,Primaria 6°,EduMax,211,9,202
2025-08-28,13,Preescolar,SuperSchool,164,1,163
2025-08-28,13,Preescolar,EduMax,121,10,111
2025-08-28,13,Preescolar,EduMax,220,17,203
2025-08-28,13,Preescolar,TopKids,138,7,131
2025-08-28,13,Preescolar,EduMax,236,3,233
2025-08-28,13,Preescolar,SuperSchool,280,6,274
2025-08-28,13,Preescolar,TopKids,185,1,184
2025-08-28,13,Preescolar,SuperSchool,169,19,150
2025-08-28,13,Preescolar,TopKids,158,11,147
2025-08-28,13,Preescolar,EduMax,75,11,64
2025-08-28,13,Preescolar,EduMax,282,2,280
2025-08-28,13,Preescolar,SuperSchool,164,12,152
2025-08-28,13,Preescolar,SuperSchool,282,23,259
2025-08-28,13,Preescolar,EduMax,182,9,173
2025-08-28,13,Kínder,EduMax,59,17,42
2025-08-28,13,Kínder,EduMax,59,14,45
2025-08-28,13,Kínder,EduMax,105,22,83
2025-08-28,13,Kínder,EduMax,291,5,286
2025-08-28,13,Kínder,SuperSchool,279,16,263
2025-08-28,13,Kínder,EduMax,136,16,120
2025-08-28,13,Kínder,SuperSchool,124,21,103
2025-08-28,13,Kínder,TopKids,164,3,161
2025-08-28,13,Kínder,SuperSchool,261,5,256
2025-08-28,13,Kínder,EduMax,218,5,213
2025-08-28,13,Kínder,SuperSchool,229,17,212
2025-08-28,13,Primaria 1°,EduMax,229,20,209
2025-08-28,13,Primaria 1°,TopKids,146,16,130
2025-08-28,13,Primaria 1°,TopKids,143,2,141
2025-08-28,13,Primaria 1°,TopKids,89,1,88
2025-08-28,13,Primaria 1°,EduMax,180,8,172
2025-08-28,13,Primaria 1°,EduMax,281,11,270
2025-08-28,13,Primaria 1°,SuperSchool,134,5,129
2025-08-28,13,Primaria 1°,EduMax,134,9,125
2025-08-28,13,Primaria 1°,SuperSchool,150,19,131
2025-08-28,13,Primaria 1°,TopKids,115,19,96
2025-08-28,13,Primaria 1°,TopKids,96,8,88
2025-08-28,13,Primaria 1°,TopKids,141,24,117
2025-08-28,13,Primaria 1°,TopKids,89,1,88
2025-08-28,13,Primaria 1°,EduMax,188,7,181
2025-08-28,13,Primaria 2°,TopKids,96,10,86
2025-08-28,13,Primaria 2°,SuperSchool,205,1,204
2025-08-28,13,Primaria 2°,EduMax,69,20,49
2025-08-28,13,Primaria 2°,SuperSchool,250,13,237
2025-08-28,13,Primaria 2°,SuperSchool,204,17,187
2025-08-28,13,Primaria 2°,SuperSchool,131,17,114
2025-08-28,13,Primaria 3°,TopKids,187,9,178
2025-08-28,13,Primaria 3°,SuperSchool,67,12,55
2025-08-28,13,Primaria 3°,TopKids,291,5,286
2025-08-28,13,Primaria 3°,TopKids,192,3,189
2025-08-28,13,Primaria 3°,EduMax,87,6,81
2025-08-28,13,Primaria 3°,TopKids,101,1,100
2025-08-28,13,Primaria 3°,SuperSchool,194,11,183
2025-08-28,13,Primaria 3°,EduMax,108,24,84
2025-08-28,13,Primaria 3°,EduMax,241,9,232
2025-08-28,13,Primaria 4°,EduMax,74,7,67
2025-08-28,13,Primaria 4°,TopKids,211,10,201
2025-08-28,13,Primaria 4°,EduMax,162,16,146
2025-08-28,13,Primaria 4°,EduMax,268,1,267
2025-08-28,13,Primaria 4°,SuperSchool,251,1,250
2025-08-28,13,Primaria 4°,TopKids,117,3,114
2025-08-28,13,Primaria 4°,SuperSchool,126,21,105
2025-08-28,13,Primaria 5°,SuperSchool,123,6,117
2025-08-28,13,Primaria 5°,TopKids,170,1,169
2025-08-28,13,Primaria 5°,SuperSchool,197,4,193
2025-08-28,13,Primaria 5°,EduMax,299,10,289
2025-08-28,13,Primaria 5°,EduMax,235,15,220
2025-08-28,13,Primaria 5°,TopKids,206,1,205
2025-08-28,13,Primaria 5°,EduMax,198,15,183
2025-08-28,13,Primaria 5°,TopKids,210,6,204
2025-08-28,13,Primaria 5°,TopKids,181,12,169
2025-08-28,13,Primaria 5°,SuperSchool,147,17,130
2025-08-28,13,Primaria 5°,EduMax,119,12,107
2025-08-28,13,Primaria 5°,TopKids,128,17,111
2025-08-28,13,Primaria 5°,SuperSchool,63,23,40
2025-08-28,13,Primaria 5°,EduMax,53,20,33
2025-08-28,13,Primaria 5°,EduMax,295,14,281
2025-08-28,13,Primaria 5°,EduMax,109,8,101
2025-08-28,13,Primaria 5°,SuperSchool,225,7,218
2025-08-28,13,Primaria 5°,TopKids,247,22,225
2025-08-28,13,Primaria 5°,TopKids,132,10,122
2025-08-28,13,Primaria 6°,EduMax,75,10,65
2025-08-28,13,Primaria 6°,SuperSchool,292,3,289
2025-08-28,13,Primaria 6°,TopKids,229,6,223
2025-08-28,13,Primaria 6°,SuperSchool,163,10,153
2025-08-28,13,Primaria 6°,EduMax,173,13,160
2025-08-28,13,Primaria 6°,EduMax,61,14,47
2025-08-28,13,Primaria 6°,SuperSchool,295,8,287
2025-08-28,13,Primaria 6°,TopKids,299,5,294
2025-08-28,13,Primaria 6°,SuperSchool,277,6,271
2025-08-28,13,Primaria 6°,TopKids,271,5,266
2025-08-28,13,Primaria 6°,SuperSchool,135,14,121
2025-08-28,14,Preescolar,EduMax,60,3,57
2025-08-28,14,Preescolar,TopKids,72,8,64
2025-08-28,14,Preescolar,SuperSchool,214,20,194
2025-08-28,14,Preescolar,TopKids,107,21,86
2025-08-28,14,Preescolar,EduMax,268,8,260
2025-08-28,14,Preescolar,SuperSchool,250,15,235
2025-08-28,14,Preescolar,SuperSchool,232,5,227
2025-08-28,14,Preescolar,TopKids,213,19,194
2025-08-28,14,Preescolar,EduMax,72,2,70
2025-08-28,14,Preescolar,SuperSchool,131,23,108
2025-08-28,14,Preescolar,EduMax,174,10,164
2025-08-28,14,Preescolar,TopKids,264,9,255
2025-08-28,14,Preescolar,SuperSchool,291,7,284
2025-08-28,14,Preescolar,EduMax,129,2,127
2025-08-28,14,Preescolar,EduMax,162,6,156
2025-08-28,14,Preescolar,EduMax,63,15,48
2025-08-28,14,Preescolar,SuperSchool,189,19,170
2025-08-28,14,Preescolar,TopKids,146,8,138
2025-08-28,14,Kínder,EduMax,285,20,265
2025-08-28,14,Kínder,SuperSchool,131,12,119
2025-08-28,14,Kínder,EduMax,179,7,172
2025-08-28,14,Kínder,TopKids,154,18,136
2025-08-28,14,Kínder,SuperSchool,298,8,290
2025-08-28,14,Kínder,SuperSchool,182,16,166
2025-08-28,14,Kínder,EduMax,107,13,94
2025-08-28,14,Kínder,SuperSchool,60,20,40
2025-08-28,14,Kínder,TopKids,222,15,207
2025-08-28,14,Kínder,EduMax,105,16,89
2025-08-28,14,Primaria 1°,EduMax,228,15,213
2025-08-28,14,Primaria 1°,EduMax,72,4,68
2025-08-28,14,Primaria 1°,EduMax,121,24,97
2025-08-28,14,Primaria 1°,TopKids,270,12,258
2025-08-28,14,Primaria 1°,EduMax,291,19,272
2025-08-28,14,Primaria 1°,SuperSchool,246,7,239
2025-08-28,14,Primaria 1°,EduMax,156,21,135
2025-08-28,14,Primaria 1°,EduMax,72,21,51
2025-08-28,14,Primaria 1°,TopKids,283,24,259
2025-08-28,14,Primaria 1°,TopKids,193,1,192
2025-08-28,14,Primaria 1°,TopKids,114,12,102
2025-08-28,14,Primaria 1°,SuperSchool,223,18,205
2025-08-28,14,Primaria 1°,SuperSchool,147,12,135
2025-08-28,14,Primaria 1°,SuperSchool,155,2,153
2025-08-28,14,Primaria 1°,TopKids,245,19,226
2025-08-28,14,Primaria 1°,EduMax,245,9,236
2025-08-28,14,Primaria 1°,SuperSchool,91,14,77
2025-08-28,14,Primaria 2°,TopKids,212,20,192
2025-08-28,14,Primaria 2°,SuperSchool,255,22,233
2025-08-28,14,Primaria 2°,SuperSchool,201,23,178
2025-08-28,14,Primaria 2°,SuperSchool,214,13,201
2025-08-28,14,Primaria 2°,TopKids,234,4,230
2025-08-28,14,Primaria 2°,TopKids,63,20,43
2025-08-28,14,Primaria 2°,TopKids,85,17,68
2025-08-28,14,Primaria 2°,EduMax,218,4,214
2025-08-28,14,Primaria 2°,TopKids,68,9,59
2025-08-28,14,Primaria 2°,EduMax,216,7,209
2025-08-28,14,Primaria 2°,TopKids,125,20,105
2025-08-28,14,Primaria 2°,EduMax,125,20,105
2025-08-28,14,Primaria 2°,EduMax,96,23,73
2025-08-28,14,Primaria 3°,EduMax,230,22,208
2025-08-28,14,Primaria 3°,SuperSchool,117,11,106
2025-08-28,14,Primaria 3°,TopKids,282,3,279
2025-08-28,14,Primaria 3°,TopKids,147,9,138
2025-08-28,14,Primaria 3°,TopKids,297,10,287
2025-08-28,14,Primaria 3°,TopKids,276,17,259
2025-08-28,14,Primaria 3°,TopKids,66,19,47
2025-08-28,14,Primaria 3°,EduMax,73,14,59
2025-08-28,14,Primaria 3°,SuperSchool,64,3,61
2025-08-28,14,Primaria 3°,SuperSchool,101,22,79
2025-08-28,14,Primaria 4°,SuperSchool,167,13,154
2025-08-28,14,Primaria 4°,EduMax,71,20,51
2025-08-28,14,Primaria 4°,SuperSchool,80,7,73
2025-08-28,14,Primaria 4°,TopKids,289,16,273
2025-08-28,14,Primaria 4°,EduMax,139,6,133
2025-08-28,14,Primaria 4°,EduMax,181,3,178
2025-08-28,14,Primaria 4°,SuperSchool,116,19,97
2025-08-28,14,Primaria 4°,SuperSchool,223,19,204
2025-08-28,14,Primaria 4°,TopKids,299,13,286
2025-08-28,14,Primaria 4°,EduMax,176,16,160
2025-08-28,14,Primaria 4°,EduMax,225,9,216
2025-08-28,14,Primaria 4°,SuperSchool,112,24,88
2025-08-28,14,Primaria 4°,TopKids,235,3,232
2025-08-28,14,Primaria 4°,TopKids,229,18,211
2025-08-28,14,Primaria 5°,EduMax,210,12,198
2025-08-28,14,Primaria 5°,SuperSchool,251,9,242
2025-08-28,14,Primaria 5°,SuperSchool,140,18,122
2025-08-28,14,Primaria 5°,EduMax,117,8,109
2025-08-28,14,Primaria 5°,TopKids,262,4,258
2025-08-28,14,Primaria 5°,EduMax,289,21,268
2025-08-28,14,Primaria 5°,TopKids,198,8,190
2025-08-28,14,Primaria 5°,TopKids,232,24,208
2025-08-28,14,Primaria 5°,SuperSchool,173,8,165
2025-08-28,14,Primaria 5°,EduMax,56,24,32
2025-08-28,14,Primaria 5°,SuperSchool,182,18,164
2025-08-28,14,Primaria 5°,EduMax,232,19,213
2025-08-28,14,Primaria 5°,EduMax,60,8,52
2025-08-28,14,Primaria 5°,EduMax,60,16,44
2025-08-28,14,Primaria 5°,EduMax,53,2,51
2025-08-28,14,Primaria 5°,SuperSchool,216,17,199
2025-08-28,14,Primaria 5°,TopKids,94,10,84
2025-08-28,14,Primaria 5°,SuperSchool,219,7,212
2025-08-28,14,Primaria 6°,SuperSchool,193,3,190
2025-08-28,14,Primaria 6°,SuperSchool,55,10,45
2025-08-28,14,Primaria 6°,SuperSchool,205,4,201
2025-08-28,14,Primaria 6°,TopKids,125,10,115
2025-08-28,14,Primaria 6°,TopKids,61,19,42
2025-08-28,14,Primaria 6°,SuperSchool,68,22,46
2025-08-28,14,Primaria 6°,SuperSchool,277,13,264
2025-08-28,14,Primaria 6°,EduMax,159,16,143
2025-08-28,14,Primaria 6°,EduMax,249,13,236
2025-08-28,14,Primaria 6°,EduMax,242,12,230
2025-08-28,14,Primaria 6°,SuperSchool,120,16,104
2025-08-28,14,Primaria 6°,EduMax,91,3,88
2025-08-28,14,Primaria 6°,SuperSchool,201,1,200
2025-08-28,14,Primaria 6°,SuperSchool,87,1,86
2025-08-28,15,Preescolar,TopKids,286,6,280
2025-08-28,15,Preescolar,SuperSchool,286,22,264
2025-08-28,15,Preescolar,SuperSchool,168,10,158
2025-08-28,15,Preescolar,SuperSchool,85,13,72
2025-08-28,15,Preescolar,SuperSchool,208,4,204
2025-08-28,15,Preescolar,EduMax,261,8,253
2025-08-28,15,Preescolar,TopKids,213,9,204
2025-08-28,15,Preescolar,TopKids,201,5,196
2025-08-28,15,Preescolar,SuperSchool,153,4,149
2025-08-28,15,Preescolar,SuperSchool,197,13,184
2025-08-28,15,Preescolar,SuperSchool,145,22,123
2025-08-28,15,Preescolar,EduMax,113,21,92
2025-08-28,15,Kínder,SuperSchool,244,4,240
2025-08-28,15,Kínder,SuperSchool,76,21,55
2025-08-28,15,Kínder,TopKids,135,22,113
2025-08-28,15,Kínder,SuperSchool,235,6,229
2025-08-28,15,Kínder,TopKids,95,7,88
2025-08-28,15,Kínder,TopKids,183,13,170
2025-08-28,15,Kínder,EduMax,256,16,240
2025-08-28,15,Kínder,SuperSchool,256,24,232
2025-08-28,15,Kínder,TopKids,109,9,100
2025-08-28,15,Kínder,TopKids,255,19,236
2025-08-28,15,Kínder,EduMax,154,1,153
2025-08-28,15,Kínder,EduMax,184,14,170
2025-08-28,15,Kínder,EduMax,111,1,110
2025-08-28,15,Kínder,TopKids,167,1,166
2025-08-28,15,Primaria 1°,TopKids,115,3,112
2025-08-28,15,Primaria 1°,EduMax,270,12,258
2025-08-28,15,Primaria 1°,SuperSchool,149,22,127
2025-08-28,15,Primaria 1°,TopKids,229,22,207
2025-08-28,15,Primaria 1°,TopKids,214,12,202
2025-08-28,15,Primaria 1°,TopKids,299,20,279
2025-08-28,15,Primaria 1°,TopKids,135,7,128
2025-08-28,15,Primaria 1°,EduMax,93,2,91
2025-08-28,15,Primaria 1°,EduMax,104,16,88
2025-08-28,15,Primaria 1°,TopKids,117,20,97
2025-08-28,15,Primaria 1°,SuperSchool,223,9,214
2025-08-28,15,Primaria 1°,SuperSchool,243,5,238
2025-08-28,15,Primaria 1°,TopKids,174,3,171
2025-08-28,15,Primaria 1°,EduMax,185,10,175
2025-08-28,15,Primaria 1°,SuperSchool,147,14,133
2025-08-28,15,Primaria 1°,TopKids,149,21,128
2025-08-28,15,Primaria 1°,SuperSchool,63,16,47
2025-08-28,15,Primaria 2°,EduMax,161,4,157
2025-08-28,15,Primaria 2°,SuperSchool,52,1,51
2025-08-28,15,Primaria 2°,EduMax,277,9,268
2025-08-28,15,Primaria 2°,SuperSchool,289,23,266
2025-08-28,15,Primaria 2°,TopKids,209,24,185
2025-08-28,15,Primaria 2°,EduMax,254,17,237
2025-08-28,15,Primaria 2°,TopKids,235,21,214
2025-08-28,15,Primaria 2°,EduMax,253,8,245
2025-08-28,15,Primaria 2°,TopKids,112,16,96
2025-08-28,15,Primaria 3°,TopKids,224,11,213
2025-08-28,15,Primaria 3°,EduMax,112,14,98
2025-08-28,15,Primaria 3°,TopKids,222,9,213
2025-08-28,15,Primaria 3°,SuperSchool,99,3,96
2025-08-28,15,Primaria 3°,EduMax,208,5,203
2025-08-28,15,Primaria 3°,EduMax,76,24,52
2025-08-28,15,Primaria 3°,EduMax,71,21,50
2025-08-28,15,Primaria 4°,SuperSchool,105,20,85
2025-08-28,15,Primaria 4°,SuperSchool,208,20,188
2025-08-28,15,Primaria 4°,TopKids,249,21,228
2025-08-28,15,Primaria 4°,SuperSchool,179,4,175
2025-08-28,15,Primaria 4°,TopKids,211,3,208
2025-08-28,15,Primaria 5°,SuperSchool,183,15,168
2025-08-28,15,Primaria 5°,SuperSchool,110,9,101
2025-08-28,15,Primaria 5°,EduMax,212,23,189
2025-08-28,15,Primaria 5°,TopKids,62,22,40
2025-08-28,15,Primaria 5°,TopKids,188,16,172
2025-08-28,15,Primaria 5°,TopKids,297,6,291
2025-08-28,15,Primaria 5°,EduMax,124,20,104
2025-08-28,15,Primaria 5°,EduMax,193,12,181
2025-08-28,15,Primaria 6°,TopKids,268,24,244
2025-08-28,15,Primaria 6°,EduMax,192,6,186
2025-08-28,15,Primaria 6°,EduMax,260,8,252
2025-08-28,15,Primaria 6°,TopKids,239,4,235
2025-08-28,15,Primaria 6°,EduMax,254,22,232
2025-08-28,15,Primaria 6°,EduMax,274,8,266
2025-08-28,15,Primaria 6°,TopKids,290,10,280
2025-08-28,15,Primaria 6°,SuperSchool,178,21,157
2025-08-28,15,Primaria 6°,SuperSchool,178,21,157
2025-08-28,15,Primaria 6°,TopKids,134,20,114
2025-08-28,15,Primaria 6°,SuperSchool,122,16,106
2025-08-28,16,Preescolar,EduMax,290,4,286
2025-08-28,16,Preescolar,TopKids,162,24,138
2025-08-28,16,Preescolar,EduMax,161,2,159
2025-08-28,16,Preescolar,TopKids,252,13,239
2025-08-28,16,Preescolar,SuperSchool,96,12,84
2025-08-28,16,Preescolar,SuperSchool,250,7,243
2025-08-28,16,Preescolar,TopKids,193,4,189
2025-08-28,16,Preescolar,EduMax,296,14,282
2025-08-28,16,Preescolar,EduMax,62,20,42
2025-08-28,16,Preescolar,TopKids,76,2,74
2025-08-28,16,Preescolar,EduMax,237,19,218
2025-08-28,16,Preescolar,TopKids,152,15,137
2025-08-28,16,Preescolar,SuperSchool,201,16,185
2025-08-28,16,Preescolar,SuperSchool,237,16,221
2025-08-28,16,Preescolar,EduMax,226,4,222
2025-08-28,16,Preescolar,EduMax,226,17,209
2025-08-28,16,Kínder,EduMax,103,2,101
2025-08-28,16,Kínder,SuperSchool,64,16,48
2025-08-28,16,Kínder,TopKids,142,2,140
2025-08-28,16,Kínder,SuperSchool,79,24,55
2025-08-28,16,Kínder,EduMax,77,14,63
2025-08-28,16,Kínder,EduMax,127,23,104
2025-08-28,16,Kínder,SuperSchool,61,24,37
2025-08-28,16,Kínder,SuperSchool,154,8,146
2025-08-28,16,Kínder,EduMax,56,15,41
2025-08-28,16,Kínder,SuperSchool,122,4,118
2025-08-28,16,Kínder,TopKids,264,6,258
2025-08-28,16,Kínder,TopKids,228,22,206
2025-08-28,16,Kínder,EduMax,112,19,93
2025-08-28,16,Kínder,TopKids,197,20,177
2025-08-28,16,Kínder,EduMax,288,12,276
2025-08-28,16,Kínder,SuperSchool,114,23,91
2025-08-28,16,Kínder,EduMax,277,22,255
2025-08-28,16,Kínder,TopKids,216,13,203
2025-08-28,16,Kínder,EduMax,56,22,34
2025-08-28,16,Primaria 1°,SuperSchool,92,21,71
2025-08-28,16,Primaria 1°,SuperSchool,176,4,172
2025-08-28,16,Primaria 1°,EduMax,115,9,106
2025-08-28,16,Primaria 1°,TopKids,128,21,107
2025-08-28,16,Primaria 1°,SuperSchool,227,16,211
2025-08-28,16,Primaria 1°,EduMax,75,12,63
2025-08-28,16,Primaria 1°,SuperSchool,274,2,272
2025-08-28,16,Primaria 1°,EduMax,268,7,261
2025-08-28,16,Primaria 1°,SuperSchool,192,17,175
2025-08-28,16,Primaria 1°,SuperSchool,254,2,252
2025-08-28,16,Primaria 1°,TopKids,209,15,194
2025-08-28,16,Primaria 1°,TopKids,132,14,118
2025-08-28,16,Primaria 1°,TopKids,277,11,266
2025-08-28,16,Primaria 1°,TopKids,203,2,201
2025-08-28,16,Primaria 1°,EduMax,218,22,196
2025-08-28,16,Primaria 2°,TopKids,112,23,89
2025-08-28,16,Primaria 2°,SuperSchool,238,21,217
2025-08-28,16,Primaria 2°,TopKids,85,8,77
2025-08-28,16,Primaria 2°,TopKids,203,18,185
2025-08-28,16,Primaria 2°,TopKids,83,22,61
2025-08-28,16,Primaria 2°,TopKids,98,7,91
2025-08-28,16,Primaria 2°,TopKids,281,10,271
2025-08-28,16,Primaria 2°,TopKids,254,23,231
2025-08-28,16,Primaria 2°,SuperSchool,126,19,107
2025-08-28,16,Primaria 2°,SuperSchool,71,9,62
2025-08-28,16,Primaria 2°,SuperSchool,110,16,94
2025-08-28,16,Primaria 2°,EduMax,118,9,109
2025-08-28,16,Primaria 2°,SuperSchool,55,21,34
2025-08-28,16,Primaria 2°,EduMax,163,11,152
2025-08-28,16,Primaria 2°,TopKids,280,14,266
2025-08-28,16,Primaria 3°,TopKids,288,19,269
2025-08-28,16,Primaria 3°,EduMax,258,3,255
2025-08-28,16,Primaria 3°,TopKids,280,10,270
2025-08-28,16,Primaria 3°,SuperSchool,173,17,156
2025-08-28,16,Primaria 3°,TopKids,185,17,168
2025-08-28,16,Primaria 3°,TopKids,149,8,141
2025-08-28,16,Primaria 3°,SuperSchool,146,18,128
2025-08-28,16,Primaria 3°,TopKids,70,6,64
2025-08-28,16,Primaria 3°,SuperSchool,174,19,155
2025-08-28,16,Primaria 3°,EduMax,232,17,215
2025-08-28,16,Primaria 3°,EduMax,252,14,238
2025-08-28,16,Primaria 3°,SuperSchool,271,20,251
2025-08-28,16,Primaria 4°,SuperSchool,248,17,231
2025-08-28,16,Primaria 4°,SuperSchool,167,14,153
2025-08-28,16,Primaria 4°,TopKids,169,13,156
2025-08-28,16,Primaria 4°,SuperSchool,189,14,175
2025-08-28,16,Primaria 4°,SuperSchool,250,4,246
2025-08-28,16,Primaria 4°,EduMax,132,1,131
2025-08-28,16,Primaria 4°,SuperSchool,286,6,280
2025-08-28,16,Primaria 4°,SuperSchool,266,22,244
2025-08-28,16,Primaria 4°,SuperSchool,236,3,233
2025-08-28,16,Primaria 4°,SuperSchool,51,22,29
2025-08-28,16,Primaria 4°,TopKids,274,21,253
2025-08-28,16,Primaria 4°,EduMax,224,4,220
2025-08-28,16,Primaria 5°,SuperSchool,190,23,167
2025-08-28,16,Primaria 5°,SuperSchool,261,1,260
2025-08-28,16,Primaria 5°,EduMax,215,11,204
2025-08-28,16,Primaria 5°,EduMax,94,21,73
2025-08-28,16,Primaria 5°,TopKids,69,7,62
2025-08-28,16,Primaria 5°,TopKids,297,7,290
2025-08-28,16,Primaria 5°,EduMax,92,1,91
2025-08-28,16,Primaria 5°,SuperSchool,78,13,65
2025-08-28,16,Primaria 5°,SuperSchool,152,12,140
2025-08-28,16,Primaria 5°,SuperSchool,236,8,228
2025-08-28,16,Primaria 6°,TopKids,100,20,80
2025-08-28,16,Primaria 6°,EduMax,95,2,93
2025-08-28,16,Primaria 6°,EduMax,161,9,152
2025-08-28,16,Primaria 6°,EduMax,298,21,277
2025-08-28,16,Primaria 6°,TopKids,164,15,149
2025-08-28,16,Primaria 6°,EduMax,125,9,116
2025-08-28,16,Primaria 6°,EduMax,293,15,278
2025-08-29,9,Preescolar,SuperSchool,72,10,62
2025-08-29,9,Preescolar,EduMax,110,3,107
2025-08-29,9,Preescolar,EduMax,125,1,124
2025-08-29,9,Preescolar,SuperSchool,289,10,279
2025-08-29,9,Preescolar,SuperSchool,227,1,226
2025-08-29,9,Preescolar,EduMax,88,10,78
2025-08-29,9,Preescolar,TopKids,154,5,149
2025-08-29,9,Preescolar,TopKids,245,20,225
2025-08-29,9,Preescolar,SuperSchool,121,16,105
2025-08-29,9,Preescolar,SuperSchool,290,15,275
2025-08-29,9,Preescolar,TopKids,227,6,221
2025-08-29,9,Preescolar,EduMax,118,19,99
2025-08-29,9,Preescolar,TopKids,154,2,152
2025-08-29,9,Preescolar,TopKids,145,24,121
2025-08-29,9,Preescolar,EduMax,171,24,147
2025-08-29,9,Preescolar,TopKids,175,15,160
2025-08-29,9,Preescolar,EduMax,254,9,245
2025-08-29,9,Kínder,EduMax,90,21,69
2025-08-29,9,Kínder,TopKids,248,12,236
2025-08-29,9,Kínder,TopKids,184,8,176
2025-08-29,9,Kínder,TopKids,220,4,216
2025-08-29,9,Kínder,EduMax,228,7,221
2025-08-29,9,Kínder,EduMax,108,13,95
2025-08-29,9,Kínder,SuperSchool,238,18,220
2025-08-29,9,Kínder,EduMax,184,20,164
2025-08-29,9,Kínder,TopKids,173,5,168
2025-08-29,9,Kínder,TopKids,279,2,277
2025-08-29,9,Kínder,TopKids,102,9,93
2025-08-29,9,Kínder,SuperSchool,226,17,209
2025-08-29,9,Kínder,TopKids,259,24,235
2025-08-29,9,Kínder,TopKids,156,12,144
2025-08-29,9,Kínder,TopKids,66,12,54
2025-08-29,9,Kínder,TopKids,174,24,150
2025-08-29,9,Kínder,TopKids,142,21,121
2025-08-29,9,Kínder,TopKids,123,16,107
2025-08-29,9,Kínder,TopKids,289,2,287
2025-08-29,9,Primaria 1°,EduMax,99,5,94
2025-08-29,9,Primaria 1°,EduMax,272,8,264
2025-08-29,9,Primaria 1°,EduMax,113,9,104
2025-08-29,9,Primaria 1°,EduMax,294,17,277
2025-08-29,9,Primaria 1°,TopKids,253,13,240
2025-08-29,9,Primaria 1°,EduMax,168,11,157
2025-08-29,9,Primaria 1°,EduMax,223,1,222
2025-08-29,9,Primaria 1°,TopKids,112,15,97
2025-08-29,9,Primaria 1°,SuperSchool,67,22,45
2025-08-29,9,Primaria 1°,EduMax,290,1,289
2025-08-29,9,Primaria 1°,EduMax,69,24,45
2025-08-29,9,Primaria 1°,EduMax,97,4,93
2025-08-29,9,Primaria 1°,EduMax,151,16,135
2025-08-29,9,Primaria 2°,EduMax,96,1,95
2025-08-29,9,Primaria 2°,TopKids,200,11,189
2025-08-29,9,Primaria 2°,SuperSchool,217,14,203
2025-08-29,9,Primaria 2°,SuperSchool,222,15,207
2025-08-29,9,Primaria 2°,SuperSchool,185,19,166
2025-08-29,9,Primaria 2°,SuperSchool,292,18,274
2025-08-29,9,Primaria 2°,EduMax,268,4,264
2025-08-29,9,Primaria 2°,EduMax,105,5,100
2025-08-29,9,Primaria 3°,EduMax,173,7,166
2025-08-29,9,Primaria 3°,SuperSchool,129,1,128
2025-08-29,9,Primaria 3°,SuperSchool,253,19,234
2025-08-29,9,Primaria 3°,SuperSchool,289,7,282
2025-08-29,9,Primaria 3°,EduMax,174,15,159
2025-08-29,9,Primaria 4°,TopKids,119,6,113
2025-08-29,9,Primaria 4°,TopKids,237,3,234
2025-08-29,9,Primaria 4°,EduMax,246,8,238
2025-08-29,9,Primaria 4°,TopKids,166,16,150
2025-08-29,9,Primaria 4°,TopKids,143,23,120
2025-08-29,9,Primaria 4°,TopKids,129,6,123
2025-08-29,9,Primaria 4°,EduMax,82,18,64
2025-08-29,9,Primaria 4°,EduMax,249,5,244
2025-08-29,9,Primaria 4°,EduMax,246,22,224
2025-08-29,9,Primaria 4°,SuperSchool,62,21,41
2025-08-29,9,Primaria 4°,EduMax,71,12,59
2025-08-29,9,Primaria 4°,EduMax,284,9,275
2025-08-29,9,Primaria 4°,TopKids,59,16,43
2025-08-29,9,Primaria 4°,TopKids,219,21,198
2025-08-29,9,Primaria 4°,TopKids,230,8,222
2025-08-29,9,Primaria 4°,TopKids,239,6,233
2025-08-29,9,Primaria 5°,SuperSchool,140,23,117
2025-08-29,9,Primaria 5°,EduMax,265,5,260
2025-08-29,9,Primaria 5°,EduMax,295,3,292
2025-08-29,9,Primaria 5°,TopKids,137,22,115
2025-08-29,9,Primaria 5°,TopKids,194,3,191
2025-08-29,9,Primaria 5°,TopKids,247,11,236
2025-08-29,9,Primaria 5°,SuperSchool,135,1,134
2025-08-29,9,Primaria 5°,TopKids,257,3,254
2025-08-29,9,Primaria 6°,SuperSchool,100,7,93
2025-08-29,9,Primaria 6°,EduMax,169,11,158
2025-08-29,9,Primaria 6°,TopKids,73,19,54
2025-08-29,9,Primaria 6°,SuperSchool,242,24,218
2025-08-29,9,Primaria 6°,EduMax,67,10,57
2025-08-29,9,Primaria 6°,SuperSchool,206,13,193
2025-08-29,9,Primaria 6°,SuperSchool,189,24,165
2025-08-29,9,Primaria 6°,TopKids,75,12,63
2025-08-29,9,Primaria 6°,EduMax,129,12,117
2025-08-29,9,Primaria 6°,SuperSchool,299,24,275
2025-08-29,9,Primaria 6°,EduMax,278,19,259
2025-08-29,9,Primaria 6°,EduMax,152,24,128
2025-08-29,9,Primaria 6°,TopKids,86,11,75
2025-08-29,9,Primaria 6°,SuperSchool,269,24,245
2025-08-29,9,Primaria 6°,SuperSchool,244,2,242
2025-08-29,9,Primaria 6°,TopKids,78,2,76
2025-08-29,9,Primaria 6°,EduMax,171,1,170
2025-08-29,9,Primaria 6°,TopKids,259,2,257
2025-08-29,10,Preescolar,TopKids,80,21,59
2025-08-29,10,Preescolar,SuperSchool,254,12,242
2025-08-29,10,Preescolar,TopKids,139,24,115
2025-08-29,10,Preescolar,EduMax,231,21,210
2025-08-29,10,Preescolar,EduMax,123,12,111
2025-08-29,10,Preescolar,SuperSchool,263,14,249
2025-08-29,10,Preescolar,EduMax,208,19,189
2025-08-29,10,Preescolar,SuperSchool,73,3,70
2025-08-29,10,Preescolar,SuperSchool,121,5,116
2025-08-29,10,Preescolar,EduMax,77,12,65
2025-08-29,10,Preescolar,SuperSchool,102,16,86
2025-08-29,10,Preescolar,EduMax,189,23,166
2025-08-29,10,Preescolar,SuperSchool,267,9,258
2025-08-29,10,Preescolar,SuperSchool,136,4,132
2025-08-29,10,Preescolar,TopKids,85,15,70
2025-08-29,10,Preescolar,EduMax,264,6,258
2025-08-29,10,Kínder,EduMax,170,15,155
2025-08-29,10,Kínder,EduMax,124,2,122
2025-08-29,10,Kínder,EduMax,240,2,238
2025-08-29,10,Kínder,SuperSchool,252,5,247
2025-08-29,10,Kínder,EduMax,55,3,52
2025-08-29,10,Kínder,SuperSchool,165,9,156
2025-08-29,10,Kínder,TopKids,118,23,95
2025-08-29,10,Primaria 1°,TopKids,255,22,233
2025-08-29,10,Primaria 1°,SuperSchool,288,23,265
2025-08-29,10,Primaria 1°,TopKids,117,11,106
2025-08-29,10,Primaria 1°,EduMax,90,6,84
2025-08-29,10,Primaria 1°,TopKids,66,9,57
2025-08-29,10,Primaria 1°,TopKids,104,6,98
2025-08-29,10,Primaria 1°,EduMax,241,4,237
2025-08-29,10,Primaria 1°,TopKids,244,24,220
2025-08-29,10,Primaria 1°,EduMax,209,16,193
2025-08-29,10,Primaria 1°,SuperSchool,97,12,85
2025-08-29,10,Primaria 1°,EduMax,112,9,103
2025-08-29,10,Primaria 1°,TopKids,63,20,43
2025-08-29,10,Primaria 1°,EduMax,188,7,181
2025-08-29,10,Primaria 1°,TopKids,196,21,175
2025-08-29,10,Primaria 1°,TopKids,238,6,232
2025-08-29,10,Primaria 1°,SuperSchool,200,8,192
2025-08-29,10,Primaria 2°,EduMax,112,2,110
2025-08-29,10,Primaria 2°,EduMax,106,2,104
2025-08-29,10,Primaria 2°,TopKids,69,10,59
2025-08-29,10,Primaria 2°,SuperSchool,271,24,247
2025-08-29,10,Primaria 2°,EduMax,215,22,193
2025-08-29,10,Primaria 2°,SuperSchool,127,5,122
2025-08-29,10,Primaria 2°,EduMax,179,14,165
2025-08-29,10,Primaria 2°,SuperSchool,83,23,60
2025-08-29,10,Primaria 2°,SuperSchool,148,15,133
2025-08-29,10,Primaria 3°,TopKids,125,6,119
2025-08-29,10,Primaria 3°,TopKids,194,6,188
2025-08-29,10,Primaria 3°,TopKids,260,17,243
2025-08-29,10,Primaria 3°,SuperSchool,281,24,257
2025-08-29,10,Primaria 3°,TopKids,272,8,264
2025-08-29,10,Primaria 3°,TopKids,153,3,150
2025-08-29,10,Primaria 3°,TopKids,210,8,202
2025-08-29,10,Primaria 3°,SuperSchool,231,12,219
2025-08-29,10,Primaria 3°,EduMax,130,8,122
2025-08-29,10,Primaria 3°,EduMax,133,11,122
2025-08-29,10,Primaria 3°,EduMax,268,7,261
2025-08-29,10,Primaria 4°,EduMax,256,12,244
2025-08-29,10,Primaria 4°,SuperSchool,281,14,267
2025-08-29,10,Primaria 4°,SuperSchool,75,15,60
2025-08-29,10,Primaria 4°,SuperSchool,266,11,255
2025-08-29,10,Primaria 4°,TopKids,257,20,237
2025-08-29,10,Primaria 4°,EduMax,59,19,40
2025-08-29,10,Primaria 4°,EduMax,79,1,78
2025-08-29,10,Primaria 4°,TopKids,103,4,99
2025-08-29,10,Primaria 4°,TopKids,184,1,183
2025-08-29,10,Primaria 4°,SuperSchool,202,8,194
2025-08-29,10,Primaria 4°,EduMax,66,8,58
2025-08-29,10,Primaria 4°,SuperSchool,50,15,35
2025-08-29,10,Primaria 4°,TopKids,95,12,83
2025-08-29,10,Primaria 4°,SuperSchool,268,3,265
2025-08-29,10,Primaria 4°,TopKids,197,18,179
2025-08-29,10,Primaria 4°,EduMax,271,6,265
2025-08-29,10,Primaria 4°,EduMax,120,7,113
2025-08-29,10,Primaria 4°,SuperSchool,146,8,138
2025-08-29,10,Primaria 5°,EduMax,79,23,56
2025-08-29,10,Primaria 5°,SuperSchool,73,20,53
2025-08-29,10,Primaria 5°,TopKids,110,17,93
2025-08-29,10,Primaria 5°,SuperSchool,174,16,158
2025-08-29,10,Primaria 5°,TopKids,60,12,48
2025-08-29,10,Primaria 5°,EduMax,138,3,135
2025-08-29,10,Primaria 5°,SuperSchool,58,14,44
2025-08-29,10,Primaria 5°,EduMax,120,11,109
2025-08-29,10,Primaria 5°,EduMax,52,19,33
2025-08-29,10,Primaria 5°,EduMax,194,2,192
2025-08-29,10,Primaria 5°,SuperSchool,193,17,176
2025-08-29,10,Primaria 5°,EduMax,245,11,234
2025-08-29,10,Primaria 5°,EduMax,107,17,90
2025-08-29,10,Primaria 6°,EduMax,201,12,189
2025-08-29,10,Primaria 6°,SuperSchool,155,16,139
2025-08-29,10,Primaria 6°,TopKids,58,6,52
2025-08-29,10,Primaria 6°,SuperSchool,255,24,231
2025-08-29,10,Primaria 6°,EduMax,131,13,118
2025-08-29,10,Primaria 6°,SuperSchool,76,23,53
2025-08-29,10,Primaria 6°,TopKids,149,3,146
2025-08-29,10,Primaria 6°,EduMax,250,10,240
2025-08-29,10,Primaria 6°,SuperSchool,66,10,56
2025-08-29,10,Primaria 6°,EduMax,97,17,80
2025-08-29,10,Primaria 6°,TopKids,133,7,126
2025-08-29,10,Primaria 6°,SuperSchool,175,10,165
2025-08-29,10,Primaria 6°,SuperSchool,255,17,238
2025-08-29,10,Primaria 6°,SuperSchool,205,14,191
2025-08-29,10,Primaria 6°,TopKids,62,2,60
2025-08-29,10,Primaria 6°,TopKids,154,3,151
2025-08-29,11,Preescolar,EduMax,192,20,172
2025-08-29,11,Preescolar,EduMax,54,2,52
2025-08-29,11,Preescolar,EduMax,122,14,108
2025-08-29,11,Preescolar,SuperSchool,165,4,161
2025-08-29,11,Preescolar,SuperSchool,283,2,281
2025-08-29,11,Preescolar,EduMax,203,19,184
2025-08-29,11,Preescolar,SuperSchool,100,19,81
2025-08-29,11,Preescolar,TopKids,122,3,119
2025-08-29,11,Kínder,EduMax,290,13,277
2025-08-29,11,Kínder,SuperSchool,248,9,239
2025-08-29,11,Kínder,SuperSchool,266,18,248
2025-08-29,11,Kínder,SuperSchool,103,22,81
2025-08-29,11,Kínder,SuperSchool,89,21,68
2025-08-29,11,Kínder,TopKids,218,1,217
2025-08-29,11,Kínder,SuperSchool,78,20,58
2025-08-29,11,Kínder,TopKids,81,11,70
2025-08-29,11,Kínder,SuperSchool,161,14,147
2025-08-29,11,Kínder,TopKids,229,22,207
2025-08-29,11,Primaria 1°,EduMax,266,22,244
2025-08-29,11,Primaria 1°,EduMax,263,9,254
2025-08-29,11,Primaria 1°,SuperSchool,136,3,133
2025-08-29,11,Primaria 1°,SuperSchool,212,14,198
2025-08-29,11,Primaria 1°,EduMax,159,23,136
2025-08-29,11,Primaria 1°,EduMax,263,13,250
2025-08-29,11,Primaria 1°,SuperSchool,64,20,44
2025-08-29,11,Primaria 1°,TopKids,193,20,173
2025-08-29,11,Primaria 1°,TopKids,262,1,261
2025-08-29,11,Primaria 2°,TopKids,260,6,254
2025-08-29,11,Primaria 2°,EduMax,273,1,272
2025-08-29,11,Primaria 2°,EduMax,175,16,159
2025-08-29,11,Primaria 2°,TopKids,67,13,54
2025-08-29,11,Primaria 2°,EduMax,141,10,131
2025-08-29,11,Primaria 2°,EduMax,101,11,90
2025-08-29,11,Primaria 2°,EduMax,172,24,148
2025-08-29,11,Primaria 2°,TopKids,285,17,268
2025-08-29,11,Primaria 2°,TopKids,239,21,218
2025-08-29,11,Primaria 2°,SuperSchool,50,6,44
2025-08-29,11,Primaria 2°,TopKids,233,4,229
2025-08-29,11,Primaria 2°,EduMax,254,12,242
2025-08-29,11,Primaria 2°,SuperSchool,271,8,263
2025-08-29,11,Primaria 2°,EduMax,105,7,98
2025-08-29,11,Primaria 2°,SuperSchool,216,7,209
2025-08-29,11,Primaria 2°,EduMax,174,18,156
2025-08-29,11,Primaria 2°,TopKids,164,24,140
2025-08-29,11,Primaria 2°,SuperSchool,172,20,152
2025-08-29,11,Primaria 2°,EduMax,164,18,146
2025-08-29,11,Primaria 3°,TopKids,198,2,196
2025-08-29,11,Primaria 3°,TopKids,69,11,58
2025-08-29,11,Primaria 3°,TopKids,195,22,173
2025-08-29,11,Primaria 3°,TopKids,276,4,272
2025-08-29,11,Primaria 3°,EduMax,125,21,104
2025-08-29,11,Primaria 3°,SuperSchool,271,12,259
2025-08-29,11,Primaria 3°,EduMax,93,13,80
2025-08-29,11,Primaria 3°,EduMax,78,16,62
2025-08-29,11,Primaria 3°,SuperSchool,145,14,131
2025-08-29,11,Primaria 3°,TopKids,175,11,164
2025-08-29,11,Primaria 4°,EduMax,297,6,291
2025-08-29,11,Primaria 4°,EduMax,70,4,66
2025-08-29,11,Primaria 4°,EduMax,218,10,208
2025-08-29,11,Primaria 4°,EduMax,182,10,172
2025-08-29,11,Primaria 4°,TopKids,188,6,182
2025-08-29,11,Primaria 4°,TopKids,184,12,172
2025-08-29,11,Primaria 4°,TopKids,286,17,269
2025-08-29,11,Primaria 4°,SuperSchool,237,8,229
2025-08-29,11,Primaria 4°,TopKids,129,21,108
2025-08-29,11,Primaria 4°,TopKids,150,21,129
2025-08-29,11,Primaria 4°,SuperSchool,104,13,91
2025-08-29,11,Primaria 4°,EduMax,102,16,86
2025-08-29,11,Primaria 4°,SuperSchool,159,11,148
2025-08-29,11,Primaria 4°,SuperSchool,227,8,219
2025-08-29,11,Primaria 5°,TopKids,293,2,291
2025-08-29,11,Primaria 5°,SuperSchool,199,9,190
2025-08-29,11,Primaria 5°,EduMax,256,11,245
2025-08-29,11,Primaria 5°,SuperSchool,190,24,166
2025-08-29,11,Primaria 5°,SuperSchool,113,5,108
2025-08-29,11,Primaria 5°,EduMax,104,5,99
2025-08-29,11,Primaria 5°,SuperSchool,74,18,56
2025-08-29,11,Primaria 5°,TopKids,237,24,213
2025-08-29,11,Primaria 5°,TopKids,185,17,168
2025-08-29,11,Primaria 5°,TopKids,139,23,116
2025-08-29,11,Primaria 5°,SuperSchool,124,11,113
2025-08-29,11,Primaria 5°,TopKids,217,8,209
2025-08-29,11,Primaria 5°,SuperSchool,105,21,84
2025-08-29,11,Primaria 5°,SuperSchool,276,22,254
2025-08-29,11,Primaria 5°,EduMax,164,14,150
2025-08-29,11,Primaria 5°,EduMax,72,3,69
2025-08-29,11,Primaria 6°,EduMax,252,10,242
2025-08-29,11,Primaria 6°,EduMax,50,16,34
2025-08-29,11,Primaria 6°,SuperSchool,111,6,105
2025-08-29,11,Primaria 6°,EduMax,129,19,110
2025-08-29,11,Primaria 6°,SuperSchool,140,12,128
2025-08-29,11,Primaria 6°,EduMax,170,2,168
2025-08-29,11,Primaria 6°,SuperSchool,200,11,189
2025-08-29,11,Primaria 6°,TopKids,72,20,52
2025-08-29,11,Primaria 6°,TopKids,270,8,262
2025-08-29,11,Primaria 6°,SuperSchool,195,5,190
2025-08-29,11,Primaria 6°,EduMax,160,5,155
2025-08-29,11,Primaria 6°,SuperSchool,145,23,122
2025-08-29,11,Primaria 6°,TopKids,177,12,165
2025-08-29,11,Primaria 6°,EduMax,57,20,37
2025-08-29,11,Primaria 6°,SuperSchool,153,13,140
2025-08-29,11,Primaria 6°,TopKids,136,3,133
2025-08-29,11,Primaria 6°,TopKids,216,18,198
2025-08-29,12,Preescolar,TopKids,295,23,272
2025-08-29,12,Preescolar,TopKids,243,7,236
2025-08-29,12,Preescolar,EduMax,152,14,138
2025-08-29,12,Preescolar,TopKids,65,24,41
2025-08-29,12,Preescolar,EduMax,121,16,105
2025-08-29,12,Preescolar,SuperSchool,88,11,77
2025-08-29,12,Preescolar,EduMax,200,13,187
2025-08-29,12,Preescolar,SuperSchool,285,18,267
2025-08-29,12,Preescolar,EduMax,152,12,140
2025-08-29,12,Kínder,EduMax,158,1,157
2025-08-29,12,Kínder,TopKids,97,16,81
2025-08-29,12,Kínder,SuperSchool,193,16,177
2025-08-29,12,Kínder,EduMax,220,19,201
2025-08-29,12,Kínder,TopKids,115,7,108
2025-08-29,12,Kínder,SuperSchool,90,14,76
2025-08-29,12,Kínder,EduMax,251,16,235
2025-08-29,12,Kínder,EduMax,146,24,122
2025-08-29,12,Kínder,EduMax,261,4,257
2025-08-29,12,Kínder,EduMax,181,23,158
2025-08-29,12,Kínder,EduMax,235,22,213
2025-08-29,12,Kínder,EduMax,54,11,43
2025-08-29,12,Kínder,SuperSchool,212,19,193
2025-08-29,12,Kínder,TopKids,252,21,231
2025-08-29,12,Kínder,TopKids,179,22,157
2025-08-29,12,Kínder,TopKids,167,8,159
2025-08-29,12,Primaria 1°,TopKids,297,20,277
2025-08-29,12,Primaria 1°,TopKids,256,16,240
2025-08-29,12,Primaria 1°,SuperSchool,296,17,279
2025-08-29,12,Primaria 1°,EduMax,127,1,126
2025-08-29,12,Primaria 1°,TopKids,210,3,207
2025-08-29,12,Primaria 1°,EduMax,105,15,90
2025-08-29,12,Primaria 2°,SuperSchool,53,14,39
2025-08-29,12,Primaria 2°,TopKids,71,24,47
2025-08-29,12,Primaria 2°,TopKids,124,14,110
2025-08-29,12,Primaria 2°,EduMax,204,10,194
2025-08-29,12,Primaria 2°,TopKids,251,14,237
2025-08-29,12,Primaria 2°,EduMax,86,22,64
2025-08-29,12,Primaria 2°,SuperSchool,100,8,92
2025-08-29,12,Primaria 2°,TopKids,111,17,94
2025-08-29,12,Primaria 2°,TopKids,77,16,61
2025-08-29,12,Primaria 3°,SuperSchool,213,13,200
2025-08-29,12,Primaria 3°,TopKids,114,9,105
2025-08-29,12,Primaria 3°,TopKids,269,4,265
2025-08-29,12,Primaria 3°,EduMax,271,9,262
2025-08-29,12,Primaria 3°,EduMax,276,15,261
2025-08-29,12,Primaria 3°,TopKids,78,5,73
2025-08-29,12,Primaria 3°,SuperSchool,284,19,265
2025-08-29,12,Primaria 3°,SuperSchool,112,22,90
2025-08-29,12,Primaria 4°,SuperSchool,176,19,157
2025-08-29,12,Primaria 4°,SuperSchool,86,24,62
2025-08-29,12,Primaria 4°,SuperSchool,268,9,259
2025-08-29,12,Primaria 4°,EduMax,87,21,66
2025-08-29,12,Primaria 4°,SuperSchool,139,21,118
2025-08-29,12,Primaria 4°,TopKids,168,24,144
2025-08-29,12,Primaria 4°,TopKids,274,17,257
2025-08-29,12,Primaria 4°,EduMax,119,3,116
2025-08-29,12,Primaria 4°,SuperSchool,285,11,274
2025-08-29,12,Primaria 4°,TopKids,179,19,160
2025-08-29,12,Primaria 4°,SuperSchool,223,15,208
2025-08-29,12,Primaria 4°,SuperSchool,128,21,107
2025-08-29,12,Primaria 4°,EduMax,210,12,198
2025-08-29,12,Primaria 4°,SuperSchool,168,5,163
2025-08-29,12,Primaria 4°,EduMax,268,15,253
2025-08-29,12,Primaria 4°,TopKids,68,7,61
2025-08-29,12,Primaria 4°,TopKids,88,2,86
2025-08-29,12,Primaria 5°,TopKids,221,5,216
2025-08-29,12,Primaria 5°,TopKids,248,16,232
2025-08-29,12,Primaria 5°,TopKids,262,2,260
2025-08-29,12,Primaria 5°,SuperSchool,186,20,166
2025-08-29,12,Primaria 5°,SuperSchool,61,7,54
2025-08-29,12,Primaria 5°,EduMax,77,16,61
2025-08-29,12,Primaria 6°,EduMax,124,7,117
2025-08-29,12,Primaria 6°,EduMax,132,14,118
2025-08-29,12,Primaria 6°,SuperSchool,264,19,245
2025-08-29,12,Primaria 6°,EduMax,237,13,224
2025-08-29,12,Primaria 6°,TopKids,116,2,114
2025-08-29,13,Preescolar,SuperSchool,208,7,201
2025-08-29,13,Preescolar,EduMax,278,20,258
2025-08-29,13,Preescolar,TopKids,69,1,68
2025-08-29,13,Preescolar,TopKids,120,5,115
2025-08-29,13,Preescolar,SuperSchool,181,11,170
2025-08-29,13,Preescolar,TopKids,151,20,131
2025-08-29,13,Preescolar,TopKids,78,18,60
2025-08-29,13,Preescolar,SuperSchool,238,20,218
2025-08-29,13,Preescolar,TopKids,294,20,274
2025-08-29,13,Preescolar,EduMax,149,17,132
2025-08-29,13,Preescolar,TopKids,67,6,61
2025-08-29,13,Preescolar,SuperSchool,133,22,111
2025-08-29,13,Preescolar,TopKids,253,9,244
2025-08-29,13,Kínder,TopKids,274,2,272
2025-08-29,13,Kínder,EduMax,113,3,110
2025-08-29,13,Kínder,EduMax,68,10,58
2025-08-29,13,Kínder,SuperSchool,223,19,204
2025-08-29,13,Kínder,TopKids,235,11,224
2025-08-29,13,Kínder,SuperSchool,55,19,36
2025-08-29,13,Kínder,EduMax,107,8,99
2025-08-29,13,Kínder,EduMax,295,18,277
2025-08-29,13,Kínder,SuperSchool,263,4,259
2025-08-29,13,Kínder,TopKids,243,24,219
2025-08-29,13,Kínder,EduMax,92,9,83
2025-08-29,13,Kínder,SuperSchool,57,5,52
2025-08-29,13,Primaria 1°,TopKids,70,5,65
2025-08-29,13,Primaria 1°,SuperSchool,229,16,213
2025-08-29,13,Primaria 1°,EduMax,255,5,250
2025-08-29,13,Primaria 1°,TopKids,228,4,224
2025-08-29,13,Primaria 1°,EduMax,233,11,222
2025-08-29,13,Primaria 1°,EduMax,94,16,78
2025-08-29,13,Primaria 1°,SuperSchool,257,7,250
2025-08-29,13,Primaria 1°,TopKids,208,13,195
2025-08-29,13,Primaria 1°,SuperSchool,172,15,157
2025-08-29,13,Primaria 1°,TopKids,67,20,47
2025-08-29,13,Primaria 1°,TopKids,179,8,171
2025-08-29,13,Primaria 1°,EduMax,59,10,49
2025-08-29,13,Primaria 1°,TopKids,230,21,209
2025-08-29,13,Primaria 1°,SuperSchool,110,17,93
2025-08-29,13,Primaria 1°,EduMax,163,17,146
2025-08-29,13,Primaria 1°,TopKids,144,7,137
2025-08-29,13,Primaria 1°,EduMax,79,4,75
2025-08-29,13,Primaria 2°,SuperSchool,139,11,128
2025-08-29,13,Primaria 2°,TopKids,247,10,237
2025-08-29,13,Primaria 2°,SuperSchool,141,15,126
2025-08-29,13,Primaria 2°,SuperSchool,183,16,167
2025-08-29,13,Primaria 2°,TopKids,129,14,115
2025-08-29,13,Primaria 2°,EduMax,299,9,290
2025-08-29,13,Primaria 2°,EduMax,274,22,252
2025-08-29,13,Primaria 2°,TopKids,159,8,151
2025-08-29,13,Primaria 2°,TopKids,173,24,149
2025-08-29,13,Primaria 2°,TopKids,90,19,71
2025-08-29,13,Primaria 2°,TopKids,151,18,133
2025-08-29,13,Primaria 2°,SuperSchool,260,11,249
2025-08-29,13,Primaria 2°,SuperSchool,271,24,247
2025-08-29,13,Primaria 2°,SuperSchool,250,24,226
2025-08-29,13,Primaria 2°,EduMax,153,11,142
2025-08-29,13,Primaria 2°,TopKids,103,6,97
2025-08-29,13,Primaria 2°,EduMax,128,6,122
2025-08-29,13,Primaria 2°,EduMax,103,11,92
2025-08-29,13,Primaria 2°,SuperSchool,256,12,244
2025-08-29,13,Primaria 3°,EduMax,206,15,191
2025-08-29,13,Primaria 3°,SuperSchool,257,22,235
2025-08-29,13,Primaria 3°,TopKids,226,11,215
2025-08-29,13,Primaria 3°,TopKids,151,22,129
2025-08-29,13,Primaria 3°,EduMax,243,1,242
2025-08-29,13,Primaria 3°,EduMax,107,5,102
2025-08-29,13,Primaria 3°,TopKids,167,22,145
2025-08-29,13,Primaria 3°,SuperSchool,118,18,100
2025-08-29,13,Primaria 3°,TopKids,268,19,249
2025-08-29,13,Primaria 3°,TopKids,224,9,215
2025-08-29,13,Primaria 3°,EduMax,278,17,261
2025-08-29,13,Primaria 3°,TopKids,197,17,180
2025-08-29,13,Primaria 3°,SuperSchool,58,13,45
2025-08-29,13,Primaria 4°,SuperSchool,214,14,200
2025-08-29,13,Primaria 4°,EduMax,216,5,211
2025-08-29,13,Primaria 4°,TopKids,218,10,208
2025-08-29,13,Primaria 4°,SuperSchool,242,14,228
2025-08-29,13,Primaria 4°,SuperSchool,155,11,144
2025-08-29,13,Primaria 4°,EduMax,168,2,166
2025-08-29,13,Primaria 4°,TopKids,168,24,144
2025-08-29,13,Primaria 4°,TopKids,249,3,246
2025-08-29,13,Primaria 4°,SuperSchool,171,16,155
2025-08-29,13,Primaria 4°,EduMax,129,10,119
2025-08-29,13,Primaria 5°,TopKids,185,20,165
2025-08-29,13,Primaria 5°,SuperSchool,55,8,47
2025-08-29,13,Primaria 5°,EduMax,63,3,60
2025-08-29,13,Primaria 5°,EduMax,71,1,70
2025-08-29,13,Primaria 5°,TopKids,134,6,128
2025-08-29,13,Primaria 5°,TopKids,183,18,165
2025-08-29,13,Primaria 5°,TopKids,230,19,211
2025-08-29,13,Primaria 5°,TopKids,297,5,292
2025-08-29,13,Primaria 5°,TopKids,250,12,238
2025-08-29,13,Primaria 5°,TopKids,168,13,155
2025-08-29,13,Primaria 6°,SuperSchool,230,21,209
2025-08-29,13,Primaria 6°,SuperSchool,240,2,238
2025-08-29,13,Primaria 6°,TopKids,89,14,75
2025-08-29,13,Primaria 6°,SuperSchool,144,6,138
2025-08-29,13,Primaria 6°,SuperSchool,152,14,138
2025-08-29,13,Primaria 6°,TopKids,151,16,135
2025-08-29,13,Primaria 6°,TopKids,140,4,136
2025-08-29,13,Primaria 6°,TopKids,129,4,125
2025-08-29,13,Primaria 6°,TopKids,134,2,132
2025-08-29,13,Primaria 6°,TopKids,121,10,111
2025-08-29,13,Primaria 6°,TopKids,179,6,173
2025-08-29,13,Primaria 6°,SuperSchool,50,6,44
2025-08-29,14,Preescolar,TopKids,191,15,176
2025-08-29,14,Preescolar,EduMax,66,9,57
2025-08-29,14,Preescolar,TopKids,259,24,235
2025-08-29,14,Preescolar,TopKids,102,18,84
2025-08-29,14,Preescolar,SuperSchool,97,9,88
2025-08-29,14,Preescolar,EduMax,212,12,200
2025-08-29,14,Preescolar,EduMax,50,9,41
2025-08-29,14,Preescolar,SuperSchool,209,20,189
2025-08-29,14,Preescolar,SuperSchool,89,11,78
2025-08-29,14,Preescolar,EduMax,223,16,207
2025-08-29,14,Preescolar,TopKids,228,22,206
2025-08-29,14,Preescolar,EduMax,203,8,195
2025-08-29,14,Preescolar,TopKids,74,8,66
2025-08-29,14,Preescolar,SuperSchool,133,10,123
2025-08-29,14,Preescolar,SuperSchool,168,11,157
2025-08-29,14,Preescolar,EduMax,229,17,212
2025-08-29,14,Kínder,TopKids,140,3,137
2025-08-29,14,Kínder,SuperSchool,296,8,288
2025-08-29,14,Kínder,TopKids,262,22,240
2025-08-29,14,Kínder,EduMax,68,14,54
2025-08-29,14,Kínder,SuperSchool,292,13,279
2025-08-29,14,Kínder,EduMax,239,23,216
2025-08-29,14,Kínder,EduMax,92,23,69
2025-08-29,14,Primaria 1°,SuperSchool,291,2,289
2025-08-29,14,Primaria 1°,TopKids,72,7,65
2025-08-29,14,Primaria 1°,TopKids,242,18,224
2025-08-29,14,Primaria 1°,SuperSchool,91,23,68
2025-08-29,14,Primaria 1°,SuperSchool,50,15,35
2025-08-29,14,Primaria 1°,TopKids,205,4,201
2025-08-29,14,Primaria 1°,EduMax,281,14,267
2025-08-29,14,Primaria 1°,SuperSchool,70,17,53
2025-08-29,14,Primaria 1°,TopKids,87,9,78
2025-08-29,14,Primaria 1°,EduMax,111,20,91
2025-08-29,14,Primaria 1°,TopKids,104,13,91
2025-08-29,14,Primaria 1°,SuperSchool,282,21,261
2025-08-29,14,Primaria 1°,SuperSchool,231,22,209
2025-08-29,14,Primaria 1°,TopKids,55,23,32
2025-08-29,14,Primaria 1°,TopKids,245,4,241
2025-08-29,14,Primaria 1°,SuperSchool,112,23,89
2025-08-29,14,Primaria 2°,EduMax,231,17,214
2025-08-29,14,Primaria 2°,TopKids,87,20,67
2025-08-29,14,Primaria 2°,SuperSchool,217,7,210
2025-08-29,14,Primaria 2°,SuperSchool,274,3,271
2025-08-29,14,Primaria 2°,EduMax,164,11,153
2025-08-29,14,Primaria 2°,EduMax,236,6,230
2025-08-29,14,Primaria 2°,SuperSchool,83,4,79
2025-08-29,14,Primaria 2°,SuperSchool,294,14,280
2025-08-29,14,Primaria 2°,SuperSchool,110,22,88
2025-08-29,14,Primaria 2°,EduMax,198,13,185
2025-08-29,14,Primaria 2°,EduMax,289,4,285
2025-08-29,14,Primaria 2°,SuperSchool,172,6,166
2025-08-29,14,Primaria 2°,SuperSchool,274,22,252
2025-08-29,14,Primaria 2°,SuperSchool,237,23,214
2025-08-29,14,Primaria 2°,EduMax,289,7,282
2025-08-29,14,Primaria 3°,TopKids,118,9,109
2025-08-29,14,Primaria 3°,TopKids,196,1,195
2025-08-29,14,Primaria 3°,TopKids,207,8,199
2025-08-29,14,Primaria 3°,TopKids,245,23,222
2025-08-29,14,Primaria 3°,EduMax,162,1,161
2025-08-29,14,Primaria 3°,EduMax,134,14,120
2025-08-29,14,Primaria 3°,EduMax,199,2,197
2025-08-29,14,Primaria 3°,SuperSchool,170,13,157
2025-08-29,14,Primaria 3°,TopKids,273,23,250
2025-08-29,14,Primaria 3°,EduMax,199,9,190
2025-08-29,14,Primaria 3°,SuperSchool,147,17,130
2025-08-29,14,Primaria 3°,EduMax,183,3,180
2025-08-29,14,Primaria 3°,TopKids,261,17,244
2025-08-29,14,Primaria 3°,EduMax,217,14,203
2025-08-29,14,Primaria 3°,EduMax,101,10,91
2025-08-29,14,Primaria 3°,TopKids,89,11,78
2025-08-29,14,Primaria 3°,EduMax,52,15,37
2025-08-29,14,Primaria 4°,TopKids,188,14,174
2025-08-29,14,Primaria 4°,TopKids,68,15,53
2025-08-29,14,Primaria 4°,EduMax,197,22,175
2025-08-29,14,Primaria 4°,TopKids,105,14,91
2025-08-29,14,Primaria 4°,EduMax,181,9,172
2025-08-29,14,Primaria 4°,TopKids,202,15,187
2025-08-29,14,Primaria 4°,TopKids,278,17,261
2025-08-29,14,Primaria 4°,TopKids,77,24,53
2025-08-29,14,Primaria 4°,SuperSchool,274,16,258
2025-08-29,14,Primaria 4°,TopKids,223,11,212
2025-08-29,14,Primaria 4°,EduMax,217,19,198
2025-08-29,14,Primaria 4°,EduMax,264,10,254
2025-08-29,14,Primaria 4°,SuperSchool,288,1,287
2025-08-29,14,Primaria 4°,EduMax,164,22,142
2025-08-29,14,Primaria 4°,EduMax,194,15,179
2025-08-29,14,Primaria 4°,EduMax,262,8,254
2025-08-29,14,Primaria 4°,SuperSchool,294,14,280
2025-08-29,14,Primaria 5°,EduMax,135,23,112
2025-08-29,14,Primaria 5°,TopKids,190,5,185
2025-08-29,14,Primaria 5°,EduMax,280,9,271
2025-08-29,14,Primaria 5°,EduMax,151,10,141
2025-08-29,14,Primaria 5°,SuperSchool,124,8,116
2025-08-29,14,Primaria 5°,EduMax,66,4,62
2025-08-29,14,Primaria 5°,EduMax,110,15,95
2025-08-29,14,Primaria 5°,EduMax,226,10,216
2025-08-29,14,Primaria 5°,SuperSchool,132,7,125
2025-08-29,14,Primaria 5°,SuperSchool,73,19,54
2025-08-29,14,Primaria 5°,EduMax,196,11,185
2025-08-29,14,Primaria 5°,TopKids,79,11,68
2025-08-29,14,Primaria 6°,EduMax,160,3,157
2025-08-29,14,Primaria 6°,EduMax,170,11,159
2025-08-29,14,Primaria 6°,TopKids,78,23,55
2025-08-29,14,Primaria 6°,TopKids,57,23,34
2025-08-29,14,Primaria 6°,SuperSchool,129,3,126
2025-08-29,14,Primaria 6°,SuperSchool,82,10,72
2025-08-29,14,Primaria 6°,SuperSchool,239,5,234
2025-08-29,14,Primaria 6°,SuperSchool,71,14,57
2025-08-29,14,Primaria 6°,EduMax,209,14,195
2025-08-29,14,Primaria 6°,EduMax,79,22,57
2025-08-29,15,Preescolar,SuperSchool,67,14,53
2025-08-29,15,Preescolar,TopKids,206,15,191
2025-08-29,15,Preescolar,SuperSchool,288,16,272
2025-08-29,15,Preescolar,SuperSchool,172,7,165
2025-08-29,15,Preescolar,TopKids,162,11,151
2025-08-29,15,Kínder,EduMax,159,15,144
2025-08-29,15,Kínder,SuperSchool,113,8,105
2025-08-29,15,Kínder,TopKids,53,1,52
2025-08-29,15,Kínder,EduMax,299,1,298
2025-08-29,15,Kínder,SuperSchool,246,19,227
2025-08-29,15,Kínder,SuperSchool,167,5,162
2025-08-29,15,Kínder,SuperSchool,80,12,68
2025-08-29,15,Kínder,TopKids,128,19,109
2025-08-29,15,Kínder,TopKids,294,13,281
2025-08-29,15,Kínder,TopKids,260,13,247
2025-08-29,15,Kínder,TopKids,215,1,214
2025-08-29,15,Kínder,EduMax,190,13,177
2025-08-29,15,Kínder,SuperSchool,69,4,65
2025-08-29,15,Kínder,SuperSchool,94,9,85
2025-08-29,15,Kínder,SuperSchool,276,20,256
2025-08-29,15,Primaria 1°,SuperSchool,172,15,157
2025-08-29,15,Primaria 1°,TopKids,178,9,169
2025-08-29,15,Primaria 1°,EduMax,67,1,66
2025-08-29,15,Primaria 1°,EduMax,216,10,206
2025-08-29,15,Primaria 1°,TopKids,151,7,144
2025-08-29,15,Primaria 1°,EduMax,57,2,55
2025-08-29,15,Primaria 2°,SuperSchool,76,9,67
2025-08-29,15,Primaria 2°,TopKids,81,9,72
2025-08-29,15,Primaria 2°,SuperSchool,148,16,132
2025-08-29,15,Primaria 2°,EduMax,220,16,204
2025-08-29,15,Primaria 2°,TopKids,82,21,61
2025-08-29,15,Primaria 2°,SuperSchool,148,22,126
2025-08-29,15,Primaria 2°,EduMax,228,20,208
2025-08-29,15,Primaria 2°,TopKids,231,11,220
2025-08-29,15,Primaria 2°,EduMax,79,18,61
2025-08-29,15,Primaria 2°,SuperSchool,223,16,207
2025-08-29,15,Primaria 2°,EduMax,115,23,92
2025-08-29,15,Primaria 2°,TopKids,156,10,146
2025-08-29,15,Primaria 2°,SuperSchool,123,9,114
2025-08-29,15,Primaria 3°,SuperSchool,220,10,210
2025-08-29,15,Primaria 3°,SuperSchool,148,4,144
2025-08-29,15,Primaria 3°,TopKids,283,24,259
2025-08-29,15,Primaria 3°,SuperSchool,150,13,137
2025-08-29,15,Primaria 3°,TopKids,169,1,168
2025-08-29,15,Primaria 3°,TopKids,170,11,159
2025-08-29,15,Primaria 3°,EduMax,244,17,227
2025-08-29,15,Primaria 3°,TopKids,126,16,110
2025-08-29,15,Primaria 3°,EduMax,264,20,244
2025-08-29,15,Primaria 3°,TopKids,292,6,286
2025-08-29,15,Primaria 3°,TopKids,120,15,105
2025-08-29,15,Primaria 3°,EduMax,86,16,70
2025-08-29,15,Primaria 3°,EduMax,84,12,72
2025-08-29,15,Primaria 3°,TopKids,167,3,164
2025-08-29,15,Primaria 3°,TopKids,161,16,145
2025-08-29,15,Primaria 3°,TopKids,164,15,149
2025-08-29,15,Primaria 3°,SuperSchool,229,2,227
2025-08-29,15,Primaria 3°,EduMax,63,9,54
2025-08-29,15,Primaria 4°,EduMax,203,18,185
2025-08-29,15,Primaria 4°,TopKids,53,5,48
2025-08-29,15,Primaria 4°,SuperSchool,168,21,147
2025-08-29,15,Primaria 4°,EduMax,74,15,59
2025-08-29,15,Primaria 4°,EduMax,270,2,268
2025-08-29,15,Primaria 4°,SuperSchool,143,23,120
2025-08-29,15,Primaria 4°,TopKids,173,4,169
2025-08-29,15,Primaria 4°,SuperSchool,121,21,100
2025-08-29,15,Primaria 4°,EduMax,128,2,126
2025-08-29,15,Primaria 4°,TopKids,93,10,83
2025-08-29,15,Primaria 4°,EduMax,166,20,146
2025-08-29,15,Primaria 4°,SuperSchool,122,8,114
2025-08-29,15,Primaria 4°,EduMax,176,21,155
2025-08-29,15,Primaria 4°,EduMax,201,24,177
2025-08-29,15,Primaria 4°,TopKids,245,19,226
2025-08-29,15,Primaria 4°,SuperSchool,107,21,86
2025-08-29,15,Primaria 4°,TopKids,118,20,98
2025-08-29,15,Primaria 5°,EduMax,201,10,191
2025-08-29,15,Primaria 5°,EduMax,193,4,189
2025-08-29,15,Primaria 5°,TopKids,143,14,129
2025-08-29,15,Primaria 5°,EduMax,148,10,138
2025-08-29,15,Primaria 5°,SuperSchool,86,22,64
2025-08-29,15,Primaria 5°,SuperSchool,290,11,279
2025-08-29,15,Primaria 5°,EduMax,68,18,50
2025-08-29,15,Primaria 5°,SuperSchool,188,15,173
2025-08-29,15,Primaria 5°,SuperSchool,194,24,170
2025-08-29,15,Primaria 5°,SuperSchool,238,4,234
2025-08-29,15,Primaria 5°,TopKids,265,11,254
2025-08-29,15,Primaria 5°,EduMax,153,16,137
2025-08-29,15,Primaria 6°,SuperSchool,210,4,206
2025-08-29,15,Primaria 6°,SuperSchool,151,5,146
2025-08-29,15,Primaria 6°,SuperSchool,198,10,188
2025-08-29,15,Primaria 6°,EduMax,260,18,242
2025-08-29,15,Primaria 6°,EduMax,147,16,131
2025-08-29,15,Primaria 6°,TopKids,201,5,196
2025-08-29,15,Primaria 6°,TopKids,230,22,208
2025-08-29,16,Preescolar,TopKids,182,5,177
2025-08-29,16,Preescolar,EduMax,218,9,209
2025-08-29,16,Preescolar,EduMax,184,1,183
2025-08-29,16,Preescolar,EduMax,75,12,63
2025-08-29,16,Preescolar,EduMax,133,19,114
2025-08-29,16,Preescolar,EduMax,54,22,32
2025-08-29,16,Preescolar,EduMax,247,14,233
2025-08-29,16,Preescolar,SuperSchool,67,21,46
2025-08-29,16,Preescolar,EduMax,72,24,48
2025-08-29,16,Preescolar,TopKids,298,18,280
2025-08-29,16,Preescolar,TopKids,247,6,241
2025-08-29,16,Preescolar,TopKids,282,11,271
2025-08-29,16,Preescolar,SuperSchool,240,14,226
2025-08-29,16,Kínder,EduMax,292,8,284
2025-08-29,16,Kínder,TopKids,190,19,171
2025-08-29,16,Kínder,SuperSchool,224,4,220
2025-08-29,16,Kínder,EduMax,233,19,214
2025-08-29,16,Kínder,EduMax,80,9,71
2025-08-29,16,Kínder,TopKids,239,12,227
2025-08-29,16,Primaria 1°,TopKids,150,17,133
2025-08-29,16,Primaria 1°,SuperSchool,108,4,104
2025-08-29,16,Primaria 1°,SuperSchool,216,7,209
2025-08-29,16,Primaria 1°,TopKids,226,15,211
2025-08-29,16,Primaria 1°,TopKids,224,20,204
2025-08-29,16,Primaria 1°,EduMax,167,13,154
2025-08-29,16,Primaria 1°,EduMax,196,15,181
2025-08-29,16,Primaria 1°,SuperSchool,102,6,96
2025-08-29,16,Primaria 2°,SuperSchool,294,13,281
2025-08-29,16,Primaria 2°,EduMax,108,14,94
2025-08-29,16,Primaria 2°,SuperSchool,105,14,91
2025-08-29,16,Primaria 2°,EduMax,96,16,80
2025-08-29,16,Primaria 2°,EduMax,209,1,208
2025-08-29,16,Primaria 2°,SuperSchool,284,7,277
2025-08-29,16,Primaria 2°,TopKids,194,4,190
2025-08-29,16,Primaria 2°,SuperSchool,120,3,117
2025-08-29,16,Primaria 2°,EduMax,291,18,273
2025-08-29,16,Primaria 2°,EduMax,297,1,296
2025-08-29,16,Primaria 2°,EduMax,90,2,88
2025-08-29,16,Primaria 2°,EduMax,117,21,96
2025-08-29,16,Primaria 2°,TopKids,59,23,36
2025-08-29,16,Primaria 2°,SuperSchool,252,9,243
2025-08-29,16,Primaria 2°,TopKids,252,4,248
2025-08-29,16,Primaria 3°,SuperSchool,102,17,85
2025-08-29,16,Primaria 3°,EduMax,182,18,164
2025-08-29,16,Primaria 3°,SuperSchool,235,3,232
2025-08-29,16,Primaria 3°,TopKids,162,8,154
2025-08-29,16,Primaria 3°,TopKids,264,2,262
2025-08-29,16,Primaria 3°,SuperSchool,152,21,131
2025-08-29,16,Primaria 3°,SuperSchool,215,20,195
2025-08-29,16,Primaria 3°,EduMax,216,18,198
2025-08-29,16,Primaria 3°,TopKids,157,7,150
2025-08-29,16,Primaria 3°,TopKids,177,1,176
2025-08-29,16,Primaria 3°,SuperSchool,123,10,113
2025-08-29,16,Primaria 4°,TopKids,180,13,167
2025-08-29,16,Primaria 4°,SuperSchool,208,6,202
2025-08-29,16,Primaria 4°,TopKids,276,15,261
2025-08-29,16,Primaria 4°,SuperSchool,294,6,288
2025-08-29,16,Primaria 4°,EduMax,281,11,270
2025-08-29,16,Primaria 4°,TopKids,65,9,56
2025-08-29,16,Primaria 4°,TopKids,252,16,236
2025-08-29,16,Primaria 4°,SuperSchool,215,17,198
2025-08-29,16,Primaria 4°,SuperSchool,205,18,187
2025-08-29,16,Primaria 4°,SuperSchool,163,8,155
2025-08-29,16,Primaria 4°,EduMax,231,10,221
2025-08-29,16,Primaria 4°,EduMax,122,24,98
2025-08-29,16,Primaria 4°,TopKids,251,14,237
2025-08-29,16,Primaria 4°,TopKids,164,6,158
2025-08-29,16,Primaria 4°,TopKids,267,19,248
2025-08-29,16,Primaria 4°,SuperSchool,253,22,231
2025-08-29,16,Primaria 5°,TopKids,166,16,150
2025-08-29,16,Primaria 5°,EduMax,263,17,246
2025-08-29,16,Primaria 5°,TopKids,106,5,101
2025-08-29,16,Primaria 5°,SuperSchool,93,7,86
2025-08-29,16,Primaria 5°,SuperSchool,267,4,263
2025-08-29,16,Primaria 5°,SuperSchool,273,6,267
2025-08-29,16,Primaria 5°,EduMax,250,4,246
2025-08-29,16,Primaria 5°,EduMax,124,20,104
2025-08-29,16,Primaria 5°,SuperSchool,240,16,224
2025-08-29,16,Primaria 5°,TopKids,161,16,145
2025-08-29,16,Primaria 5°,EduMax,192,3,189
2025-08-29,16,Primaria 5°,SuperSchool,274,11,263
2025-08-29,16,Primaria 5°,EduMax,247,24,223
2025-08-29,16,Primaria 5°,SuperSchool,106,18,88
2025-08-29,16,Primaria 5°,SuperSchool,189,7,182
2025-08-29,16,Primaria 5°,EduMax,152,9,143
2025-08-29,16,Primaria 5°,EduMax,202,20,182
2025-08-29,16,Primaria 5°,SuperSchool,155,12,143
2025-08-29,16,Primaria 5°,EduMax,219,3,216
2025-08-29,16,Primaria 6°,SuperSchool,171,22,149
2025-08-29,16,Primaria 6°,SuperSchool,278,14,264
2025-08-29,16,Primaria 6°,EduMax,282,22,260
2025-08-29,16,Primaria 6°,EduMax,149,1,148
2025-08-29,16,Primaria 6°,EduMax,280,21,259
2025-09-01,9,Preescolar,EduMax,113,24,89
2025-09-01,9,Preescolar,SuperSchool,121,12,109
2025-09-01,9,Preescolar,SuperSchool,156,2,154
2025-09-01,9,Preescolar,EduMax,201,2,199
2025-09-01,9,Preescolar,SuperSchool,202,24,178
2025-09-01,9,Preescolar,EduMax,298,7,291
2025-09-01,9,Preescolar,EduMax,240,9,231
2025-09-01,9,Preescolar,EduMax,84,2,82
2025-09-01,9,Preescolar,TopKids,71,19,52
2025-09-01,9,Preescolar,TopKids,226,20,206
2025-09-01,9,Kínder,TopKids,293,22,271
2025-09-01,9,Kínder,TopKids,171,6,165
2025-09-01,9,Kínder,EduMax,63,1,62
2025-09-01,9,Kínder,TopKids,151,13,138
2025-09-01,9,Kínder,EduMax,191,13,178
2025-09-01,9,Kínder,SuperSchool,95,13,82
2025-09-01,9,Kínder,TopKids,143,10,133
2025-09-01,9,Kínder,EduMax,269,4,265
2025-09-01,9,Kínder,EduMax,189,22,167
2025-09-01,9,Primaria 1°,TopKids,214,10,204
2025-09-01,9,Primaria 1°,SuperSchool,76,10,66
2025-09-01,9,Primaria 1°,EduMax,117,4,113
2025-09-01,9,Primaria 1°,SuperSchool,106,14,92
2025-09-01,9,Primaria 1°,SuperSchool,197,13,184
2025-09-01,9,Primaria 1°,TopKids,239,22,217
2025-09-01,9,Primaria 1°,EduMax,70,19,51
2025-09-01,9,Primaria 1°,SuperSchool,251,17,234
2025-09-01,9,Primaria 1°,EduMax,101,13,88
2025-09-01,9,Primaria 1°,SuperSchool,79,1,78
2025-09-01,9,Primaria 2°,SuperSchool,145,13,132
2025-09-01,9,Primaria 2°,SuperSchool,77,13,64
2025-09-01,9,Primaria 2°,SuperSchool,292,14,278
2025-09-01,9,Primaria 2°,EduMax,275,14,261
2025-09-01,9,Primaria 2°,SuperSchool,278,22,256
2025-09-01,9,Primaria 2°,EduMax,84,16,68
2025-09-01,9,Primaria 3°,TopKids,67,20,47
2025-09-01,9,Primaria 3°,EduMax,86,8,78
2025-09-01,9,Primaria 3°,EduMax,128,3,125
2025-09-01,9,Primaria 3°,EduMax,154,11,143
2025-09-01,9,Primaria 3°,EduMax,104,14,90
2025-09-01,9,Primaria 3°,TopKids,58,10,48
2025-09-01,9,Primaria 3°,EduMax,160,18,142
2025-09-01,9,Primaria 3°,SuperSchool,100,7,93
2025-09-01,9,Primaria 3°,TopKids,118,21,97
2025-09-01,9,Primaria 3°,EduMax,172,1,171
2025-09-01,9,Primaria 3°,EduMax,62,17,45
2025-09-01,9,Primaria 3°,SuperSchool,139,21,118
2025-09-01,9,Primaria 3°,SuperSchool,61,24,37
2025-09-01,9,Primaria 3°,SuperSchool,117,7,110
2025-09-01,9,Primaria 4°,SuperSchool,296,20,276
2025-09-01,9,Primaria 4°,SuperSchool,88,17,71
2025-09-01,9,Primaria 4°,TopKids,157,15,142
2025-09-01,9,Primaria 4°,TopKids,290,14,276
2025-09-01,9,Primaria 4°,TopKids,160,15,145
2025-09-01,9,Primaria 4°,TopKids,156,18,138
2025-09-01,9,Primaria 4°,SuperSchool,251,21,230
2025-09-01,9,Primaria 4°,EduMax,90,24,66
2025-09-01,9,Primaria 5°,SuperSchool,198,11,187
2025-09-01,9,Primaria 5°,TopKids,198,9,189
2025-09-01,9,Primaria 5°,TopKids,144,17,127
2025-09-01,9,Primaria 5°,SuperSchool,90,3,87
2025-09-01,9,Primaria 5°,TopKids,273,10,263
2025-09-01,9,Primaria 5°,SuperSchool,234,11,223
2025-09-01,9,Primaria 5°,SuperSchool,189,14,175
2025-09-01,9,Primaria 6°,TopKids,122,7,115
2025-09-01,9,Primaria 6°,TopKids,63,8,55
2025-09-01,9,Primaria 6°,TopKids,294,18,276
2025-09-01,9,Primaria 6°,TopKids,106,3,103
2025-09-01,9,Primaria 6°,TopKids,271,2,269
2025-09-01,9,Primaria 6°,EduMax,299,5,294
2025-09-01,9,Primaria 6°,TopKids,135,9,126
2025-09-01,9,Primaria 6°,EduMax,160,8,152
2025-09-01,9,Primaria 6°,EduMax,184,19,165
2025-09-01,9,Primaria 6°,SuperSchool,295,2,293
2025-09-01,9,Primaria 6°,TopKids,269,14,255
2025-09-01,9,Primaria 6°,TopKids,70,14,56
2025-09-01,9,Primaria 6°,TopKids,153,18,135
2025-09-01,9,Primaria 6°,EduMax,162,7,155
2025-09-01,9,Primaria 6°,SuperSchool,122,9,113
2025-09-01,9,Primaria 6°,TopKids,100,6,94
2025-09-01,10,Preescolar,SuperSchool,64,20,44
2025-09-01,10,Preescolar,EduMax,90,15,75
2025-09-01,10,Preescolar,EduMax,103,23,80
2025-09-01,10,Preescolar,EduMax,216,17,199
2025-09-01,10,Preescolar,EduMax,177,9,168
2025-09-01,10,Preescolar,TopKids,276,14,262
2025-09-01,10,Preescolar,EduMax,245,16,229
2025-09-01,10,Preescolar,TopKids,161,23,138
2025-09-01,10,Preescolar,SuperSchool,218,4,214
2025-09-01,10,Preescolar,EduMax,153,24,129
2025-09-01,10,Preescolar,EduMax,201,6,195
2025-09-01,10,Kínder,EduMax,107,14,93
2025-09-01,10,Kínder,EduMax,291,13,278
2025-09-01,10,Kínder,TopKids,148,6,142
2025-09-01,10,Kínder,TopKids,111,20,91
2025-09-01,10,Kínder,SuperSchool,133,16,117
2025-09-01,10,Kínder,EduMax,153,13,140
2025-09-01,10,Kínder,SuperSchool,222,20,202
2025-09-01,10,Kínder,EduMax,258,21,237
2025-09-01,10,Kínder,TopKids,103,3,100
2025-09-01,10,Kínder,SuperSchool,280,20,260
2025-09-01,10,Kínder,SuperSchool,92,23,69
2025-09-01,10,Kínder,EduMax,277,20,257
2025-09-01,10,Primaria 1°,TopKids,120,4,116
2025-09-01,10,Primaria 1°,EduMax,178,17,161
2025-09-01,10,Primaria 1°,SuperSchool,98,3,95
2025-09-01,10,Primaria 1°,SuperSchool,244,3,241
2025-09-01,10,Primaria 1°,SuperSchool,58,5,53
2025-09-01,10,Primaria 1°,EduMax,160,12,148
2025-09-01,10,Primaria 1°,EduMax,120,7,113
2025-09-01,10,Primaria 1°,TopKids,181,13,168
2025-09-01,10,Primaria 1°,TopKids,144,18,126
2025-09-01,10,Primaria 1°,EduMax,152,10,142
2025-09-01,10,Primaria 2°,EduMax,264,8,256
2025-09-01,10,Primaria 2°,TopKids,78,11,67
2025-09-01,10,Primaria 2°,SuperSchool,183,24,159
2025-09-01,10,Primaria 2°,EduMax,292,14,278
2025-09-01,10,Primaria 2°,EduMax,53,20,33
2025-09-01,10,Primaria 2°,TopKids,86,16,70
2025-09-01,10,Primaria 2°,EduMax,88,2,86
2025-09-01,10,Primaria 2°,SuperSchool,243,9,234
2025-09-01,10,Primaria 2°,SuperSchool,244,2,242
2025-09-01,10,Primaria 2°,EduMax,299,8,291
2025-09-01,10,Primaria 2°,EduMax,285,17,268
2025-09-01,10,Primaria 3°,EduMax,119,18,101
2025-09-01,10,Primaria 3°,EduMax,185,23,162
2025-09-01,10,Primaria 3°,EduMax,51,17,34
2025-09-01,10,Primaria 3°,TopKids,137,16,121
2025-09-01,10,Primaria 3°,EduMax,241,18,223
2025-09-01,10,Primaria 3°,SuperSchool,279,17,262
2025-09-01,10,Primaria 3°,EduMax,95,10,85
2025-09-01,10,Primaria 3°,TopKids,245,18,227
2025-09-01,10,Primaria 3°,TopKids,167,16,151
2025-09-01,10,Primaria 3°,EduMax,117,19,98
2025-09-01,10,Primaria 3°,EduMax,202,8,194
2025-09-01,10,Primaria 3°,EduMax,100,18,82
2025-09-01,10,Primaria 3°,EduMax,113,7,106
2025-09-01,10,Primaria 3°,SuperSchool,194,3,191
2025-09-01,10,Primaria 3°,EduMax,192,4,188
2025-09-01,10,Primaria 3°,EduMax,225,14,211
2025-09-01,10,Primaria 3°,EduMax,258,9,249
2025-09-01,10,Primaria 4°,EduMax,268,23,245
2025-09-01,10,Primaria 4°,SuperSchool,250,12,238
2025-09-01,10,Primaria 4°,TopKids,173,10,163
2025-09-01,10,Primaria 4°,SuperSchool,197,1,196
2025-09-01,10,Primaria 4°,SuperSchool,160,24,136
2025-09-01,10,Primaria 4°,SuperSchool,211,4,207
2025-09-01,10,Primaria 4°,SuperSchool,136,3,133
2025-09-01,10,Primaria 4°,TopKids,88,12,76
2025-09-01,10,Primaria 4°,TopKids,74,6,68
2025-09-01,10,Primaria 4°,TopKids,216,22,194
2025-09-01,10,Primaria 4°,SuperSchool,55,1,54
2025-09-01,10,Primaria 5°,SuperSchool,225,3,222
2025-09-01,10,Primaria 5°,EduMax,87,8,79
2025-09-01,10,Primaria 5°,TopKids,152,24,128
2025-09-01,10,Primaria 5°,SuperSchool,164,18,146
2025-09-01,10,Primaria 5°,TopKids,252,11,241
2025-09-01,10,Primaria 5°,TopKids,237,23,214
2025-09-01,10,Primaria 5°,SuperSchool,240,23,217
2025-09-01,10,Primaria 5°,EduMax,172,10,162
2025-09-01,10,Primaria 5°,EduMax,241,2,239
2025-09-01,10,Primaria 5°,EduMax,130,9,121
2025-09-01,10,Primaria 5°,EduMax,69,9,60
2025-09-01,10,Primaria 5°,SuperSchool,173,11,162
2025-09-01,10,Primaria 6°,EduMax,259,18,241
2025-09-01,10,Primaria 6°,EduMax,112,8,104
2025-09-01,10,Primaria 6°,SuperSchool,249,8,241
2025-09-01,10,Primaria 6°,TopKids,249,14,235
2025-09-01,10,Primaria 6°,SuperSchool,168,8,160
2025-09-01,11,Preescolar,TopKids,75,6,69
2025-09-01,11,Preescolar,SuperSchool,181,7,174
2025-09-01,11,Preescolar,SuperSchool,135,22,113
2025-09-01,11,Preescolar,EduMax,177,6,171
2025-09-01,11,Preescolar,EduMax,123,18,105
2025-09-01,11,Kínder,TopKids,191,22,169
2025-09-01,11,Kínder,EduMax,283,22,261
2025-09-01,11,Kínder,SuperSchool,90,10,80
2025-09-01,11,Kínder,EduMax,244,16,228
2025-09-01,11,Kínder,EduMax,296,11,285
2025-09-01,11,Kínder,EduMax,189,14,175
2025-09-01,11,Kínder,EduMax,282,13,269
2025-09-01,11,Kínder,EduMax,87,11,76
2025-09-01,11,Kínder,SuperSchool,268,15,253
2025-09-01,11,Kínder,TopKids,284,17,267
2025-09-01,11,Kínder,SuperSchool,122,16,106
2025-09-01,11,Kínder,TopKids,267,17,250
2025-09-01,11,Primaria 1°,TopKids,244,9,235
2025-09-01,11,Primaria 1°,EduMax,221,19,202
2025-09-01,11,Primaria 1°,EduMax,289,8,281
2025-09-01,11,Primaria 1°,TopKids,246,12,234
2025-09-01,11,Primaria 1°,EduMax,112,12,100
2025-09-01,11,Primaria 1°,EduMax,224,10,214
2025-09-01,11,Primaria 1°,SuperSchool,216,7,209
2025-09-01,11,Primaria 1°,TopKids,166,11,155
2025-09-01,11,Primaria 1°,EduMax,102,2,100
2025-09-01,11,Primaria 1°,EduMax,131,16,115
2025-09-01,11,Primaria 2°,TopKids,250,7,243
2025-09-01,11,Primaria 2°,EduMax,124,8,116
2025-09-01,11,Primaria 2°,TopKids,140,20,120
2025-09-01,11,Primaria 2°,SuperSchool,271,19,252
2025-09-01,11,Primaria 2°,EduMax,189,1,188
2025-09-01,11,Primaria 2°,EduMax,259,7,252
2025-09-01,11,Primaria 2°,SuperSchool,245,10,235
2025-09-01,11,Primaria 2°,SuperSchool,259,9,250
2025-09-01,11,Primaria 2°,EduMax,59,8,51
2025-09-01,11,Primaria 2°,TopKids,284,13,271
2025-09-01,11,Primaria 2°,SuperSchool,97,13,84
2025-09-01,11,Primaria 2°,SuperSchool,93,15,78
2025-09-01,11,Primaria 2°,SuperSchool,257,8,249
2025-09-01,11,Primaria 2°,EduMax,169,8,161
2025-09-01,11,Primaria 2°,EduMax,259,11,248
2025-09-01,11,Primaria 2°,SuperSchool,123,2,121
2025-09-01,11,Primaria 3°,TopKids,196,20,176
2025-09-01,11,Primaria 3°,EduMax,236,6,230
2025-09-01,11,Primaria 3°,SuperSchool,157,5,152
2025-09-01,11,Primaria 3°,EduMax,90,2,88
2025-09-01,11,Primaria 3°,EduMax,69,14,55
2025-09-01,11,Primaria 3°,EduMax,288,2,286
2025-09-01,11,Primaria 3°,EduMax,93,7,86
2025-09-01,11,Primaria 3°,TopKids,84,15,69
2025-09-01,11,Primaria 3°,TopKids,88,8,80
2025-09-01,11,Primaria 3°,TopKids,52,19,33
2025-09-01,11,Primaria 3°,TopKids,260,18,242
2025-09-01,11,Primaria 4°,TopKids,132,5,127
2025-09-01,11,Primaria 4°,TopKids,62,2,60
2025-09-01,11,Primaria 4°,EduMax,117,4,113
2025-09-01,11,Primaria 4°,TopKids,242,9,233
2025-09-01,11,Primaria 4°,EduMax,277,6,271
2025-09-01,11,Primaria 4°,SuperSchool,174,22,152
2025-09-01,11,Primaria 4°,SuperSchool,186,14,172
2025-09-01,11,Primaria 4°,SuperSchool,295,5,290
2025-09-01,11,Primaria 4°,TopKids,181,8,173
2025-09-01,11,Primaria 4°,TopKids,268,2,266
2025-09-01,11,Primaria 4°,TopKids,242,2,240
2025-09-01,11,Primaria 4°,TopKids,140,13,127
2025-09-01,11,Primaria 4°,TopKids,52,2,50
2025-09-01,11,Primaria 4°,SuperSchool,113,7,106
2025-09-01,11,Primaria 4°,TopKids,71,16,55
2025-09-01,11,Primaria 4°,EduMax,169,6,163
2025-09-01,11,Primaria 4°,EduMax,232,11,221
2025-09-01,11,Primaria 4°,TopKids,167,23,144
2025-09-01,11,Primaria 5°,SuperSchool,292,22,270
2025-09-01,11,Primaria 5°,SuperSchool,112,1,111
2025-09-01,11,Primaria 5°,SuperSchool,286,20,266
2025-09-01,11,Primaria 5°,SuperSchool,268,11,257
2025-09-01,11,Primaria 5°,SuperSchool,222,20,202
2025-09-01,11,Primaria 5°,SuperSchool,180,20,160
2025-09-01,11,Primaria 5°,SuperSchool,86,6,80
2025-09-01,11,Primaria 5°,SuperSchool,251,11,240
2025-09-01,11,Primaria 5°,SuperSchool,270,10,260
2025-09-01,11,Primaria 6°,SuperSchool,80,4,76
2025-09-01,11,Primaria 6°,EduMax,226,18,208
2025-09-01,11,Primaria 6°,TopKids,155,21,134
2025-09-01,11,Primaria 6°,EduMax,100,9,91
2025-09-01,11,Primaria 6°,SuperSchool,274,5,269
2025-09-01,11,Primaria 6°,TopKids,242,19,223
2025-09-01,11,Primaria 6°,TopKids,183,10,173
2025-09-01,11,Primaria 6°,SuperSchool,61,12,49
2025-09-01,11,Primaria 6°,SuperSchool,268,2,266
2025-09-01,11,Primaria 6°,SuperSchool,202,14,188
2025-09-01,11,Primaria 6°,SuperSchool,86,5,81
2025-09-01,11,Primaria 6°,SuperSchool,118,24,94
2025-09-01,11,Primaria 6°,SuperSchool,107,19,88
2025-09-01,11,Primaria 6°,TopKids,232,17,215
2025-09-01,11,Primaria 6°,TopKids,87,13,74
2025-09-01,11,Primaria 6°,EduMax,273,5,268
2025-09-01,11,Primaria 6°,TopKids,81,10,71
2025-09-01,11,Primaria 6°,TopKids,282,13,269
2025-09-01,12,Preescolar,SuperSchool,207,18,189
2025-09-01,12,Preescolar,SuperSchool,289,23,266
2025-09-01,12,Preescolar,TopKids,231,4,227
2025-09-01,12,Preescolar,TopKids,154,15,139
2025-09-01,12,Preescolar,TopKids,289,4,285
2025-09-01,12,Preescolar,TopKids,134,4,130
2025-09-01,12,Preescolar,EduMax,292,7,285
2025-09-01,12,Kínder,EduMax,210,18,192
2025-09-01,12,Kínder,EduMax,291,22,269
2025-09-01,12,Kínder,TopKids,77,11,66
2025-09-01,12,Kínder,TopKids,168,1,167
2025-09-01,12,Kínder,TopKids,269,8,261
2025-09-01,12,Kínder,SuperSchool,95,24,71
2025-09-01,12,Kínder,TopKids,217,19,198
2025-09-01,12,Kínder,EduMax,277,23,254
2025-09-01,12,Kínder,EduMax,71,10,61
2025-09-01,12,Kínder,TopKids,107,15,92
2025-09-01,12,Kínder,SuperSchool,219,7,212
2025-09-01,12,Kínder,EduMax,292,3,289
2025-09-01,12,Kínder,SuperSchool,97,14,83
2025-09-01,12,Kínder,TopKids,93,1,92
2025-09-01,12,Kínder,TopKids,76,1,75
2025-09-01,12,Kínder,EduMax,115,7,108
2025-09-01,12,Primaria 1°,TopKids,286,16,270
2025-09-01,12,Primaria 1°,SuperSchool,80,22,58
2025-09-01,12,Primaria 1°,SuperSchool,251,4,247
2025-09-01,12,Primaria 1°,SuperSchool,297,21,276
2025-09-01,12,Primaria 1°,SuperSchool,130,8,122
2025-09-01,12,Primaria 1°,TopKids,184,24,160
2025-09-01,12,Primaria 1°,SuperSchool,160,15,145
2025-09-01,12,Primaria 1°,TopKids,85,6,79
2025-09-01,12,Primaria 1°,EduMax,272,12,260
2025-09-01,12,Primaria 1°,EduMax,138,4,134
2025-09-01,12,Primaria 1°,EduMax,298,14,284
2025-09-01,12,Primaria 1°,EduMax,190,22,168
2025-09-01,12,Primaria 2°,TopKids,70,15,55
2025-09-01,12,Primaria 2°,TopKids,214,13,201
2025-09-01,12,Primaria 2°,EduMax,299,15,284
2025-09-01,12,Primaria 2°,SuperSchool,279,23,256
2025-09-01,12,Primaria 2°,EduMax,212,9,203
2025-09-01,12,Primaria 2°,TopKids,137,11,126
2025-09-01,12,Primaria 2°,EduMax,103,1,102
2025-09-01,12,Primaria 2°,EduMax,69,4,65
2025-09-01,12,Primaria 2°,EduMax,106,2,104
2025-09-01,12,Primaria 3°,SuperSchool,231,21,210
2025-09-01,12,Primaria 3°,EduMax,85,15,70
2025-09-01,12,Primaria 3°,TopKids,144,3,141
2025-09-01,12,Primaria 3°,EduMax,245,17,228
2025-09-01,12,Primaria 3°,EduMax,83,20,63
2025-09-01,12,Primaria 3°,SuperSchool,160,5,155
2025-09-01,12,Primaria 3°,TopKids,151,17,134
2025-09-01,12,Primaria 3°,SuperSchool,80,1,79
2025-09-01,12,Primaria 3°,EduMax,210,8,202
2025-09-01,12,Primaria 3°,SuperSchool,181,18,163
2025-09-01,12,Primaria 3°,TopKids,201,9,192
2025-09-01,12,Primaria 3°,TopKids,193,21,172
2025-09-01,12,Primaria 3°,EduMax,116,1,115
2025-09-01,12,Primaria 3°,TopKids,169,13,156
2025-09-01,12,Primaria 3°,EduMax,183,5,178
2025-09-01,12,Primaria 3°,SuperSchool,232,5,227
2025-09-01,12,Primaria 3°,TopKids,213,21,192
2025-09-01,12,Primaria 4°,EduMax,236,23,213
2025-09-01,12,Primaria 4°,EduMax,241,11,230
2025-09-01,12,Primaria 4°,EduMax,91,10,81
2025-09-01,12,Primaria 4°,SuperSchool,109,9,100
2025-09-01,12,Primaria 4°,EduMax,51,14,37
2025-09-01,12,Primaria 4°,TopKids,258,24,234
2025-09-01,12,Primaria 4°,SuperSchool,62,7,55
2025-09-01,12,Primaria 4°,EduMax,130,6,124
2025-09-01,12,Primaria 4°,TopKids,202,3,199
2025-09-01,12,Primaria 4°,SuperSchool,102,15,87
2025-09-01,12,Primaria 4°,SuperSchool,298,23,275
2025-09-01,12,Primaria 4°,EduMax,128,1,127
2025-09-01,12,Primaria 4°,TopKids,277,22,255
2025-09-01,12,Primaria 4°,EduMax,257,18,239
2025-09-01,12,Primaria 4°,EduMax,165,4,161
2025-09-01,12,Primaria 4°,EduMax,113,12,101
2025-09-01,12,Primaria 5°,SuperSchool,188,2,186
2025-09-01,12,Primaria 5°,TopKids,132,12,120
2025-09-01,12,Primaria 5°,SuperSchool,93,16,77
2025-09-01,12,Primaria 5°,TopKids,147,7,140
2025-09-01,12,Primaria 5°,EduMax,146,15,131
2025-09-01,12,Primaria 5°,TopKids,61,13,48
2025-09-01,12,Primaria 5°,SuperSchool,50,5,45
2025-09-01,12,Primaria 5°,TopKids,259,22,237
2025-09-01,12,Primaria 5°,EduMax,59,8,51
2025-09-01,12,Primaria 5°,EduMax,71,3,68
2025-09-01,12,Primaria 5°,EduMax,246,14,232
2025-09-01,12,Primaria 5°,SuperSchool,101,21,80
2025-09-01,12,Primaria 5°,EduMax,108,6,102
2025-09-01,12,Primaria 5°,EduMax,69,24,45
2025-09-01,12,Primaria 6°,EduMax,79,11,68
2025-09-01,12,Primaria 6°,SuperSchool,90,20,70
2025-09-01,12,Primaria 6°,TopKids,112,5,107
2025-09-01,12,Primaria 6°,TopKids,78,15,63
2025-09-01,12,Primaria 6°,SuperSchool,126,12,114
2025-09-01,12,Primaria 6°,TopKids,265,19,246
2025-09-01,12,Primaria 6°,SuperSchool,201,19,182
2025-09-01,12,Primaria 6°,EduMax,66,16,50
2025-09-01,12,Primaria 6°,SuperSchool,238,4,234
2025-09-01,13,Preescolar,EduMax,251,21,230
2025-09-01,13,Preescolar,SuperSchool,55,11,44
2025-09-01,13,Preescolar,TopKids,97,14,83
2025-09-01,13,Preescolar,TopKids,196,22,174
2025-09-01,13,Preescolar,TopKids,173,4,169
2025-09-01,13,Preescolar,SuperSchool,231,19,212
2025-09-01,13,Preescolar,SuperSchool,99,8,91
2025-09-01,13,Preescolar,TopKids,163,11,152
2025-09-01,13,Preescolar,EduMax,63,13,50
2025-09-01,13,Preescolar,EduMax,129,12,117
2025-09-01,13,Preescolar,SuperSchool,112,7,105
2025-09-01,13,Preescolar,EduMax,238,17,221
2025-09-01,13,Kínder,SuperSchool,203,7,196
2025-09-01,13,Kínder,TopKids,276,15,261
2025-09-01,13,Kínder,SuperSchool,66,13,53
2025-09-01,13,Kínder,EduMax,212,20,192
2025-09-01,13,Kínder,TopKids,246,9,237
2025-09-01,13,Kínder,TopKids,67,11,56
2025-09-01,13,Primaria 1°,TopKids,115,23,92
2025-09-01,13,Primaria 1°,SuperSchool,187,6,181
2025-09-01,13,Primaria 1°,TopKids,117,21,96
2025-09-01,13,Primaria 1°,SuperSchool,168,11,157
2025-09-01,13,Primaria 1°,SuperSchool,287,14,273
2025-09-01,13,Primaria 1°,TopKids,249,5,244
2025-09-01,13,Primaria 1°,SuperSchool,218,21,197
2025-09-01,13,Primaria 1°,TopKids,93,7,86
2025-09-01,13,Primaria 1°,SuperSchool,192,15,177
2025-09-01,13,Primaria 1°,SuperSchool,275,8,267
2025-09-01,13,Primaria 1°,EduMax,150,3,147
2025-09-01,13,Primaria 1°,EduMax,142,1,141
2025-09-01,13,Primaria 1°,EduMax,129,10,119
2025-09-01,13,Primaria 1°,TopKids,171,10,161
2025-09-01,13,Primaria 1°,EduMax,92,12,80
2025-09-01,13,Primaria 2°,TopKids,118,9,109
2025-09-01,13,Primaria 2°,TopKids,96,23,73
2025-09-01,13,Primaria 2°,SuperSchool,220,13,207
2025-09-01,13,Primaria 2°,SuperSchool,264,7,257
2025-09-01,13,Primaria 2°,SuperSchool,259,23,236
2025-09-01,13,Primaria 2°,EduMax,143,10,133
2025-09-01,13,Primaria 2°,EduMax,67,21,46
2025-09-01,13,Primaria 2°,SuperSchool,90,10,80
2025-09-01,13,Primaria 2°,SuperSchool,92,14,78
2025-09-01,13,Primaria 2°,TopKids,107,10,97
2025-09-01,13,Primaria 2°,EduMax,260,10,250
2025-09-01,13,Primaria 2°,SuperSchool,211,22,189
2025-09-01,13,Primaria 2°,EduMax,203,18,185
2025-09-01,13,Primaria 2°,EduMax,293,19,274
2025-09-01,13,Primaria 2°,TopKids,153,6,147
2025-09-01,13,Primaria 2°,TopKids,170,13,157
2025-09-01,13,Primaria 2°,EduMax,199,7,192
2025-09-01,13,Primaria 2°,SuperSchool,55,16,39
2025-09-01,13,Primaria 2°,SuperSchool,72,18,54
2025-09-01,13,Primaria 3°,EduMax,110,4,106
2025-09-01,13,Primaria 3°,TopKids,54,21,33
2025-09-01,13,Primaria 3°,EduMax,97,15,82
2025-09-01,13,Primaria 3°,TopKids,51,23,28
2025-09-01,13,Primaria 3°,EduMax,259,4,255
2025-09-01,13,Primaria 3°,TopKids,61,3,58
2025-09-01,13,Primaria 3°,SuperSchool,161,6,155
2025-09-01,13,Primaria 3°,EduMax,171,22,149
2025-09-01,13,Primaria 3°,SuperSchool,253,12,241
2025-09-01,13,Primaria 3°,TopKids,201,14,187
2025-09-01,13,Primaria 3°,SuperSchool,90,12,78
2025-09-01,13,Primaria 3°,TopKids,251,11,240
2025-09-01,13,Primaria 3°,EduMax,144,16,128
2025-09-01,13,Primaria 3°,TopKids,178,22,156
2025-09-01,13,Primaria 3°,SuperSchool,50,22,28
2025-09-01,13,Primaria 3°,EduMax,253,23,230
2025-09-01,13,Primaria 3°,TopKids,77,20,57
2025-09-01,13,Primaria 3°,EduMax,125,23,102
2025-09-01,13,Primaria 4°,TopKids,156,2,154
2025-09-01,13,Primaria 4°,TopKids,115,17,98
2025-09-01,13,Primaria 4°,SuperSchool,279,16,263
2025-09-01,13,Primaria 4°,TopKids,205,6,199
2025-09-01,13,Primaria 4°,TopKids,68,20,48
2025-09-01,13,Primaria 5°,SuperSchool,247,15,232
2025-09-01,13,Primaria 5°,EduMax,90,2,88
2025-09-01,13,Primaria 5°,SuperSchool,294,23,271
2025-09-01,13,Primaria 5°,SuperSchool,285,10,275
2025-09-01,13,Primaria 5°,TopKids,187,18,169
2025-09-01,13,Primaria 5°,SuperSchool,62,4,58
2025-09-01,13,Primaria 5°,SuperSchool,195,3,192
2025-09-01,13,Primaria 5°,TopKids,265,11,254
2025-09-01,13,Primaria 5°,SuperSchool,75,12,63
2025-09-01,13,Primaria 5°,EduMax,219,10,209
2025-09-01,13,Primaria 5°,SuperSchool,155,9,146
2025-09-01,13,Primaria 5°,SuperSchool,231,16,215
2025-09-01,13,Primaria 5°,EduMax,95,13,82
2025-09-01,13,Primaria 5°,EduMax,113,14,99
2025-09-01,13,Primaria 6°,TopKids,232,18,214
2025-09-01,13,Primaria 6°,SuperSchool,141,20,121
2025-09-01,13,Primaria 6°,SuperSchool,113,12,101
2025-09-01,13,Primaria 6°,TopKids,241,11,230
2025-09-01,13,Primaria 6°,SuperSchool,296,4,292
2025-09-01,13,Primaria 6°,SuperSchool,247,22,225
2025-09-01,13,Primaria 6°,SuperSchool,94,24,70
2025-09-01,13,Primaria 6°,EduMax,286,6,280
2025-09-01,13,Primaria 6°,EduMax,213,21,192
2025-09-01,13,Primaria 6°,TopKids,170,15,155
2025-09-01,13,Primaria 6°,TopKids,147,23,124
2025-09-01,13,Primaria 6°,SuperSchool,171,23,148
2025-09-01,14,Preescolar,SuperSchool,82,5,77
2025-09-01,14,Preescolar,TopKids,293,17,276
2025-09-01,14,Preescolar,EduMax,114,7,107
2025-09-01,14,Preescolar,SuperSchool,244,16,228
2025-09-01,14,Preescolar,SuperSchool,170,14,156
2025-09-01,14,Preescolar,EduMax,140,16,124
2025-09-01,14,Kínder,SuperSchool,146,21,125
2025-09-01,14,Kínder,SuperSchool,252,19,233
2025-09-01,14,Kínder,TopKids,207,18,189
2025-09-01,14,Kínder,EduMax,282,9,273
2025-09-01,14,Kínder,EduMax,80,13,67
2025-09-01,14,Primaria 1°,SuperSchool,126,23,103
2025-09-01,14,Primaria 1°,EduMax,280,2,278
2025-09-01,14,Primaria 1°,EduMax,177,24,153
2025-09-01,14,Primaria 1°,SuperSchool,73,5,68
2025-09-01,14,Primaria 1°,SuperSchool,293,10,283
2025-09-01,14,Primaria 1°,EduMax,180,13,167
2025-09-01,14,Primaria 1°,SuperSchool,155,2,153
2025-09-01,14,Primaria 1°,TopKids,141,16,125
2025-09-01,14,Primaria 1°,TopKids,182,7,175
2025-09-01,14,Primaria 1°,SuperSchool,54,8,46
2025-09-01,14,Primaria 1°,EduMax,295,24,271
2025-09-01,14,Primaria 1°,SuperSchool,140,20,120
2025-09-01,14,Primaria 1°,TopKids,238,4,234
2025-09-01,14,Primaria 1°,SuperSchool,96,18,78
2025-09-01,14,Primaria 1°,EduMax,236,14,222
2025-09-01,14,Primaria 1°,EduMax,182,12,170
2025-09-01,14,Primaria 1°,EduMax,299,18,281
2025-09-01,14,Primaria 1°,EduMax,269,22,247
2025-09-01,14,Primaria 1°,TopKids,274,7,267
2025-09-01,14,Primaria 2°,TopKids,152,9,143
2025-09-01,14,Primaria 2°,TopKids,136,12,124
2025-09-01,14,Primaria 2°,SuperSchool,71,4,67
2025-09-01,14,Primaria 2°,EduMax,205,24,181
2025-09-01,14,Primaria 2°,TopKids,297,5,292
2025-09-01,14,Primaria 2°,TopKids,64,23,41
2025-09-01,14,Primaria 2°,SuperSchool,152,22,130
2025-09-01,14,Primaria 2°,TopKids,106,16,90
2025-09-01,14,Primaria 2°,TopKids,259,3,256
2025-09-01,14,Primaria 2°,EduMax,82,7,75
2025-09-01,14,Primaria 2°,EduMax,59,24,35
2025-09-01,14,Primaria 2°,SuperSchool,225,12,213
2025-09-01,14,Primaria 2°,TopKids,175,18,157
2025-09-01,14,Primaria 2°,EduMax,172,17,155
2025-09-01,14,Primaria 2°,SuperSchool,90,19,71
2025-09-01,14,Primaria 2°,EduMax,88,11,77
2025-09-01,14,Primaria 3°,SuperSchool,155,15,140
2025-09-01,14,Primaria 3°,SuperSchool,280,6,274
2025-09-01,14,Primaria 3°,SuperSchool,125,3,122
2025-09-01,14,Primaria 3°,SuperSchool,283,13,270
2025-09-01,14,Primaria 3°,TopKids,185,6,179
2025-09-01,14,Primaria 3°,TopKids,157,9,148
2025-09-01,14,Primaria 3°,SuperSchool,156,6,150
2025-09-01,14,Primaria 3°,EduMax,56,9,47
2025-09-01,14,Primaria 3°,SuperSchool,100,18,82
2025-09-01,14,Primaria 3°,SuperSchool,124,10,114
2025-09-01,14,Primaria 3°,SuperSchool,232,3,229
2025-09-01,14,Primaria 4°,EduMax,115,12,103
2025-09-01,14,Primaria 4°,TopKids,159,15,144
2025-09-01,14,Primaria 4°,EduMax,235,12,223
2025-09-01,14,Primaria 4°,SuperSchool,179,23,156
2025-09-01,14,Primaria 4°,EduMax,274,20,254
2025-09-01,14,Primaria 4°,TopKids,271,22,249
2025-09-01,14,Primaria 4°,EduMax,75,20,55
2025-09-01,14,Primaria 4°,SuperSchool,242,1,241
2025-09-01,14,Primaria 4°,TopKids,124,12,112
2025-09-01,14,Primaria 4°,TopKids,191,23,168
2025-09-01,14,Primaria 4°,SuperSchool,82,6,76
2025-09-01,14,Primaria 4°,TopKids,103,3,100
2025-09-01,14,Primaria 4°,EduMax,296,6,290
2025-09-01,14,Primaria 4°,SuperSchool,288,17,271
2025-09-01,14,Primaria 4°,SuperSchool,72,9,63
2025-09-01,14,Primaria 4°,EduMax,210,16,194
2025-09-01,14,Primaria 5°,TopKids,218,17,201
2025-09-01,14,Primaria 5°,EduMax,108,14,94
2025-09-01,14,Primaria 5°,EduMax,198,14,184
2025-09-01,14,Primaria 5°,TopKids,111,7,104
2025-09-01,14,Primaria 5°,EduMax,97,7,90
2025-09-01,14,Primaria 5°,EduMax,108,6,102
2025-09-01,14,Primaria 5°,TopKids,234,22,212
2025-09-01,14,Primaria 6°,EduMax,194,8,186
2025-09-01,14,Primaria 6°,EduMax,164,21,143
2025-09-01,14,Primaria 6°,EduMax,120,12,108
2025-09-01,14,Primaria 6°,TopKids,106,4,102
2025-09-01,14,Primaria 6°,SuperSchool,170,11,159
2025-09-01,14,Primaria 6°,EduMax,164,19,145
2025-09-01,14,Primaria 6°,SuperSchool,143,11,132
2025-09-01,14,Primaria 6°,SuperSchool,169,1,168
2025-09-01,14,Primaria 6°,EduMax,295,16,279
2025-09-01,14,Primaria 6°,EduMax,159,24,135
2025-09-01,14,Primaria 6°,TopKids,291,17,274
2025-09-01,14,Primaria 6°,EduMax,292,15,277
2025-09-01,14,Primaria 6°,EduMax,79,4,75
2025-09-01,14,Primaria 6°,SuperSchool,57,20,37
2025-09-01,14,Primaria 6°,EduMax,107,11,96
2025-09-01,14,Primaria 6°,TopKids,73,24,49
2025-09-01,15,Preescolar,EduMax,77,16,61
2025-09-01,15,Preescolar,EduMax,152,16,136
2025-09-01,15,Preescolar,EduMax,83,6,77
2025-09-01,15,Preescolar,TopKids,261,15,246
2025-09-01,15,Preescolar,TopKids,71,16,55
2025-09-01,15,Preescolar,TopKids,50,21,29
2025-09-01,15,Preescolar,TopKids,292,6,286
2025-09-01,15,Preescolar,TopKids,164,17,147
2025-09-01,15,Preescolar,SuperSchool,198,13,185
2025-09-01,15,Preescolar,TopKids,289,13,276
2025-09-01,15,Preescolar,EduMax,115,11,104
2025-09-01,15,Preescolar,EduMax,138,16,122
2025-09-01,15,Preescolar,SuperSchool,75,3,72
2025-09-01,15,Kínder,SuperSchool,174,23,151
2025-09-01,15,Kínder,EduMax,274,18,256
2025-09-01,15,Kínder,EduMax,231,9,222
2025-09-01,15,Kínder,SuperSchool,93,24,69
2025-09-01,15,Kínder,EduMax,52,2,50
2025-09-01,15,Kínder,SuperSchool,140,9,131
2025-09-01,15,Kínder,SuperSchool,207,21,186
2025-09-01,15,Kínder,TopKids,91,5,86
2025-09-01,15,Kínder,EduMax,268,15,253
2025-09-01,15,Kínder,TopKids,90,1,89
2025-09-01,15,Kínder,SuperSchool,164,6,158
2025-09-01,15,Kínder,TopKids,175,18,157
2025-09-01,15,Kínder,EduMax,129,1,128
2025-09-01,15,Kínder,TopKids,273,10,263
2025-09-01,15,Kínder,TopKids,74,10,64
2025-09-01,15,Kínder,SuperSchool,173,1,172
2025-09-01,15,Primaria 1°,EduMax,198,16,182
2025-09-01,15,Primaria 1°,TopKids,235,20,215
2025-09-01,15,Primaria 1°,EduMax,50,20,30
2025-09-01,15,Primaria 1°,SuperSchool,281,12,269
2025-09-01,15,Primaria 1°,SuperSchool,286,9,277
2025-09-01,15,Primaria 1°,SuperSchool,297,8,289
2025-09-01,15,Primaria 1°,SuperSchool,109,2,107
2025-09-01,15,Primaria 2°,TopKids,287,19,268
2025-09-01,15,Primaria 2°,EduMax,186,19,167
2025-09-01,15,Primaria 2°,EduMax,159,8,151
2025-09-01,15,Primaria 2°,SuperSchool,88,4,84
2025-09-01,15,Primaria 2°,SuperSchool,146,8,138
2025-09-01,15,Primaria 2°,TopKids,124,21,103
2025-09-01,15,Primaria 2°,EduMax,162,24,138
2025-09-01,15,Primaria 2°,SuperSchool,236,5,231
2025-09-01,15,Primaria 2°,EduMax,184,10,174
2025-09-01,15,Primaria 2°,SuperSchool,133,15,118
2025-09-01,15,Primaria 2°,EduMax,211,4,207
2025-09-01,15,Primaria 2°,SuperSchool,95,24,71
2025-09-01,15,Primaria 2°,SuperSchool,160,14,146
2025-09-01,15,Primaria 2°,EduMax,120,13,107
2025-09-01,15,Primaria 2°,SuperSchool,206,17,189
2025-09-01,15,Primaria 2°,TopKids,267,20,247
2025-09-01,15,Primaria 2°,SuperSchool,174,9,165
2025-09-01,15,Primaria 2°,EduMax,111,20,91
2025-09-01,15,Primaria 2°,TopKids,259,24,235
2025-09-01,15,Primaria 3°,SuperSchool,111,17,94
2025-09-01,15,Primaria 3°,TopKids,290,10,280
2025-09-01,15,Primaria 3°,TopKids,202,14,188
2025-09-01,15,Primaria 3°,EduMax,253,12,241
2025-09-01,15,Primaria 3°,SuperSchool,132,23,109
2025-09-01,15,Primaria 3°,EduMax,174,17,157
2025-09-01,15,Primaria 3°,TopKids,134,6,128
2025-09-01,15,Primaria 3°,EduMax,196,22,174
2025-09-01,15,Primaria 3°,EduMax,279,4,275
2025-09-01,15,Primaria 3°,SuperSchool,260,11,249
2025-09-01,15,Primaria 3°,EduMax,56,2,54
2025-09-01,15,Primaria 3°,EduMax,214,22,192
2025-09-01,15,Primaria 3°,SuperSchool,122,11,111
2025-09-01,15,Primaria 3°,SuperSchool,113,18,95
2025-09-01,15,Primaria 4°,SuperSchool,109,13,96
2025-09-01,15,Primaria 4°,TopKids,258,22,236
2025-09-01,15,Primaria 4°,EduMax,187,18,169
2025-09-01,15,Primaria 4°,SuperSchool,285,15,270
2025-09-01,15,Primaria 4°,TopKids,204,19,185
2025-09-01,15,Primaria 4°,EduMax,128,13,115
2025-09-01,15,Primaria 4°,TopKids,220,8,212
2025-09-01,15,Primaria 4°,TopKids,188,24,164
2025-09-01,15,Primaria 5°,EduMax,88,16,72
2025-09-01,15,Primaria 5°,EduMax,129,20,109
2025-09-01,15,Primaria 5°,SuperSchool,130,19,111
2025-09-01,15,Primaria 5°,EduMax,256,15,241
2025-09-01,15,Primaria 5°,TopKids,261,21,240
2025-09-01,15,Primaria 5°,TopKids,212,12,200
2025-09-01,15,Primaria 5°,TopKids,183,20,163
2025-09-01,15,Primaria 5°,SuperSchool,252,23,229
2025-09-01,15,Primaria 5°,TopKids,250,18,232
2025-09-01,15,Primaria 6°,TopKids,217,16,201
2025-09-01,15,Primaria 6°,TopKids,143,6,137
2025-09-01,15,Primaria 6°,TopKids,256,12,244
2025-09-01,15,Primaria 6°,EduMax,253,2,251
2025-09-01,15,Primaria 6°,SuperSchool,84,1,83
2025-09-01,15,Primaria 6°,EduMax,237,13,224
2025-09-01,15,Primaria 6°,SuperSchool,234,5,229
2025-09-01,15,Primaria 6°,TopKids,159,16,143
2025-09-01,15,Primaria 6°,EduMax,191,1,190
2025-09-01,15,Primaria 6°,EduMax,238,21,217
2025-09-01,15,Primaria 6°,EduMax,81,6,75
2025-09-01,15,Primaria 6°,EduMax,88,17,71
2025-09-01,15,Primaria 6°,TopKids,105,14,91
2025-09-01,15,Primaria 6°,TopKids,152,22,130
2025-09-01,15,Primaria 6°,EduMax,262,9,253
2025-09-01,15,Primaria 6°,TopKids,271,21,250
2025-09-01,15,Primaria 6°,TopKids,212,23,189
2025-09-01,15,Primaria 6°,EduMax,245,5,240
2025-09-01,16,Preescolar,SuperSchool,58,23,35
2025-09-01,16,Preescolar,EduMax,257,22,235
2025-09-01,16,Preescolar,EduMax,76,10,66
2025-09-01,16,Preescolar,TopKids,198,13,185
2025-09-01,16,Preescolar,EduMax,52,11,41
2025-09-01,16,Preescolar,TopKids,56,10,46
2025-09-01,16,Preescolar,SuperSchool,53,8,45
2025-09-01,16,Preescolar,SuperSchool,54,17,37
2025-09-01,16,Kínder,EduMax,56,5,51
2025-09-01,16,Kínder,TopKids,116,8,108
2025-09-01,16,Kínder,SuperSchool,54,17,37
2025-09-01,16,Kínder,SuperSchool,160,8,152
2025-09-01,16,Kínder,TopKids,162,12,150
2025-09-01,16,Kínder,SuperSchool,235,18,217
2025-09-01,16,Kínder,EduMax,116,5,111
2025-09-01,16,Kínder,TopKids,278,5,273
2025-09-01,16,Kínder,EduMax,170,6,164
2025-09-01,16,Kínder,EduMax,279,22,257
2025-09-01,16,Kínder,EduMax,50,16,34
2025-09-01,16,Kínder,TopKids,151,20,131
2025-09-01,16,Kínder,EduMax,247,17,230
2025-09-01,16,Primaria 1°,SuperSchool,230,22,208
2025-09-01,16,Primaria 1°,EduMax,59,24,35
2025-09-01,16,Primaria 1°,EduMax,175,5,170
2025-09-01,16,Primaria 1°,EduMax,277,16,261
2025-09-01,16,Primaria 1°,SuperSchool,203,19,184
2025-09-01,16,Primaria 1°,EduMax,201,21,180
2025-09-01,16,Primaria 1°,TopKids,59,7,52
2025-09-01,16,Primaria 1°,EduMax,127,10,117
2025-09-01,16,Primaria 1°,EduMax,174,20,154
2025-09-01,16,Primaria 1°,EduMax,106,11,95
2025-09-01,16,Primaria 1°,EduMax,80,12,68
2025-09-01,16,Primaria 1°,SuperSchool,199,22,177
2025-09-01,16,Primaria 1°,SuperSchool,148,13,135
2025-09-01,16,Primaria 1°,TopKids,256,19,237
2025-09-01,16,Primaria 1°,EduMax,261,4,257
2025-09-01,16,Primaria 1°,EduMax,128,4,124
2025-09-01,16,Primaria 2°,EduMax,213,18,195
2025-09-01,16,Primaria 2°,TopKids,125,8,117
2025-09-01,16,Primaria 2°,SuperSchool,56,22,34
2025-09-01,16,Primaria 2°,EduMax,188,2,186
2025-09-01,16,Primaria 2°,EduMax,117,21,96
2025-09-01,16,Primaria 2°,SuperSchool,198,9,189
2025-09-01,16,Primaria 2°,SuperSchool,287,2,285
2025-09-01,16,Primaria 2°,SuperSchool,98,8,90
2025-09-01,16,Primaria 2°,EduMax,264,15,249
2025-09-01,16,Primaria 2°,TopKids,51,11,40
2025-09-01,16,Primaria 3°,EduMax,70,10,60
2025-09-01,16,Primaria 3°,TopKids,199,14,185
2025-09-01,16,Primaria 3°,SuperSchool,70,22,48
2025-09-01,16,Primaria 3°,EduMax,187,1,186
2025-09-01,16,Primaria 3°,SuperSchool,137,3,134
2025-09-01,16,Primaria 3°,TopKids,92,19,73
2025-09-01,16,Primaria 3°,SuperSchool,190,22,168
2025-09-01,16,Primaria 3°,TopKids,119,2,117
2025-09-01,16,Primaria 3°,SuperSchool,195,24,171
2025-09-01,16,Primaria 3°,EduMax,274,1,273
2025-09-01,16,Primaria 3°,SuperSchool,101,17,84
2025-09-01,16,Primaria 3°,TopKids,180,23,157
2025-09-01,16,Primaria 3°,EduMax,233,23,210
2025-09-01,16,Primaria 3°,SuperSchool,84,4,80
2025-09-01,16,Primaria 3°,TopKids,141,13,128
2025-09-01,16,Primaria 3°,EduMax,143,15,128
2025-09-01,16,Primaria 3°,TopKids,70,8,62
2025-09-01,16,Primaria 3°,SuperSchool,195,13,182
2025-09-01,16,Primaria 4°,SuperSchool,258,13,245
2025-09-01,16,Primaria 4°,SuperSchool,94,11,83
2025-09-01,16,Primaria 4°,EduMax,230,10,220
2025-09-01,16,Primaria 4°,TopKids,55,19,36
2025-09-01,16,Primaria 4°,TopKids,68,12,56
2025-09-01,16,Primaria 4°,SuperSchool,241,7,234
2025-09-01,16,Primaria 4°,EduMax,299,20,279
2025-09-01,16,Primaria 4°,EduMax,232,3,229
2025-09-01,16,Primaria 4°,SuperSchool,183,1,182
2025-09-01,16,Primaria 4°,EduMax,281,23,258
2025-09-01,16,Primaria 4°,SuperSchool,148,3,145
2025-09-01,16,Primaria 5°,TopKids,112,7,105
2025-09-01,16,Primaria 5°,EduMax,220,18,202
2025-09-01,16,Primaria 5°,SuperSchool,231,2,229
2025-09-01,16,Primaria 5°,TopKids,159,1,158
2025-09-01,16,Primaria 5°,EduMax,64,20,44
2025-09-01,16,Primaria 5°,SuperSchool,148,23,125
2025-09-01,16,Primaria 5°,EduMax,201,1,200
2025-09-01,16,Primaria 5°,SuperSchool,113,5,108
2025-09-01,16,Primaria 5°,EduMax,94,14,80
2025-09-01,16,Primaria 5°,TopKids,296,6,290
2025-09-01,16,Primaria 5°,TopKids,269,11,258
2025-09-01,16,Primaria 5°,SuperSchool,229,19,210
2025-09-01,16,Primaria 5°,TopKids,295,21,274
2025-09-01,16,Primaria 5°,TopKids,144,10,134
2025-09-01,16,Primaria 5°,TopKids,86,4,82
2025-09-01,16,Primaria 5°,SuperSchool,139,5,134
2025-09-01,16,Primaria 5°,SuperSchool,237,17,220
2025-09-01,16,Primaria 5°,SuperSchool,274,24,250
2025-09-01,16,Primaria 6°,SuperSchool,264,19,245
2025-09-01,16,Primaria 6°,SuperSchool,69,23,46
2025-09-01,16,Primaria 6°,TopKids,196,5,191
2025-09-01,16,Primaria 6°,SuperSchool,117,13,104
2025-09-01,16,Primaria 6°,EduMax,189,9,180
2025-09-01,16,Primaria 6°,TopKids,262,15,247
2025-09-02,9,Preescolar,SuperSchool,182,5,177
2025-09-02,9,Preescolar,SuperSchool,265,5,260
2025-09-02,9,Preescolar,SuperSchool,80,14,66
2025-09-02,9,Preescolar,EduMax,218,14,204
2025-09-02,9,Preescolar,TopKids,288,4,284
2025-09-02,9,Kínder,EduMax,215,14,201
2025-09-02,9,Kínder,SuperSchool,76,11,65
2025-09-02,9,Kínder,SuperSchool,255,7,248
2025-09-02,9,Kínder,EduMax,94,18,76
2025-09-02,9,Kínder,SuperSchool,51,9,42
2025-09-02,9,Kínder,TopKids,69,11,58
2025-09-02,9,Kínder,EduMax,87,1,86
2025-09-02,9,Kínder,SuperSchool,231,14,217
2025-09-02,9,Kínder,SuperSchool,289,9,280
2025-09-02,9,Kínder,EduMax,260,20,240
2025-09-02,9,Kínder,EduMax,57,23,34
2025-09-02,9,Primaria 1°,SuperSchool,83,21,62
2025-09-02,9,Primaria 1°,EduMax,67,13,54
2025-09-02,9,Primaria 1°,TopKids,294,15,279
2025-09-02,9,Primaria 1°,SuperSchool,176,23,153
2025-09-02,9,Primaria 1°,TopKids,242,22,220
2025-09-02,9,Primaria 1°,TopKids,158,18,140
2025-09-02,9,Primaria 1°,SuperSchool,220,13,207
2025-09-02,9,Primaria 1°,SuperSchool,239,16,223
2025-09-02,9,Primaria 1°,TopKids,116,17,99
2025-09-02,9,Primaria 1°,EduMax,81,9,72
2025-09-02,9,Primaria 1°,SuperSchool,289,1,288
2025-09-02,9,Primaria 1°,SuperSchool,162,10,152
2025-09-02,9,Primaria 1°,SuperSchool,281,13,268
2025-09-02,9,Primaria 2°,SuperSchool,245,8,237
2025-09-02,9,Primaria 2°,SuperSchool,296,7,289
2025-09-02,9,Primaria 2°,SuperSchool,219,17,202
2025-09-02,9,Primaria 2°,EduMax,283,16,267
2025-09-02,9,Primaria 2°,EduMax,219,4,215
2025-09-02,9,Primaria 2°,EduMax,208,1,207
2025-09-02,9,Primaria 2°,TopKids,62,12,50
2025-09-02,9,Primaria 2°,SuperSchool,230,10,220
2025-09-02,9,Primaria 2°,EduMax,112,9,103
2025-09-02,9,Primaria 3°,SuperSchool,145,1,144
2025-09-02,9,Primaria 3°,EduMax,159,2,157
2025-09-02,9,Primaria 3°,TopKids,246,10,236
2025-09-02,9,Primaria 3°,EduMax,86,2,84
2025-09-02,9,Primaria 3°,SuperSchool,110,10,100
2025-09-02,9,Primaria 4°,TopKids,74,6,68
2025-09-02,9,Primaria 4°,SuperSchool,294,18,276
2025-09-02,9,Primaria 4°,TopKids,133,18,115
2025-09-02,9,Primaria 4°,EduMax,93,8,85
2025-09-02,9,Primaria 4°,EduMax,229,23,206
2025-09-02,9,Primaria 4°,SuperSchool,282,12,270
2025-09-02,9,Primaria 4°,EduMax,212,6,206
2025-09-02,9,Primaria 4°,TopKids,200,19,181
2025-09-02,9,Primaria 4°,EduMax,242,9,233
2025-09-02,9,Primaria 4°,TopKids,235,16,219
2025-09-02,9,Primaria 4°,TopKids,240,9,231
2025-09-02,9,Primaria 4°,EduMax,192,22,170
2025-09-02,9,Primaria 5°,SuperSchool,225,8,217
2025-09-02,9,Primaria 5°,EduMax,159,17,142
2025-09-02,9,Primaria 5°,TopKids,208,4,204
2025-09-02,9,Primaria 5°,EduMax,202,24,178
2025-09-02,9,Primaria 5°,EduMax,97,8,89
2025-09-02,9,Primaria 5°,EduMax,56,3,53
2025-09-02,9,Primaria 5°,EduMax,240,20,220
2025-09-02,9,Primaria 5°,EduMax,213,19,194
2025-09-02,9,Primaria 5°,EduMax,117,2,115
2025-09-02,9,Primaria 5°,TopKids,96,17,79
2025-09-02,9,Primaria 5°,EduMax,92,17,75
2025-09-02,9,Primaria 5°,SuperSchool,177,23,154
2025-09-02,9,Primaria 6°,SuperSchool,209,20,189
2025-09-02,9,Primaria 6°,SuperSchool,243,7,236
2025-09-02,9,Primaria 6°,EduMax,271,1,270
2025-09-02,9,Primaria 6°,EduMax,178,1,177
2025-09-02,9,Primaria 6°,SuperSchool,113,5,108
2025-09-02,9,Primaria 6°,EduMax,175,6,169
2025-09-02,9,Primaria 6°,TopKids,153,24,129
2025-09-02,9,Primaria 6°,EduMax,245,23,222
2025-09-02,9,Primaria 6°,SuperSchool,266,3,263
2025-09-02,9,Primaria 6°,TopKids,213,23,190
2025-09-02,9,Primaria 6°,SuperSchool,110,22,88
2025-09-02,9,Primaria 6°,SuperSchool,296,11,285
2025-09-02,9,Primaria 6°,TopKids,150,20,130
2025-09-02,9,Primaria 6°,SuperSchool,127,24,103
2025-09-02,9,Primaria 6°,EduMax,101,19,82
2025-09-02,9,Primaria 6°,SuperSchool,165,23,142
2025-09-02,9,Primaria 6°,EduMax,196,12,184
2025-09-02,9,Primaria 6°,EduMax,206,14,192
2025-09-02,10,Preescolar,EduMax,120,21,99
2025-09-02,10,Preescolar,SuperSchool,162,6,156
2025-09-02,10,Preescolar,EduMax,185,18,167
2025-09-02,10,Preescolar,SuperSchool,121,24,97
2025-09-02,10,Preescolar,SuperSchool,116,13,103
2025-09-02,10,Kínder,TopKids,147,4,143
2025-09-02,10,Kínder,SuperSchool,247,4,243
2025-09-02,10,Kínder,SuperSchool,271,7,264
2025-09-02,10,Kínder,EduMax,109,22,87
2025-09-02,10,Kínder,EduMax,162,23,139
2025-09-02,10,Kínder,TopKids,260,7,253
2025-09-02,10,Kínder,SuperSchool,180,8,172
2025-09-02,10,Kínder,TopKids,257,20,237
2025-09-02,10,Kínder,TopKids,264,23,241
2025-09-02,10,Kínder,SuperSchool,91,23,68
2025-09-02,10,Kínder,EduMax,244,20,224
2025-09-02,10,Kínder,EduMax,170,8,162
2025-09-02,10,Kínder,EduMax,121,11,110
2025-09-02,10,Kínder,EduMax,299,23,276
2025-09-02,10,Kínder,EduMax,220,1,219
2025-09-02,10,Kínder,TopKids,214,14,200
2025-09-02,10,Kínder,TopKids,267,20,247
2025-09-02,10,Kínder,SuperSchool,117,4,113
2025-09-02,10,Kínder,EduMax,204,19,185
2025-09-02,10,Primaria 1°,SuperSchool,88,2,86
2025-09-02,10,Primaria 1°,SuperSchool,233,6,227
2025-09-02,10,Primaria 1°,EduMax,77,16,61
2025-09-02,10,Primaria 1°,EduMax,142,16,126
2025-09-02,10,Primaria 1°,TopKids,231,16,215
2025-09-02,10,Primaria 1°,TopKids,124,11,113
2025-09-02,10,Primaria 1°,TopKids,207,16,191
2025-09-02,10,Primaria 2°,TopKids,156,18,138
2025-09-02,10,Primaria 2°,TopKids,59,4,55
2025-09-02,10,Primaria 2°,EduMax,191,6,185
2025-09-02,10,Primaria 2°,TopKids,278,15,263
2025-09-02,10,Primaria 2°,SuperSchool,296,24,272
2025-09-02,10,Primaria 2°,EduMax,271,19,252
2025-09-02,10,Primaria 2°,EduMax,177,17,160
2025-09-02,10,Primaria 2°,EduMax,188,14,174
2025-09-02,10,Primaria 2°,SuperSchool,94,12,82
2025-09-02,10,Primaria 3°,TopKids,59,13,46
2025-09-02,10,Primaria 3°,TopKids,293,13,280
2025-09-02,10,Primaria 3°,EduMax,177,9,168
2025-09-02,10,Primaria 3°,EduMax,196,20,176
2025-09-02,10,Primaria 3°,EduMax,295,7,288
2025-09-02,10,Primaria 3°,TopKids,130,14,116
2025-09-02,10,Primaria 3°,EduMax,282,16,266
2025-09-02,10,Primaria 3°,EduMax,255,4,251
2025-09-02,10,Primaria 3°,TopKids,52,11,41
2025-09-02,10,Primaria 3°,SuperSchool,289,23,266
2025-09-02,10,Primaria 3°,SuperSchool,77,23,54
2025-09-02,10,Primaria 3°,EduMax,111,23,88
2025-09-02,10,Primaria 3°,TopKids,90,22,68
2025-09-02,10,Primaria 3°,TopKids,253,8,245
2025-09-02,10,Primaria 4°,TopKids,111,17,94
2025-09-02,10,Primaria 4°,TopKids,160,23,137
2025-09-02,10,Primaria 4°,SuperSchool,221,19,202
2025-09-02,10,Primaria 4°,TopKids,109,6,103
2025-09-02,10,Primaria 4°,TopKids,52,16,36
2025-09-02,10,Primaria 4°,EduMax,58,9,49
2025-09-02,10,Primaria 4°,EduMax,118,1,117
2025-09-02,10,Primaria 4°,TopKids,176,3,173
2025-09-02,10,Primaria 4°,SuperSchool,97,11,86
2025-09-02,10,Primaria 4°,SuperSchool,76,9,67
2025-09-02,10,Primaria 4°,EduMax,63,23,40
2025-09-02,10,Primaria 4°,SuperSchool,75,22,53
2025-09-02,10,Primaria 4°,TopKids,164,9,155
2025-09-02,10,Primaria 4°,EduMax,130,9,121
2025-09-02,10,Primaria 4°,TopKids,298,16,282
2025-09-02,10,Primaria 4°,SuperSchool,139,17,122
2025-09-02,10,Primaria 4°,EduMax,111,4,107
2025-09-02,10,Primaria 4°,SuperSchool,263,9,254
2025-09-02,10,Primaria 5°,SuperSchool,163,14,149
2025-09-02,10,Primaria 5°,TopKids,213,1,212
2025-09-02,10,Primaria 5°,EduMax,85,10,75
2025-09-02,10,Primaria 5°,SuperSchool,266,17,249
2025-09-02,10,Primaria 5°,TopKids,186,16,170
2025-09-02,10,Primaria 5°,TopKids,297,24,273
2025-09-02,10,Primaria 5°,SuperSchool,128,20,108
2025-09-02,10,Primaria 5°,SuperSchool,157,23,134
2025-09-02,10,Primaria 5°,EduMax,216,16,200
2025-09-02,10,Primaria 5°,TopKids,55,6,49
2025-09-02,10,Primaria 6°,EduMax,288,2,286
2025-09-02,10,Primaria 6°,SuperSchool,217,7,210
2025-09-02,10,Primaria 6°,TopKids,111,16,95
2025-09-02,10,Primaria 6°,TopKids,58,20,38
2025-09-02,10,Primaria 6°,TopKids,211,20,191
2025-09-02,10,Primaria 6°,EduMax,109,11,98
2025-09-02,10,Primaria 6°,EduMax,116,2,114
2025-09-02,10,Primaria 6°,EduMax,191,24,167
2025-09-02,10,Primaria 6°,SuperSchool,246,12,234
2025-09-02,10,Primaria 6°,EduMax,183,8,175
2025-09-02,11,Preescolar,TopKids,285,7,278
2025-09-02,11,Preescolar,TopKids,65,7,58
2025-09-02,11,Preescolar,SuperSchool,286,19,267
2025-09-02,11,Preescolar,TopKids,82,24,58
2025-09-02,11,Preescolar,EduMax,152,22,130
2025-09-02,11,Preescolar,TopKids,258,15,243
2025-09-02,11,Preescolar,EduMax,298,19,279
2025-09-02,11,Preescolar,TopKids,113,4,109
2025-09-02,11,Preescolar,SuperSchool,216,16,200
2025-09-02,11,Preescolar,SuperSchool,236,20,216
2025-09-02,11,Preescolar,SuperSchool,160,9,151
2025-09-02,11,Kínder,TopKids,286,7,279
2025-09-02,11,Kínder,TopKids,109,19,90
2025-09-02,11,Kínder,SuperSchool,124,8,116
2025-09-02,11,Kínder,SuperSchool,277,4,273
2025-09-02,11,Kínder,EduMax,103,17,86
2025-09-02,11,Kínder,TopKids,218,6,212
2025-09-02,11,Kínder,EduMax,141,12,129
2025-09-02,11,Kínder,TopKids,288,9,279
2025-09-02,11,Kínder,SuperSchool,147,12,135
2025-09-02,11,Primaria 1°,TopKids,210,21,189
2025-09-02,11,Primaria 1°,TopKids,52,20,32
2025-09-02,11,Primaria 1°,SuperSchool,244,15,229
2025-09-02,11,Primaria 1°,EduMax,128,3,125
2025-09-02,11,Primaria 1°,TopKids,274,2,272
2025-09-02,11,Primaria 1°,SuperSchool,255,14,241
2025-09-02,11,Primaria 1°,TopKids,239,10,229
2025-09-02,11,Primaria 1°,TopKids,181,15,166
2025-09-02,11,Primaria 1°,EduMax,298,4,294
2025-09-02,11,Primaria 1°,EduMax,222,8,214
2025-09-02,11,Primaria 1°,SuperSchool,239,20,219
2025-09-02,11,Primaria 2°,EduMax,213,5,208
2025-09-02,11,Primaria 2°,SuperSchool,87,23,64
2025-09-02,11,Primaria 2°,TopKids,123,3,120
2025-09-02,11,Primaria 2°,SuperSchool,186,17,169
2025-09-02,11,Primaria 2°,TopKids,283,12,271
2025-09-02,11,Primaria 2°,SuperSchool,137,10,127
2025-09-02,11,Primaria 2°,TopKids,294,19,275
2025-09-02,11,Primaria 2°,EduMax,162,5,157
2025-09-02,11,Primaria 2°,SuperSchool,96,4,92
2025-09-02,11,Primaria 3°,SuperSchool,290,5,285
2025-09-02,11,Primaria 3°,SuperSchool,240,22,218
2025-09-02,11,Primaria 3°,TopKids,283,11,272
2025-09-02,11,Primaria 3°,EduMax,227,13,214
2025-09-02,11,Primaria 3°,EduMax,97,19,78
2025-09-02,11,Primaria 3°,EduMax,104,12,92
2025-09-02,11,Primaria 3°,TopKids,95,2,93
2025-09-02,11,Primaria 3°,EduMax,245,1,244
2025-09-02,11,Primaria 3°,EduMax,171,17,154
2025-09-02,11,Primaria 3°,TopKids,248,17,231
2025-09-02,11,Primaria 3°,SuperSchool,154,10,144
2025-09-02,11,Primaria 3°,EduMax,183,17,166
2025-09-02,11,Primaria 3°,TopKids,292,4,288
2025-09-02,11,Primaria 4°,SuperSchool,105,9,96
2025-09-02,11,Primaria 4°,TopKids,200,1,199
2025-09-02,11,Primaria 4°,TopKids,184,22,162
2025-09-02,11,Primaria 4°,SuperSchool,214,1,213
2025-09-02,11,Primaria 4°,EduMax,94,15,79
2025-09-02,11,Primaria 4°,EduMax,79,17,62
2025-09-02,11,Primaria 4°,TopKids,77,13,64
2025-09-02,11,Primaria 4°,TopKids,181,7,174
2025-09-02,11,Primaria 4°,TopKids,201,7,194
2025-09-02,11,Primaria 4°,EduMax,230,16,214
2025-09-02,11,Primaria 4°,SuperSchool,58,22,36
2025-09-02,11,Primaria 4°,TopKids,295,2,293
2025-09-02,11,Primaria 4°,TopKids,65,5,60
2025-09-02,11,Primaria 4°,EduMax,64,3,61
2025-09-02,11,Primaria 4°,SuperSchool,236,7,229
2025-09-02,11,Primaria 4°,TopKids,149,9,140
2025-09-02,11,Primaria 4°,TopKids,296,21,275
2025-09-02,11,Primaria 4°,SuperSchool,266,7,259
2025-09-02,11,Primaria 5°,TopKids,196,11,185
2025-09-02,11,Primaria 5°,SuperSchool,50,21,29
2025-09-02,11,Primaria 5°,SuperSchool,126,2,124
2025-09-02,11,Primaria 5°,SuperSchool,292,23,269
2025-09-02,11,Primaria 5°,TopKids,68,10,58
2025-09-02,11,Primaria 5°,EduMax,108,9,99
2025-09-02,11,Primaria 5°,TopKids,252,6,246
2025-09-02,11,Primaria 5°,TopKids,243,24,219
2025-09-02,11,Primaria 5°,EduMax,160,5,155
2025-09-02,11,Primaria 5°,EduMax,175,7,168
2025-09-02,11,Primaria 5°,TopKids,294,16,278
2025-09-02,11,Primaria 5°,SuperSchool,144,2,142
2025-09-02,11,Primaria 5°,SuperSchool,143,20,123
2025-09-02,11,Primaria 6°,EduMax,65,23,42
2025-09-02,11,Primaria 6°,SuperSchool,290,8,282
2025-09-02,11,Primaria 6°,SuperSchool,211,13,198
2025-09-02,11,Primaria 6°,SuperSchool,263,7,256
2025-09-02,11,Primaria 6°,EduMax,198,5,193
2025-09-02,12,Preescolar,TopKids,130,24,106
2025-09-02,12,Preescolar,SuperSchool,157,19,138
2025-09-02,12,Preescolar,SuperSchool,129,19,110
2025-09-02,12,Preescolar,TopKids,219,12,207
2025-09-02,12,Preescolar,TopKids,287,10,277
2025-09-02,12,Preescolar,TopKids,235,16,219
2025-09-02,12,Preescolar,EduMax,258,4,254
2025-09-02,12,Preescolar,EduMax,145,11,134
2025-09-02,12,Preescolar,SuperSchool,55,22,33
2025-09-02,12,Preescolar,EduMax,269,7,262
2025-09-02,12,Preescolar,TopKids,178,10,168
2025-09-02,12,Kínder,TopKids,109,20,89
2025-09-02,12,Kínder,EduMax,231,18,213
2025-09-02,12,Kínder,TopKids,257,1,256
2025-09-02,12,Kínder,SuperSchool,271,20,251
2025-09-02,12,Kínder,EduMax,289,21,268
2025-09-02,12,Primaria 1°,TopKids,137,16,121
2025-09-02,12,Primaria 1°,SuperSchool,216,10,206
2025-09-02,12,Primaria 1°,TopKids,143,13,130
2025-09-02,12,Primaria 1°,EduMax,253,13,240
2025-09-02,12,Primaria 1°,TopKids,220,8,212
2025-09-02,12,Primaria 1°,TopKids,195,7,188
2025-09-02,12,Primaria 1°,EduMax,219,20,199
2025-09-02,12,Primaria 1°,TopKids,256,20,236
2025-09-02,12,Primaria 1°,TopKids,68,6,62
2025-09-02,12,Primaria 1°,TopKids,224,20,204
2025-09-02,12,Primaria 1°,EduMax,241,2,239
2025-09-02,12,Primaria 1°,TopKids,150,3,147
2025-09-02,12,Primaria 1°,EduMax,87,1,86
2025-09-02,12,Primaria 2°,SuperSchool,241,7,234
2025-09-02,12,Primaria 2°,TopKids,279,15,264
2025-09-02,12,Primaria 2°,EduMax,250,4,246
2025-09-02,12,Primaria 2°,TopKids,251,1,250
2025-09-02,12,Primaria 2°,TopKids,226,18,208
2025-09-02,12,Primaria 2°,EduMax,133,15,118
2025-09-02,12,Primaria 2°,EduMax,129,2,127
2025-09-02,12,Primaria 3°,TopKids,116,23,93
2025-09-02,12,Primaria 3°,SuperSchool,89,20,69
2025-09-02,12,Primaria 3°,EduMax,108,15,93
2025-09-02,12,Primaria 3°,SuperSchool,166,23,143
2025-09-02,12,Primaria 3°,TopKids,106,24,82
2025-09-02,12,Primaria 3°,SuperSchool,269,12,257
2025-09-02,12,Primaria 3°,EduMax,227,3,224
2025-09-02,12,Primaria 3°,EduMax,258,11,247
2025-09-02,12,Primaria 3°,SuperSchool,295,7,288
2025-09-02,12,Primaria 3°,EduMax,136,18,118
2025-09-02,12,Primaria 3°,SuperSchool,280,18,262
2025-09-02,12,Primaria 3°,EduMax,109,6,103
2025-09-02,12,Primaria 3°,EduMax,121,21,100
2025-09-02,12,Primaria 4°,EduMax,226,4,222
2025-09-02,12,Primaria 4°,SuperSchool,299,16,283
2025-09-02,12,Primaria 4°,SuperSchool,64,15,49
2025-09-02,12,Primaria 4°,SuperSchool,100,1,99
2025-09-02,12,Primaria 4°,SuperSchool,215,10,205
2025-09-02,12,Primaria 4°,SuperSchool,203,12,191
2025-09-02,12,Primaria 4°,TopKids,192,21,171
2025-09-02,12,Primaria 4°,SuperSchool,51,19,32
2025-09-02,12,Primaria 4°,EduMax,142,9,133
2025-09-02,12,Primaria 5°,SuperSchool,126,17,109
2025-09-02,12,Primaria 5°,EduMax,105,22,83
2025-09-02,12,Primaria 5°,EduMax,293,23,270
2025-09-02,12,Primaria 5°,EduMax,234,6,228
2025-09-02,12,Primaria 5°,EduMax,100,9,91
2025-09-02,12,Primaria 5°,TopKids,176,7,169
2025-09-02,12,Primaria 5°,EduMax,270,5,265
2025-09-02,12,Primaria 5°,TopKids,229,1,228
2025-09-02,12,Primaria 5°,SuperSchool,152,18,134
2025-09-02,12,Primaria 5°,TopKids,141,8,133
2025-09-02,12,Primaria 5°,TopKids,125,10,115
2025-09-02,12,Primaria 5°,EduMax,139,16,123
2025-09-02,12,Primaria 5°,EduMax,132,18,114
2025-09-02,12,Primaria 5°,SuperSchool,261,7,254
2025-09-02,12,Primaria 5°,TopKids,193,10,183
2025-09-02,12,Primaria 5°,TopKids,191,24,167
2025-09-02,12,Primaria 5°,SuperSchool,64,8,56
2025-09-02,12,Primaria 6°,EduMax,102,9,93
2025-09-02,12,Primaria 6°,EduMax,141,7,134
2025-09-02,12,Primaria 6°,TopKids,93,14,79
2025-09-02,12,Primaria 6°,TopKids,273,19,254
2025-09-02,12,Primaria 6°,EduMax,212,6,206
2025-09-02,12,Primaria 6°,SuperSchool,201,9,192
2025-09-02,12,Primaria 6°,EduMax,279,14,265
2025-09-02,12,Primaria 6°,TopKids,80,23,57
2025-09-02,12,Primaria 6°,TopKids,277,14,263
2025-09-02,12,Primaria 6°,TopKids,294,10,284
2025-09-02,12,Primaria 6°,EduMax,220,13,207
2025-09-02,13,Preescolar,EduMax,101,14,87
2025-09-02,13,Preescolar,TopKids,69,22,47
2025-09-02,13,Preescolar,TopKids,294,5,289
2025-09-02,13,Preescolar,EduMax,136,24,112
2025-09-02,13,Preescolar,SuperSchool,235,8,227
2025-09-02,13,Preescolar,EduMax,277,20,257
2025-09-02,13,Preescolar,EduMax,60,15,45
2025-09-02,13,Preescolar,SuperSchool,180,15,165
2025-09-02,13,Preescolar,EduMax,51,8,43
2025-09-02,13,Preescolar,EduMax,223,9,214
2025-09-02,13,Preescolar,SuperSchool,79,12,67
2025-09-02,13,Preescolar,EduMax,274,24,250
2025-09-02,13,Kínder,EduMax,266,11,255
2025-09-02,13,Kínder,SuperSchool,212,1,211
2025-09-02,13,Kínder,SuperSchool,208,6,202
2025-09-02,13,Kínder,SuperSchool,229,4,225
2025-09-02,13,Kínder,SuperSchool,160,14,146
2025-09-02,13,Kínder,TopKids,64,12,52
2025-09-02,13,Kínder,EduMax,95,10,85
2025-09-02,13,Primaria 1°,TopKids,296,4,292
2025-09-02,13,Primaria 1°,EduMax,269,8,261
2025-09-02,13,Primaria 1°,TopKids,86,10,76
2025-09-02,13,Primaria 1°,EduMax,238,4,234
2025-09-02,13,Primaria 1°,EduMax,294,17,277
2025-09-02,13,Primaria 1°,TopKids,250,3,247
2025-09-02,13,Primaria 1°,EduMax,186,4,182
2025-09-02,13,Primaria 1°,EduMax,207,19,188
2025-09-02,13,Primaria 1°,SuperSchool,104,23,81
2025-09-02,13,Primaria 1°,EduMax,172,11,161
2025-09-02,13,Primaria 1°,TopKids,199,6,193
2025-09-02,13,Primaria 1°,EduMax,219,24,195
2025-09-02,13,Primaria 2°,EduMax,259,16,243
2025-09-02,13,Primaria 2°,SuperSchool,169,5,164
2025-09-02,13,Primaria 2°,SuperSchool,260,18,242
2025-09-02,13,Primaria 2°,TopKids,66,16,50
2025-09-02,13,Primaria 2°,SuperSchool,134,1,133
2025-09-02,13,Primaria 2°,EduMax,261,24,237
2025-09-02,13,Primaria 2°,EduMax,297,2,295
2025-09-02,13,Primaria 2°,TopKids,78,3,75
2025-09-02,13,Primaria 2°,EduMax,62,19,43
2025-09-02,13,Primaria 2°,SuperSchool,94,15,79
2025-09-02,13,Primaria 2°,EduMax,156,3,153
2025-09-02,13,Primaria 2°,EduMax,144,5,139
2025-09-02,13,Primaria 2°,EduMax,141,15,126
2025-09-02,13,Primaria 3°,EduMax,232,22,210
2025-09-02,13,Primaria 3°,SuperSchool,262,10,252
2025-09-02,13,Primaria 3°,SuperSchool,206,6,200
2025-09-02,13,Primaria 3°,TopKids,149,20,129
2025-09-02,13,Primaria 3°,TopKids,247,1,246
2025-09-02,13,Primaria 3°,SuperSchool,79,18,61
2025-09-02,13,Primaria 3°,EduMax,182,16,166
2025-09-02,13,Primaria 3°,TopKids,101,19,82
2025-09-02,13,Primaria 3°,SuperSchool,248,2,246
2025-09-02,13,Primaria 3°,SuperSchool,241,6,235
2025-09-02,13,Primaria 3°,EduMax,226,8,218
2025-09-02,13,Primaria 3°,SuperSchool,187,16,171
2025-09-02,13,Primaria 3°,EduMax,105,19,86
2025-09-02,13,Primaria 4°,EduMax,94,23,71
2025-09-02,13,Primaria 4°,TopKids,245,16,229
2025-09-02,13,Primaria 4°,EduMax,290,21,269
2025-09-02,13,Primaria 4°,EduMax,189,13,176
2025-09-02,13,Primaria 4°,EduMax,293,8,285
2025-09-02,13,Primaria 4°,SuperSchool,259,21,238
2025-09-02,13,Primaria 4°,EduMax,171,13,158
2025-09-02,13,Primaria 4°,EduMax,108,17,91
2025-09-02,13,Primaria 4°,EduMax,61,13,48
2025-09-02,13,Primaria 4°,EduMax,117,15,102
2025-09-02,13,Primaria 4°,SuperSchool,196,15,181
2025-09-02,13,Primaria 5°,EduMax,293,6,287
2025-09-02,13,Primaria 5°,SuperSchool,54,2,52
2025-09-02,13,Primaria 5°,EduMax,278,3,275
2025-09-02,13,Primaria 5°,EduMax,144,11,133
2025-09-02,13,Primaria 5°,SuperSchool,227,14,213
2025-09-02,13,Primaria 5°,EduMax,204,24,180
2025-09-02,13,Primaria 5°,EduMax,138,3,135
2025-09-02,13,Primaria 5°,EduMax,161,11,150
2025-09-02,13,Primaria 5°,TopKids,89,16,73
2025-09-02,13,Primaria 5°,TopKids,281,9,272
2025-09-02,13,Primaria 5°,EduMax,121,24,97
2025-09-02,13,Primaria 5°,EduMax,140,2,138
2025-09-02,13,Primaria 5°,TopKids,69,19,50
2025-09-02,13,Primaria 5°,TopKids,234,19,215
2025-09-02,13,Primaria 6°,SuperSchool,130,1,129
2025-09-02,13,Primaria 6°,SuperSchool,173,5,168
2025-09-02,13,Primaria 6°,SuperSchool,261,21,240
2025-09-02,13,Primaria 6°,SuperSchool,55,10,45
2025-09-02,13,Primaria 6°,TopKids,186,6,180
2025-09-02,13,Primaria 6°,SuperSchool,105,18,87
2025-09-02,14,Preescolar,TopKids,264,7,257
2025-09-02,14,Preescolar,EduMax,187,12,175
2025-09-02,14,Preescolar,SuperSchool,233,15,218
2025-09-02,14,Preescolar,SuperSchool,212,15,197
2025-09-02,14,Preescolar,SuperSchool,124,24,100
2025-09-02,14,Preescolar,EduMax,205,16,189
2025-09-02,14,Preescolar,TopKids,235,21,214
2025-09-02,14,Preescolar,EduMax,76,21,55
2025-09-02,14,Preescolar,TopKids,234,18,216
2025-09-02,14,Preescolar,EduMax,71,12,59
2025-09-02,14,Preescolar,TopKids,205,5,200
2025-09-02,14,Preescolar,EduMax,228,23,205
2025-09-02,14,Preescolar,SuperSchool,211,3,208
2025-09-02,14,Kínder,SuperSchool,79,12,67
2025-09-02,14,Kínder,EduMax,280,4,276
2025-09-02,14,Kínder,TopKids,242,5,237
2025-09-02,14,Kínder,SuperSchool,192,13,179
2025-09-02,14,Kínder,SuperSchool,232,13,219
2025-09-02,14,Kínder,TopKids,285,8,277
2025-09-02,14,Kínder,SuperSchool,140,6,134
2025-09-02,14,Kínder,TopKids,192,7,185
2025-09-02,14,Kínder,SuperSchool,264,15,249
2025-09-02,14,Kínder,SuperSchool,109,12,97
2025-09-02,14,Kínder,TopKids,181,13,168
2025-09-02,14,Kínder,EduMax,281,7,274
2025-09-02,14,Kínder,EduMax,200,16,184
2025-09-02,14,Kínder,TopKids,103,16,87
2025-09-02,14,Primaria 1°,TopKids,222,13,209
2025-09-02,14,Primaria 1°,SuperSchool,164,18,146
2025-09-02,14,Primaria 1°,SuperSchool,88,20,68
2025-09-02,14,Primaria 1°,EduMax,270,24,246
2025-09-02,14,Primaria 1°,EduMax,199,4,195
2025-09-02,14,Primaria 1°,SuperSchool,230,16,214
2025-09-02,14,Primaria 1°,TopKids,239,9,230
2025-09-02,14,Primaria 1°,EduMax,125,14,111
2025-09-02,14,Primaria 1°,EduMax,294,17,277
2025-09-02,14,Primaria 1°,TopKids,187,13,174
2025-09-02,14,Primaria 1°,SuperSchool,51,1,50
2025-09-02,14,Primaria 2°,SuperSchool,257,10,247
2025-09-02,14,Primaria 2°,EduMax,270,10,260
2025-09-02,14,Primaria 2°,TopKids,152,7,145
2025-09-02,14,Primaria 2°,SuperSchool,50,13,37
2025-09-02,14,Primaria 2°,SuperSchool,84,13,71
2025-09-02,14,Primaria 2°,TopKids,189,18,171
2025-09-02,14,Primaria 2°,TopKids,208,5,203
2025-09-02,14,Primaria 2°,SuperSchool,51,6,45
2025-09-02,14,Primaria 2°,TopKids,242,3,239
2025-09-02,14,Primaria 2°,EduMax,91,11,80
2025-09-02,14,Primaria 3°,SuperSchool,273,16,257
2025-09-02,14,Primaria 3°,TopKids,227,11,216
2025-09-02,14,Primaria 3°,SuperSchool,73,18,55
2025-09-02,14,Primaria 3°,EduMax,54,2,52
2025-09-02,14,Primaria 3°,EduMax,74,18,56
2025-09-02,14,Primaria 3°,EduMax,216,22,194
2025-09-02,14,Primaria 3°,TopKids,60,13,47
2025-09-02,14,Primaria 3°,SuperSchool,195,12,183
2025-09-02,14,Primaria 3°,EduMax,205,10,195
2025-09-02,14,Primaria 4°,EduMax,199,8,191
2025-09-02,14,Primaria 4°,EduMax,180,7,173
2025-09-02,14,Primaria 4°,TopKids,170,20,150
2025-09-02,14,Primaria 4°,TopKids,248,7,241
2025-09-02,14,Primaria 4°,SuperSchool,203,9,194
2025-09-02,14,Primaria 4°,TopKids,220,17,203
2025-09-02,14,Primaria 4°,EduMax,230,20,210
2025-09-02,14,Primaria 4°,SuperSchool,257,23,234
2025-09-02,14,Primaria 4°,SuperSchool,241,8,233
2025-09-02,14,Primaria 4°,SuperSchool,185,5,180
2025-09-02,14,Primaria 4°,SuperSchool,298,7,291
2025-09-02,14,Primaria 4°,TopKids,184,1,183
2025-09-02,14,Primaria 4°,SuperSchool,210,12,198
2025-09-02,14,Primaria 4°,TopKids,234,9,225
2025-09-02,14,Primaria 4°,SuperSchool,285,22,263
2025-09-02,14,Primaria 4°,EduMax,163,9,154
2025-09-02,14,Primaria 5°,SuperSchool,123,14,109
2025-09-02,14,Primaria 5°,SuperSchool,223,7,216
2025-09-02,14,Primaria 5°,EduMax,263,22,241
2025-09-02,14,Primaria 5°,EduMax,94,8,86
2025-09-02,14,Primaria 5°,TopKids,166,2,164
2025-09-02,14,Primaria 5°,EduMax,215,16,199
2025-09-02,14,Primaria 5°,EduMax,224,21,203
2025-09-02,14,Primaria 5°,EduMax,252,21,231
2025-09-02,14,Primaria 5°,SuperSchool,173,2,171
2025-09-02,14,Primaria 5°,EduMax,272,10,262
2025-09-02,14,Primaria 5°,SuperSchool,81,21,60
2025-09-02,14,Primaria 5°,TopKids,167,15,152
2025-09-02,14,Primaria 5°,EduMax,109,4,105
2025-09-02,14,Primaria 5°,SuperSchool,297,1,296
2025-09-02,14,Primaria 5°,SuperSchool,91,4,87
2025-09-02,14,Primaria 5°,SuperSchool,191,19,172
2025-09-02,14,Primaria 5°,SuperSchool,284,8,276
2025-09-02,14,Primaria 6°,SuperSchool,207,21,186
2025-09-02,14,Primaria 6°,EduMax,222,5,217
2025-09-02,14,Primaria 6°,EduMax,88,12,76
2025-09-02,14,Primaria 6°,EduMax,158,14,144
2025-09-02,14,Primaria 6°,EduMax,193,10,183
2025-09-02,15,Preescolar,TopKids,124,1,123
2025-09-02,15,Preescolar,TopKids,161,10,151
2025-09-02,15,Preescolar,EduMax,116,11,105
2025-09-02,15,Preescolar,TopKids,65,6,59
2025-09-02,15,Preescolar,EduMax,218,1,217
2025-09-02,15,Preescolar,EduMax,163,13,150
2025-09-02,15,Preescolar,EduMax,109,19,90
2025-09-02,15,Preescolar,EduMax,236,4,232
2025-09-02,15,Preescolar,EduMax,66,24,42
2025-09-02,15,Preescolar,SuperSchool,141,8,133
2025-09-02,15,Preescolar,SuperSchool,183,2,181
2025-09-02,15,Preescolar,TopKids,171,15,156
2025-09-02,15,Preescolar,TopKids,208,23,185
2025-09-02,15,Preescolar,TopKids,198,16,182
2025-09-02,15,Preescolar,TopKids,223,8,215
2025-09-02,15,Preescolar,EduMax,174,21,153
2025-09-02,15,Preescolar,TopKids,241,19,222
2025-09-02,15,Kínder,TopKids,265,6,259
2025-09-02,15,Kínder,EduMax,156,1,155
2025-09-02,15,Kínder,EduMax,218,16,202
2025-09-02,15,Kínder,EduMax,168,9,159
2025-09-02,15,Kínder,TopKids,246,21,225
2025-09-02,15,Kínder,EduMax,143,7,136
2025-09-02,15,Kínder,SuperSchool,243,20,223
2025-09-02,15,Kínder,TopKids,112,4,108
2025-09-02,15,Kínder,EduMax,212,2,210
2025-09-02,15,Kínder,SuperSchool,205,11,194
2025-09-02,15,Kínder,SuperSchool,151,1,150
2025-09-02,15,Kínder,EduMax,204,3,201
2025-09-02,15,Kínder,TopKids,250,8,242
2025-09-02,15,Primaria 1°,SuperSchool,141,13,128
2025-09-02,15,Primaria 1°,EduMax,100,24,76
2025-09-02,15,Primaria 1°,SuperSchool,75,24,51
2025-09-02,15,Primaria 1°,SuperSchool,55,21,34
2025-09-02,15,Primaria 1°,TopKids,85,9,76
2025-09-02,15,Primaria 1°,EduMax,116,17,99
2025-09-02,15,Primaria 1°,SuperSchool,120,8,112
2025-09-02,15,Primaria 1°,TopKids,254,3,251
2025-09-02,15,Primaria 1°,TopKids,159,22,137
2025-09-02,15,Primaria 1°,TopKids,115,6,109
2025-09-02,15,Primaria 1°,SuperSchool,143,7,136
2025-09-02,15,Primaria 1°,TopKids,218,9,209
2025-09-02,15,Primaria 1°,SuperSchool,296,3,293
2025-09-02,15,Primaria 1°,EduMax,242,10,232
2025-09-02,15,Primaria 1°,EduMax,273,3,270
2025-09-02,15,Primaria 1°,EduMax,122,17,105
2025-09-02,15,Primaria 2°,TopKids,268,21,247
2025-09-02,15,Primaria 2°,TopKids,53,4,49
2025-09-02,15,Primaria 2°,SuperSchool,145,6,139
2025-09-02,15,Primaria 2°,TopKids,93,23,70
2025-09-02,15,Primaria 2°,TopKids,286,6,280
2025-09-02,15,Primaria 2°,TopKids,239,3,236
2025-09-02,15,Primaria 2°,SuperSchool,159,14,145
2025-09-02,15,Primaria 2°,TopKids,155,5,150
2025-09-02,15,Primaria 2°,EduMax,139,2,137
2025-09-02,15,Primaria 2°,EduMax,296,11,285
2025-09-02,15,Primaria 2°,EduMax,235,24,211
2025-09-02,15,Primaria 2°,SuperSchool,92,24,68
2025-09-02,15,Primaria 2°,TopKids,244,2,242
2025-09-02,15,Primaria 2°,TopKids,182,21,161
2025-09-02,15,Primaria 2°,SuperSchool,153,9,144
2025-09-02,15,Primaria 2°,TopKids,273,8,265
2025-09-02,15,Primaria 2°,EduMax,51,10,41
2025-09-02,15,Primaria 2°,TopKids,168,11,157
2025-09-02,15,Primaria 2°,SuperSchool,159,23,136
2025-09-02,15,Primaria 3°,TopKids,147,18,129
2025-09-02,15,Primaria 3°,SuperSchool,146,17,129
2025-09-02,15,Primaria 3°,EduMax,62,21,41
2025-09-02,15,Primaria 3°,TopKids,107,24,83
2025-09-02,15,Primaria 3°,SuperSchool,274,24,250
2025-09-02,15,Primaria 3°,EduMax,185,13,172
2025-09-02,15,Primaria 3°,EduMax,107,8,99
2025-09-02,15,Primaria 4°,SuperSchool,126,1,125
2025-09-02,15,Primaria 4°,EduMax,237,5,232
2025-09-02,15,Primaria 4°,TopKids,197,13,184
2025-09-02,15,Primaria 4°,EduMax,214,10,204
2025-09-02,15,Primaria 4°,TopKids,211,2,209
2025-09-02,15,Primaria 4°,EduMax,214,4,210
2025-09-02,15,Primaria 4°,EduMax,209,21,188
2025-09-02,15,Primaria 4°,EduMax,154,24,130
2025-09-02,15,Primaria 4°,SuperSchool,90,24,66
2025-09-02,15,Primaria 4°,SuperSchool,85,8,77
2025-09-02,15,Primaria 5°,EduMax,154,3,151
2025-09-02,15,Primaria 5°,EduMax,141,23,118
2025-09-02,15,Primaria 5°,TopKids,209,5,204
2025-09-02,15,Primaria 5°,SuperSchool,228,24,204
2025-09-02,15,Primaria 5°,TopKids,185,9,176
2025-09-02,15,Primaria 5°,EduMax,72,22,50
2025-09-02,15,Primaria 5°,EduMax,72,10,62
2025-09-02,15,Primaria 5°,SuperSchool,212,3,209
2025-09-02,15,Primaria 5°,TopKids,244,4,240
2025-09-02,15,Primaria 5°,SuperSchool,226,14,212
2025-09-02,15,Primaria 5°,TopKids,208,2,206
2025-09-02,15,Primaria 5°,SuperSchool,236,22,214
2025-09-02,15,Primaria 5°,SuperSchool,243,12,231
2025-09-02,15,Primaria 5°,SuperSchool,200,9,191
2025-09-02,15,Primaria 5°,TopKids,178,24,154
2025-09-02,15,Primaria 5°,TopKids,136,18,118
2025-09-02,15,Primaria 5°,EduMax,273,15,258
2025-09-02,15,Primaria 5°,SuperSchool,252,24,228
2025-09-02,15,Primaria 6°,TopKids,210,5,205
2025-09-02,15,Primaria 6°,EduMax,242,10,232
2025-09-02,15,Primaria 6°,SuperSchool,204,8,196
2025-09-02,15,Primaria 6°,SuperSchool,101,2,99
2025-09-02,15,Primaria 6°,EduMax,166,12,154
2025-09-02,16,Preescolar,SuperSchool,254,22,232
2025-09-02,16,Preescolar,TopKids,144,7,137
2025-09-02,16,Preescolar,TopKids,290,19,271
2025-09-02,16,Preescolar,TopKids,56,12,44
2025-09-02,16,Preescolar,EduMax,83,7,76
2025-09-02,16,Preescolar,SuperSchool,113,1,112
2025-09-02,16,Preescolar,EduMax,83,22,61
2025-09-02,16,Preescolar,EduMax,223,12,211
2025-09-02,16,Preescolar,EduMax,86,7,79
2025-09-02,16,Preescolar,SuperSchool,129,22,107
2025-09-02,16,Preescolar,TopKids,149,20,129
2025-09-02,16,Preescolar,TopKids,101,1,100
2025-09-02,16,Preescolar,SuperSchool,229,20,209
2025-09-02,16,Preescolar,EduMax,218,10,208
2025-09-02,16,Preescolar,EduMax,199,7,192
2025-09-02,16,Kínder,SuperSchool,169,1,168
2025-09-02,16,Kínder,TopKids,90,14,76
2025-09-02,16,Kínder,TopKids,277,8,269
2025-09-02,16,Kínder,SuperSchool,288,22,266
2025-09-02,16,Kínder,SuperSchool,245,19,226
2025-09-02,16,Kínder,TopKids,121,2,119
2025-09-02,16,Kínder,EduMax,202,8,194
2025-09-02,16,Kínder,SuperSchool,129,16,113
2025-09-02,16,Kínder,TopKids,88,15,73
2025-09-02,16,Kínder,SuperSchool,298,3,295
2025-09-02,16,Kínder,SuperSchool,281,7,274
2025-09-02,16,Primaria 1°,EduMax,264,5,259
2025-09-02,16,Primaria 1°,TopKids,184,10,174
2025-09-02,16,Primaria 1°,TopKids,147,18,129
2025-09-02,16,Primaria 1°,TopKids,72,19,53
2025-09-02,16,Primaria 1°,TopKids,63,23,40
2025-09-02,16,Primaria 1°,EduMax,51,18,33
2025-09-02,16,Primaria 2°,TopKids,82,16,66
2025-09-02,16,Primaria 2°,TopKids,219,20,199
2025-09-02,16,Primaria 2°,SuperSchool,272,3,269
2025-09-02,16,Primaria 2°,SuperSchool,262,23,239
2025-09-02,16,Primaria 2°,TopKids,159,11,148
2025-09-02,16,Primaria 2°,SuperSchool,88,2,86
2025-09-02,16,Primaria 2°,TopKids,165,8,157
2025-09-02,16,Primaria 2°,SuperSchool,138,21,117
2025-09-02,16,Primaria 2°,SuperSchool,105,14,91
2025-09-02,16,Primaria 2°,SuperSchool,148,14,134
2025-09-02,16,Primaria 2°,SuperSchool,160,12,148
2025-09-02,16,Primaria 2°,EduMax,292,10,282
2025-09-02,16,Primaria 2°,SuperSchool,80,24,56
2025-09-02,16,Primaria 3°,SuperSchool,162,3,159
2025-09-02,16,Primaria 3°,SuperSchool,282,17,265
2025-09-02,16,Primaria 3°,EduMax,177,20,157
2025-09-02,16,Primaria 3°,TopKids,168,21,147
2025-09-02,16,Primaria 3°,TopKids,87,2,85
2025-09-02,16,Primaria 3°,SuperSchool,118,18,100
2025-09-02,16,Primaria 3°,EduMax,299,21,278
2025-09-02,16,Primaria 3°,EduMax,206,10,196
2025-09-02,16,Primaria 3°,EduMax,232,10,222
2025-09-02,16,Primaria 3°,SuperSchool,99,16,83
2025-09-02,16,Primaria 3°,TopKids,143,6,137
2025-09-02,16,Primaria 3°,EduMax,234,22,212
2025-09-02,16,Primaria 3°,EduMax,60,1,59
2025-09-02,16,Primaria 3°,SuperSchool,290,11,279
2025-09-02,16,Primaria 3°,EduMax,154,10,144
2025-09-02,16,Primaria 3°,EduMax,234,6,228
2025-09-02,16,Primaria 3°,EduMax,204,3,201
2025-09-02,16,Primaria 3°,SuperSchool,125,18,107
2025-09-02,16,Primaria 4°,EduMax,55,5,50
2025-09-02,16,Primaria 4°,TopKids,256,15,241
2025-09-02,16,Primaria 4°,SuperSchool,94,16,78
2025-09-02,16,Primaria 4°,SuperSchool,51,17,34
2025-09-02,16,Primaria 4°,SuperSchool,139,23,116
2025-09-02,16,Primaria 4°,TopKids,112,6,106
2025-09-02,16,Primaria 4°,EduMax,53,15,38
2025-09-02,16,Primaria 4°,EduMax,271,12,259
2025-09-02,16,Primaria 4°,TopKids,93,20,73
2025-09-02,16,Primaria 4°,SuperSchool,280,20,260
2025-09-02,16,Primaria 5°,TopKids,61,17,44
2025-09-02,16,Primaria 5°,EduMax,205,4,201
2025-09-02,16,Primaria 5°,EduMax,95,14,81
2025-09-02,16,Primaria 5°,SuperSchool,290,17,273
2025-09-02,16,Primaria 5°,EduMax,227,3,224
2025-09-02,16,Primaria 5°,SuperSchool,257,19,238
2025-09-02,16,Primaria 5°,EduMax,168,6,162
2025-09-02,16,Primaria 5°,EduMax,282,18,264
2025-09-02,16,Primaria 5°,EduMax,218,18,200
2025-09-02,16,Primaria 6°,EduMax,136,13,123
2025-09-02,16,Primaria 6°,TopKids,121,24,97
2025-09-02,16,Primaria 6°,SuperSchool,250,6,244
2025-09-02,16,Primaria 6°,SuperSchool,146,13,133
2025-09-02,16,Primaria 6°,TopKids,155,18,137
2025-09-02,16,Primaria 6°,EduMax,94,5,89
2025-09-02,16,Primaria 6°,SuperSchool,267,15,252
2025-09-02,16,Primaria 6°,EduMax,207,11,196
2025-09-02,16,Primaria 6°,SuperSchool,57,5,52
2025-09-02,16,Primaria 6°,EduMax,64,6,58
2025-09-02,16,Primaria 6°,EduMax,104,3,101
2025-09-02,16,Primaria 6°,SuperSchool,187,7,180
2025-09-02,16,Primaria 6°,TopKids,164,24,140
2025-09-03,9,Preescolar,EduMax,171,8,163
2025-09-03,9,Preescolar,TopKids,237,5,232
2025-09-03,9,Preescolar,TopKids,203,10,193
2025-09-03,9,Preescolar,SuperSchool,149,22,127
2025-09-03,9,Preescolar,TopKids,87,18,69
2025-09-03,9,Preescolar,SuperSchool,286,13,273
2025-09-03,9,Preescolar,SuperSchool,149,4,145
2025-09-03,9,Preescolar,EduMax,201,18,183
2025-09-03,9,Preescolar,EduMax,288,18,270
2025-09-03,9,Preescolar,TopKids,66,5,61
2025-09-03,9,Preescolar,TopKids,257,20,237
2025-09-03,9,Preescolar,EduMax,130,1,129
2025-09-03,9,Preescolar,EduMax,98,18,80
2025-09-03,9,Preescolar,TopKids,266,5,261
2025-09-03,9,Kínder,SuperSchool,169,23,146
2025-09-03,9,Kínder,TopKids,177,6,171
2025-09-03,9,Kínder,SuperSchool,259,4,255
2025-09-03,9,Kínder,SuperSchool,72,3,69
2025-09-03,9,Kínder,EduMax,233,24,209
2025-09-03,9,Kínder,SuperSchool,233,22,211
2025-09-03,9,Kínder,TopKids,91,11,80
2025-09-03,9,Kínder,TopKids,234,14,220
2025-09-03,9,Kínder,EduMax,196,4,192
2025-09-03,9,Kínder,TopKids,75,1,74
2025-09-03,9,Kínder,EduMax,119,13,106
2025-09-03,9,Kínder,EduMax,269,1,268
2025-09-03,9,Kínder,SuperSchool,89,18,71
2025-09-03,9,Kínder,EduMax,147,24,123
2025-09-03,9,Kínder,TopKids,73,1,72
2025-09-03,9,Kínder,EduMax,294,15,279
2025-09-03,9,Kínder,TopKids,81,18,63
2025-09-03,9,Kínder,SuperSchool,276,15,261
2025-09-03,9,Primaria 1°,TopKids,254,9,245
2025-09-03,9,Primaria 1°,EduMax,114,2,112
2025-09-03,9,Primaria 1°,SuperSchool,287,5,282
2025-09-03,9,Primaria 1°,SuperSchool,263,10,253
2025-09-03,9,Primaria 1°,EduMax,196,8,188
2025-09-03,9,Primaria 1°,SuperSchool,282,18,264
2025-09-03,9,Primaria 1°,SuperSchool,117,8,109
2025-09-03,9,Primaria 1°,SuperSchool,206,6,200
2025-09-03,9,Primaria 1°,SuperSchool,109,1,108
2025-09-03,9,Primaria 1°,TopKids,77,19,58
2025-09-03,9,Primaria 1°,EduMax,277,1,276
2025-09-03,9,Primaria 1°,SuperSchool,228,4,224
2025-09-03,9,Primaria 1°,EduMax,81,14,67
2025-09-03,9,Primaria 1°,SuperSchool,260,11,249
2025-09-03,9,Primaria 1°,TopKids,181,9,172
2025-09-03,9,Primaria 1°,SuperSchool,194,15,179
2025-09-03,9,Primaria 1°,EduMax,158,1,157
2025-09-03,9,Primaria 2°,EduMax,140,21,119
2025-09-03,9,Primaria 2°,TopKids,190,11,179
2025-09-03,9,Primaria 2°,EduMax,145,16,129
2025-09-03,9,Primaria 2°,SuperSchool,151,2,149
2025-09-03,9,Primaria 2°,EduMax,246,19,227
2025-09-03,9,Primaria 2°,TopKids,141,17,124
2025-09-03,9,Primaria 3°,TopKids,204,18,186
2025-09-03,9,Primaria 3°,TopKids,171,4,167
2025-09-03,9,Primaria 3°,TopKids,160,11,149
2025-09-03,9,Primaria 3°,EduMax,67,3,64
2025-09-03,9,Primaria 3°,EduMax,287,6,281
2025-09-03,9,Primaria 3°,EduMax,210,8,202
2025-09-03,9,Primaria 3°,EduMax,176,20,156
2025-09-03,9,Primaria 3°,EduMax,261,11,250
2025-09-03,9,Primaria 3°,EduMax,76,16,60
2025-09-03,9,Primaria 4°,TopKids,199,2,197
2025-09-03,9,Primaria 4°,TopKids,254,20,234
2025-09-03,9,Primaria 4°,EduMax,63,7,56
2025-09-03,9,Primaria 4°,TopKids,157,12,145
2025-09-03,9,Primaria 4°,SuperSchool,104,6,98
2025-09-03,9,Primaria 4°,TopKids,62,5,57
2025-09-03,9,Primaria 4°,EduMax,236,14,222
2025-09-03,9,Primaria 4°,SuperSchool,290,3,287
2025-09-03,9,Primaria 4°,TopKids,167,4,163
2025-09-03,9,Primaria 5°,EduMax,255,1,254
2025-09-03,9,Primaria 5°,TopKids,189,5,184
2025-09-03,9,Primaria 5°,EduMax,85,17,68
2025-09-03,9,Primaria 5°,EduMax,199,13,186
2025-09-03,9,Primaria 5°,TopKids,244,11,233
2025-09-03,9,Primaria 5°,TopKids,60,5,55
2025-09-03,9,Primaria 5°,EduMax,245,10,235
2025-09-03,9,Primaria 5°,EduMax,157,22,135
2025-09-03,9,Primaria 5°,TopKids,131,15,116
2025-09-03,9,Primaria 5°,TopKids,136,18,118
2025-09-03,9,Primaria 5°,TopKids,116,1,115
2025-09-03,9,Primaria 5°,SuperSchool,91,6,85
2025-09-03,9,Primaria 6°,SuperSchool,188,14,174
2025-09-03,9,Primaria 6°,SuperSchool,77,7,70
2025-09-03,9,Primaria 6°,EduMax,149,11,138
2025-09-03,9,Primaria 6°,TopKids,282,21,261
2025-09-03,9,Primaria 6°,EduMax,279,19,260
2025-09-03,9,Primaria 6°,TopKids,51,11,40
2025-09-03,9,Primaria 6°,SuperSchool,291,9,282
2025-09-03,9,Primaria 6°,TopKids,223,8,215
2025-09-03,9,Primaria 6°,TopKids,94,10,84
2025-09-03,9,Primaria 6°,TopKids,285,21,264
2025-09-03,9,Primaria 6°,SuperSchool,180,2,178
2025-09-03,9,Primaria 6°,TopKids,73,18,55
2025-09-03,9,Primaria 6°,SuperSchool,202,4,198
2025-09-03,10,Preescolar,SuperSchool,92,15,77
2025-09-03,10,Preescolar,TopKids,237,24,213
2025-09-03,10,Preescolar,SuperSchool,243,23,220
2025-09-03,10,Preescolar,TopKids,192,13,179
2025-09-03,10,Preescolar,EduMax,212,14,198
2025-09-03,10,Preescolar,EduMax,126,23,103
2025-09-03,10,Preescolar,EduMax,257,12,245
2025-09-03,10,Preescolar,SuperSchool,151,13,138
2025-09-03,10,Preescolar,EduMax,297,2,295
2025-09-03,10,Preescolar,EduMax,162,19,143
2025-09-03,10,Preescolar,TopKids,81,15,66
2025-09-03,10,Preescolar,TopKids,90,8,82
2025-09-03,10,Kínder,TopKids,163,17,146
2025-09-03,10,Kínder,EduMax,296,6,290
2025-09-03,10,Kínder,TopKids,105,2,103
2025-09-03,10,Kínder,SuperSchool,59,8,51
2025-09-03,10,Kínder,EduMax,201,16,185
2025-09-03,10,Kínder,EduMax,139,7,132
2025-09-03,10,Kínder,EduMax,133,9,124
2025-09-03,10,Kínder,EduMax,78,16,62
2025-09-03,10,Kínder,EduMax,60,9,51
2025-09-03,10,Kínder,SuperSchool,295,11,284
2025-09-03,10,Kínder,TopKids,134,11,123
2025-09-03,10,Kínder,TopKids,172,10,162
2025-09-03,10,Primaria 1°,SuperSchool,279,7,272
2025-09-03,10,Primaria 1°,SuperSchool,55,3,52
2025-09-03,10,Primaria 1°,TopKids,170,13,157
2025-09-03,10,Primaria 1°,EduMax,75,4,71
2025-09-03,10,Primaria 1°,SuperSchool,70,19,51
2025-09-03,10,Primaria 1°,EduMax,297,7,290
2025-09-03,10,Primaria 1°,SuperSchool,210,17,193
2025-09-03,10,Primaria 1°,SuperSchool,261,18,243
2025-09-03,10,Primaria 1°,SuperSchool,167,6,161
2025-09-03,10,Primaria 1°,EduMax,173,19,154
2025-09-03,10,Primaria 2°,EduMax,187,10,177
2025-09-03,10,Primaria 2°,SuperSchool,93,24,69
2025-09-03,10,Primaria 2°,SuperSchool,171,10,161
2025-09-03,10,Primaria 2°,TopKids,247,9,238
2025-09-03,10,Primaria 2°,EduMax,105,10,95
2025-09-03,10,Primaria 2°,TopKids,162,19,143
2025-09-03,10,Primaria 2°,EduMax,276,14,262
2025-09-03,10,Primaria 2°,EduMax,78,19,59
2025-09-03,10,Primaria 2°,EduMax,157,15,142
2025-09-03,10,Primaria 2°,SuperSchool,87,21,66
2025-09-03,10,Primaria 2°,TopKids,216,23,193
2025-09-03,10,Primaria 2°,EduMax,291,2,289
2025-09-03,10,Primaria 2°,SuperSchool,81,15,66
2025-09-03,10,Primaria 2°,TopKids,52,16,36
2025-09-03,10,Primaria 3°,SuperSchool,264,23,241
2025-09-03,10,Primaria 3°,SuperSchool,75,8,67
2025-09-03,10,Primaria 3°,EduMax,265,13,252
2025-09-03,10,Primaria 3°,EduMax,50,16,34
2025-09-03,10,Primaria 3°,TopKids,156,24,132
2025-09-03,10,Primaria 3°,TopKids,124,6,118
2025-09-03,10,Primaria 3°,EduMax,270,11,259
2025-09-03,10,Primaria 3°,EduMax,178,9,169
2025-09-03,10,Primaria 3°,TopKids,120,21,99
2025-09-03,10,Primaria 3°,EduMax,52,9,43
2025-09-03,10,Primaria 3°,EduMax,173,10,163
2025-09-03,10,Primaria 3°,SuperSchool,208,1,207
2025-09-03,10,Primaria 3°,EduMax,195,6,189
2025-09-03,10,Primaria 3°,EduMax,282,10,272
2025-09-03,10,Primaria 4°,TopKids,181,1,180
2025-09-03,10,Primaria 4°,SuperSchool,220,21,199
2025-09-03,10,Primaria 4°,TopKids,196,21,175
2025-09-03,10,Primaria 4°,SuperSchool,235,20,215
2025-09-03,10,Primaria 4°,TopKids,246,2,244
2025-09-03,10,Primaria 4°,TopKids,297,3,294
2025-09-03,10,Primaria 4°,TopKids,280,5,275
2025-09-03,10,Primaria 4°,TopKids,123,9,114
2025-09-03,10,Primaria 4°,TopKids,63,22,41
2025-09-03,10,Primaria 4°,SuperSchool,274,16,258
2025-09-03,10,Primaria 4°,SuperSchool,151,2,149
2025-09-03,10,Primaria 4°,TopKids,158,8,150
2025-09-03,10,Primaria 4°,SuperSchool,218,13,205
2025-09-03,10,Primaria 4°,EduMax,99,9,90
2025-09-03,10,Primaria 4°,EduMax,149,18,131
2025-09-03,10,Primaria 4°,SuperSchool,61,16,45
2025-09-03,10,Primaria 4°,SuperSchool,124,14,110
2025-09-03,10,Primaria 4°,EduMax,104,21,83
2025-09-03,10,Primaria 4°,TopKids,137,21,116
2025-09-03,10,Primaria 5°,SuperSchool,287,5,282
2025-09-03,10,Primaria 5°,TopKids,167,8,159
2025-09-03,10,Primaria 5°,EduMax,236,3,233
2025-09-03,10,Primaria 5°,TopKids,211,11,200
2025-09-03,10,Primaria 5°,SuperSchool,266,7,259
2025-09-03,10,Primaria 6°,EduMax,78,19,59
2025-09-03,10,Primaria 6°,EduMax,139,9,130
2025-09-03,10,Primaria 6°,SuperSchool,234,10,224
2025-09-03,10,Primaria 6°,TopKids,98,7,91
2025-09-03,10,Primaria 6°,EduMax,247,9,238
2025-09-03,10,Primaria 6°,TopKids,167,22,145
2025-09-03,10,Primaria 6°,SuperSchool,201,1,200
2025-09-03,10,Primaria 6°,TopKids,211,22,189
2025-09-03,10,Primaria 6°,TopKids,213,20,193
2025-09-03,10,Primaria 6°,SuperSchool,131,10,121
2025-09-03,10,Primaria 6°,SuperSchool,123,9,114
2025-09-03,10,Primaria 6°,TopKids,74,13,61
2025-09-03,10,Primaria 6°,TopKids,291,13,278
2025-09-03,10,Primaria 6°,SuperSchool,80,2,78
2025-09-03,10,Primaria 6°,EduMax,248,9,239
2025-09-03,10,Primaria 6°,TopKids,223,17,206
2025-09-03,10,Primaria 6°,TopKids,135,5,130
2025-09-03,10,Primaria 6°,SuperSchool,70,9,61
2025-09-03,11,Preescolar,TopKids,194,8,186
2025-09-03,11,Preescolar,TopKids,185,12,173
2025-09-03,11,Preescolar,EduMax,78,19,59
2025-09-03,11,Preescolar,EduMax,201,2,199
2025-09-03,11,Preescolar,TopKids,287,19,268
2025-09-03,11,Preescolar,SuperSchool,286,9,277
2025-09-03,11,Preescolar,EduMax,126,16,110
2025-09-03,11,Preescolar,EduMax,231,1,230
2025-09-03,11,Preescolar,SuperSchool,122,24,98
2025-09-03,11,Preescolar,TopKids,94,17,77
2025-09-03,11,Preescolar,EduMax,298,9,289
2025-09-03,11,Preescolar,TopKids,136,20,116
2025-09-03,11,Preescolar,TopKids,91,21,70
2025-09-03,11,Preescolar,TopKids,235,5,230
2025-09-03,11,Preescolar,SuperSchool,275,9,266
2025-09-03,11,Preescolar,EduMax,59,12,47
2025-09-03,11,Preescolar,EduMax,160,3,157
2025-09-03,11,Kínder,TopKids,77,9,68
2025-09-03,11,Kínder,TopKids,142,22,120
2025-09-03,11,Kínder,TopKids,142,13,129
2025-09-03,11,Kínder,TopKids,60,3,57
2025-09-03,11,Kínder,TopKids,57,7,50
2025-09-03,11,Kínder,SuperSchool,119,19,100
2025-09-03,11,Primaria 1°,TopKids,271,11,260
2025-09-03,11,Primaria 1°,EduMax,140,24,116
2025-09-03,11,Primaria 1°,SuperSchool,255,17,238
2025-09-03,11,Primaria 1°,TopKids,206,24,182
2025-09-03,11,Primaria 1°,SuperSchool,158,6,152
2025-09-03,11,Primaria 1°,EduMax,133,20,113
2025-09-03,11,Primaria 1°,EduMax,134,13,121
2025-09-03,11,Primaria 1°,TopKids,223,12,211
2025-09-03,11,Primaria 1°,TopKids,190,10,180
2025-09-03,11,Primaria 1°,TopKids,278,12,266
2025-09-03,11,Primaria 1°,SuperSchool,202,2,200
2025-09-03,11,Primaria 1°,EduMax,281,19,262
2025-09-03,11,Primaria 1°,SuperSchool,111,8,103
2025-09-03,11,Primaria 1°,EduMax,286,9,277
2025-09-03,11,Primaria 1°,TopKids,261,20,241
2025-09-03,11,Primaria 1°,TopKids,188,8,180
2025-09-03,11,Primaria 2°,EduMax,151,10,141
2025-09-03,11,Primaria 2°,EduMax,266,19,247
2025-09-03,11,Primaria 2°,TopKids,52,17,35
2025-09-03,11,Primaria 2°,EduMax,59,6,53
2025-09-03,11,Primaria 2°,TopKids,80,16,64
2025-09-03,11,Primaria 2°,SuperSchool,294,12,282
2025-09-03,11,Primaria 2°,EduMax,203,2,201
2025-09-03,11,Primaria 2°,EduMax,53,6,47
2025-09-03,11,Primaria 2°,EduMax,232,13,219
2025-09-03,11,Primaria 2°,TopKids,159,4,155
2025-09-03,11,Primaria 3°,EduMax,182,4,178
2025-09-03,11,Primaria 3°,EduMax,199,14,185
2025-09-03,11,Primaria 3°,TopKids,179,14,165
2025-09-03,11,Primaria 3°,EduMax,225,3,222
2025-09-03,11,Primaria 3°,TopKids,121,23,98
2025-09-03,11,Primaria 3°,SuperSchool,245,21,224
2025-09-03,11,Primaria 3°,EduMax,196,15,181
2025-09-03,11,Primaria 3°,EduMax,91,10,81
2025-09-03,11,Primaria 3°,TopKids,137,12,125
2025-09-03,11,Primaria 3°,SuperSchool,128,18,110
2025-09-03,11,Primaria 3°,SuperSchool,52,8,44
2025-09-03,11,Primaria 3°,TopKids,113,15,98
2025-09-03,11,Primaria 3°,TopKids,172,22,150
2025-09-03,11,Primaria 3°,SuperSchool,285,12,273
2025-09-03,11,Primaria 4°,SuperSchool,294,9,285
2025-09-03,11,Primaria 4°,TopKids,288,20,268
2025-09-03,11,Primaria 4°,SuperSchool,82,22,60
2025-09-03,11,Primaria 4°,TopKids,60,18,42
2025-09-03,11,Primaria 4°,EduMax,66,14,52
2025-09-03,11,Primaria 4°,SuperSchool,182,7,175
2025-09-03,11,Primaria 4°,TopKids,235,16,219
2025-09-03,11,Primaria 4°,SuperSchool,186,23,163
2025-09-03,11,Primaria 4°,TopKids,213,20,193
2025-09-03,11,Primaria 4°,TopKids,233,7,226
2025-09-03,11,Primaria 4°,TopKids,223,4,219
2025-09-03,11,Primaria 4°,EduMax,74,7,67
2025-09-03,11,Primaria 4°,TopKids,221,14,207
2025-09-03,11,Primaria 4°,SuperSchool,111,19,92
2025-09-03,11,Primaria 5°,EduMax,97,1,96
2025-09-03,11,Primaria 5°,TopKids,214,6,208
2025-09-03,11,Primaria 5°,TopKids,266,21,245
2025-09-03,11,Primaria 5°,SuperSchool,220,4,216
2025-09-03,11,Primaria 5°,EduMax,293,14,279
2025-09-03,11,Primaria 5°,TopKids,122,3,119
2025-09-03,11,Primaria 5°,TopKids,60,20,40
2025-09-03,11,Primaria 5°,TopKids,295,5,290
2025-09-03,11,Primaria 5°,TopKids,168,2,166
2025-09-03,11,Primaria 5°,EduMax,77,7,70
2025-09-03,11,Primaria 5°,EduMax,220,5,215
2025-09-03,11,Primaria 5°,SuperSchool,277,9,268
2025-09-03,11,Primaria 5°,TopKids,271,13,258
2025-09-03,11,Primaria 5°,EduMax,152,18,134
2025-09-03,11,Primaria 5°,EduMax,211,21,190
2025-09-03,11,Primaria 5°,SuperSchool,222,23,199
2025-09-03,11,Primaria 6°,SuperSchool,185,18,167
2025-09-03,11,Primaria 6°,EduMax,97,4,93
2025-09-03,11,Primaria 6°,EduMax,243,21,222
2025-09-03,11,Primaria 6°,TopKids,101,24,77
2025-09-03,11,Primaria 6°,TopKids,80,24,56
2025-09-03,11,Primaria 6°,EduMax,198,17,181
2025-09-03,12,Preescolar,EduMax,170,8,162
2025-09-03,12,Preescolar,SuperSchool,164,19,145
2025-09-03,12,Preescolar,TopKids,166,7,159
2025-09-03,12,Preescolar,SuperSchool,146,10,136
2025-09-03,12,Preescolar,SuperSchool,263,5,258
2025-09-03,12,Preescolar,SuperSchool,52,19,33
2025-09-03,12,Preescolar,TopKids,286,11,275
2025-09-03,12,Preescolar,EduMax,179,9,170
2025-09-03,12,Preescolar,SuperSchool,285,4,281
2025-09-03,12,Preescolar,EduMax,260,10,250
2025-09-03,12,Preescolar,TopKids,184,13,171
2025-09-03,12,Preescolar,SuperSchool,157,2,155
2025-09-03,12,Preescolar,EduMax,135,21,114
2025-09-03,12,Preescolar,SuperSchool,76,7,69
2025-09-03,12,Preescolar,SuperSchool,107,16,91
2025-09-03,12,Preescolar,EduMax,185,17,168
2025-09-03,12,Preescolar,SuperSchool,164,4,160
2025-09-03,12,Preescolar,EduMax,139,16,123
2025-09-03,12,Kínder,SuperSchool,150,2,148
2025-09-03,12,Kínder,SuperSchool,268,16,252
2025-09-03,12,Kínder,SuperSchool,112,6,106
2025-09-03,12,Kínder,SuperSchool,152,2,150
2025-09-03,12,Kínder,TopKids,283,14,269
2025-09-03,12,Kínder,TopKids,276,2,274
2025-09-03,12,Kínder,TopKids,194,19,175
2025-09-03,12,Primaria 1°,TopKids,232,11,221
2025-09-03,12,Primaria 1°,SuperSchool,271,13,258
2025-09-03,12,Primaria 1°,EduMax,191,22,169
2025-09-03,12,Primaria 1°,TopKids,118,2,116
2025-09-03,12,Primaria 1°,TopKids,66,6,60
2025-09-03,12,Primaria 1°,EduMax,85,3,82
2025-09-03,12,Primaria 1°,TopKids,92,1,91
2025-09-03,12,Primaria 1°,EduMax,151,23,128
2025-09-03,12,Primaria 1°,TopKids,130,17,113
2025-09-03,12,Primaria 1°,TopKids,124,22,102
2025-09-03,12,Primaria 1°,TopKids,158,8,150
2025-09-03,12,Primaria 1°,SuperSchool,270,7,263
2025-09-03,12,Primaria 1°,SuperSchool,263,9,254
2025-09-03,12,Primaria 1°,TopKids,211,18,193
2025-09-03,12,Primaria 2°,EduMax,116,18,98
2025-09-03,12,Primaria 2°,TopKids,249,6,243
2025-09-03,12,Primaria 2°,SuperSchool,202,2,200
2025-09-03,12,Primaria 2°,EduMax,166,9,157
2025-09-03,12,Primaria 2°,TopKids,70,15,55
2025-09-03,12,Primaria 2°,EduMax,96,22,74
2025-09-03,12,Primaria 2°,TopKids,133,12,121
2025-09-03,12,Primaria 2°,TopKids,64,16,48
2025-09-03,12,Primaria 2°,EduMax,269,6,263
2025-09-03,12,Primaria 2°,TopKids,215,23,192
2025-09-03,12,Primaria 2°,EduMax,244,21,223
2025-09-03,12,Primaria 2°,SuperSchool,221,8,213
2025-09-03,12,Primaria 2°,TopKids,115,7,108
2025-09-03,12,Primaria 2°,SuperSchool,66,7,59
2025-09-03,12,Primaria 2°,SuperSchool,85,15,70
2025-09-03,12,Primaria 2°,SuperSchool,259,14,245
2025-09-03,12,Primaria 2°,EduMax,141,11,130
2025-09-03,12,Primaria 2°,TopKids,199,6,193
2025-09-03,12,Primaria 3°,SuperSchool,235,17,218
2025-09-03,12,Primaria 3°,EduMax,108,8,100
2025-09-03,12,Primaria 3°,EduMax,89,2,87
2025-09-03,12,Primaria 3°,SuperSchool,271,4,267
2025-09-03,12,Primaria 3°,SuperSchool,134,22,112
2025-09-03,12,Primaria 3°,EduMax,176,15,161
2025-09-03,12,Primaria 3°,SuperSchool,154,7,147
2025-09-03,12,Primaria 3°,TopKids,147,7,140
2025-09-03,12,Primaria 3°,SuperSchool,227,23,204
2025-09-03,12,Primaria 3°,TopKids,145,19,126
2025-09-03,12,Primaria 3°,EduMax,105,16,89
2025-09-03,12,Primaria 3°,EduMax,249,19,230
2025-09-03,12,Primaria 3°,EduMax,51,2,49
2025-09-03,12,Primaria 3°,SuperSchool,281,10,271
2025-09-03,12,Primaria 3°,SuperSchool,166,11,155
2025-09-03,12,Primaria 3°,TopKids,235,20,215
2025-09-03,12,Primaria 3°,TopKids,108,16,92
2025-09-03,12,Primaria 3°,TopKids,185,19,166
2025-09-03,12,Primaria 4°,EduMax,286,11,275
2025-09-03,12,Primaria 4°,SuperSchool,94,21,73
2025-09-03,12,Primaria 4°,TopKids,244,6,238
2025-09-03,12,Primaria 4°,TopKids,168,3,165
2025-09-03,12,Primaria 4°,SuperSchool,299,1,298
2025-09-03,12,Primaria 4°,EduMax,296,20,276
2025-09-03,12,Primaria 4°,TopKids,170,9,161
2025-09-03,12,Primaria 4°,SuperSchool,123,13,110
2025-09-03,12,Primaria 4°,TopKids,59,22,37
2025-09-03,12,Primaria 4°,TopKids,266,7,259
2025-09-03,12,Primaria 4°,TopKids,68,7,61
2025-09-03,12,Primaria 4°,EduMax,159,21,138
2025-09-03,12,Primaria 4°,EduMax,67,10,57
2025-09-03,12,Primaria 4°,TopKids,119,22,97
2025-09-03,12,Primaria 4°,TopKids,167,9,158
2025-09-03,12,Primaria 4°,EduMax,166,21,145
2025-09-03,12,Primaria 5°,SuperSchool,180,22,158
2025-09-03,12,Primaria 5°,EduMax,274,18,256
2025-09-03,12,Primaria 5°,EduMax,296,17,279
2025-09-03,12,Primaria 5°,EduMax,166,1,165
2025-09-03,12,Primaria 5°,EduMax,144,23,121
2025-09-03,12,Primaria 5°,SuperSchool,221,19,202
2025-09-03,12,Primaria 5°,EduMax,111,19,92
2025-09-03,12,Primaria 5°,TopKids,290,16,274
2025-09-03,12,Primaria 5°,TopKids,278,22,256
2025-09-03,12,Primaria 5°,TopKids,117,5,112
2025-09-03,12,Primaria 5°,SuperSchool,202,24,178
2025-09-03,12,Primaria 5°,SuperSchool,163,15,148
2025-09-03,12,Primaria 6°,TopKids,136,14,122
2025-09-03,12,Primaria 6°,TopKids,119,18,101
2025-09-03,12,Primaria 6°,SuperSchool,135,8,127
2025-09-03,12,Primaria 6°,SuperSchool,279,10,269
2025-09-03,12,Primaria 6°,TopKids,190,7,183
2025-09-03,12,Primaria 6°,EduMax,181,13,168
2025-09-03,12,Primaria 6°,EduMax,65,22,43
2025-09-03,12,Primaria 6°,TopKids,70,1,69
2025-09-03,12,Primaria 6°,EduMax,73,13,60
2025-09-03,13,Preescolar,EduMax,147,20,127
2025-09-03,13,Preescolar,SuperSchool,173,19,154
2025-09-03,13,Preescolar,EduMax,220,17,203
2025-09-03,13,Preescolar,SuperSchool,177,5,172
2025-09-03,13,Preescolar,SuperSchool,65,4,61
2025-09-03,13,Preescolar,SuperSchool,272,13,259
2025-09-03,13,Preescolar,SuperSchool,90,13,77
2025-09-03,13,Preescolar,EduMax,59,20,39
2025-09-03,13,Preescolar,TopKids,293,1,292
2025-09-03,13,Preescolar,TopKids,176,13,163
2025-09-03,13,Preescolar,SuperSchool,99,5,94
2025-09-03,13,Preescolar,EduMax,128,23,105
2025-09-03,13,Preescolar,EduMax,117,14,103
2025-09-03,13,Preescolar,SuperSchool,131,20,111
2025-09-03,13,Preescolar,SuperSchool,273,8,265
2025-09-03,13,Preescolar,TopKids,159,17,142
2025-09-03,13,Preescolar,SuperSchool,281,14,267
2025-09-03,13,Preescolar,TopKids,58,8,50
2025-09-03,13,Kínder,TopKids,107,1,106
2025-09-03,13,Kínder,SuperSchool,74,14,60
2025-09-03,13,Kínder,SuperSchool,295,16,279
2025-09-03,13,Kínder,TopKids,173,16,157
2025-09-03,13,Kínder,TopKids,148,23,125
2025-09-03,13,Kínder,SuperSchool,230,14,216
2025-09-03,13,Kínder,TopKids,173,24,149
2025-09-03,13,Kínder,TopKids,263,14,249
2025-09-03,13,Kínder,EduMax,275,4,271
2025-09-03,13,Kínder,TopKids,134,5,129
2025-09-03,13,Kínder,TopKids,155,21,134
2025-09-03,13,Kínder,SuperSchool,51,21,30
2025-09-03,13,Kínder,TopKids,96,19,77
2025-09-03,13,Kínder,SuperSchool,234,2,232
2025-09-03,13,Kínder,SuperSchool,84,12,72
2025-09-03,13,Kínder,TopKids,269,14,255
2025-09-03,13,Kínder,SuperSchool,129,17,112
2025-09-03,13,Kínder,SuperSchool,180,22,158
2025-09-03,13,Primaria 1°,EduMax,180,6,174
2025-09-03,13,Primaria 1°,TopKids,70,19,51
2025-09-03,13,Primaria 1°,SuperSchool,246,1,245
2025-09-03,13,Primaria 1°,TopKids,234,19,215
2025-09-03,13,Primaria 1°,EduMax,180,7,173
2025-09-03,13,Primaria 1°,TopKids,237,10,227
2025-09-03,13,Primaria 1°,EduMax,287,13,274
2025-09-03,13,Primaria 1°,TopKids,204,21,183
2025-09-03,13,Primaria 1°,SuperSchool,152,1,151
2025-09-03,13,Primaria 1°,SuperSchool,87,1,86
2025-09-03,13,Primaria 1°,TopKids,81,13,68
2025-09-03,13,Primaria 1°,SuperSchool,117,17,100
2025-09-03,13,Primaria 1°,EduMax,117,20,97
2025-09-03,13,Primaria 1°,TopKids,61,13,48
2025-09-03,13,Primaria 1°,TopKids,184,1,183
2025-09-03,13,Primaria 1°,EduMax,82,14,68
2025-09-03,13,Primaria 1°,SuperSchool,204,15,189
2025-09-03,13,Primaria 1°,EduMax,134,2,132
2025-09-03,13,Primaria 1°,TopKids,129,19,110
2025-09-03,13,Primaria 2°,EduMax,295,22,273
2025-09-03,13,Primaria 2°,EduMax,179,9,170
2025-09-03,13,Primaria 2°,EduMax,67,16,51
2025-09-03,13,Primaria 2°,TopKids,288,16,272
2025-09-03,13,Primaria 2°,EduMax,76,15,61
2025-09-03,13,Primaria 2°,TopKids,221,22,199
2025-09-03,13,Primaria 2°,EduMax,198,15,183
2025-09-03,13,Primaria 2°,TopKids,172,4,168
2025-09-03,13,Primaria 3°,EduMax,107,19,88
2025-09-03,13,Primaria 3°,TopKids,241,14,227
2025-09-03,13,Primaria 3°,EduMax,98,22,76
2025-09-03,13,Primaria 3°,SuperSchool,236,11,225
2025-09-03,13,Primaria 3°,EduMax,179,11,168
2025-09-03,13,Primaria 3°,TopKids,298,16,282
2025-09-03,13,Primaria 3°,EduMax,71,17,54
2025-09-03,13,Primaria 3°,TopKids,112,3,109
2025-09-03,13,Primaria 3°,SuperSchool,94,17,77
2025-09-03,13,Primaria 3°,EduMax,165,21,144
2025-09-03,13,Primaria 3°,EduMax,139,23,116
2025-09-03,13,Primaria 3°,TopKids,142,21,121
2025-09-03,13,Primaria 3°,EduMax,240,24,216
2025-09-03,13,Primaria 3°,TopKids,111,10,101
2025-09-03,13,Primaria 3°,TopKids,99,20,79
2025-09-03,13,Primaria 3°,EduMax,125,8,117
2025-09-03,13,Primaria 3°,SuperSchool,184,5,179
2025-09-03,13,Primaria 3°,SuperSchool,160,9,151
2025-09-03,13,Primaria 3°,EduMax,259,11,248
2025-09-03,13,Primaria 4°,EduMax,291,1,290
2025-09-03,13,Primaria 4°,EduMax,220,2,218
2025-09-03,13,Primaria 4°,EduMax,252,2,250
2025-09-03,13,Primaria 4°,TopKids,154,1,153
2025-09-03,13,Primaria 4°,EduMax,296,6,290
2025-09-03,13,Primaria 4°,EduMax,243,15,228
2025-09-03,13,Primaria 4°,SuperSchool,299,24,275
2025-09-03,13,Primaria 4°,EduMax,213,13,200
2025-09-03,13,Primaria 4°,TopKids,211,9,202
2025-09-03,13,Primaria 4°,EduMax,133,4,129
2025-09-03,13,Primaria 4°,TopKids,112,4,108
2025-09-03,13,Primaria 4°,SuperSchool,187,12,175
2025-09-03,13,Primaria 4°,TopKids,108,1,107
2025-09-03,13,Primaria 4°,EduMax,165,14,151
2025-09-03,13,Primaria 5°,EduMax,247,10,237
2025-09-03,13,Primaria 5°,TopKids,145,10,135
2025-09-03,13,Primaria 5°,SuperSchool,79,3,76
2025-09-03,13,Primaria 5°,SuperSchool,99,15,84
2025-09-03,13,Primaria 5°,EduMax,187,22,165
2025-09-03,13,Primaria 6°,EduMax,228,17,211
2025-09-03,13,Primaria 6°,EduMax,298,4,294
2025-09-03,13,Primaria 6°,SuperSchool,86,7,79
2025-09-03,13,Primaria 6°,TopKids,112,19,93
2025-09-03,13,Primaria 6°,SuperSchool,297,8,289
2025-09-03,13,Primaria 6°,TopKids,130,9,121
2025-09-03,13,Primaria 6°,TopKids,161,9,152
2025-09-03,13,Primaria 6°,TopKids,193,21,172
2025-09-03,13,Primaria 6°,EduMax,108,13,95
2025-09-03,13,Primaria 6°,TopKids,214,2,212
2025-09-03,13,Primaria 6°,EduMax,148,21,127
2025-09-03,13,Primaria 6°,SuperSchool,196,22,174
2025-09-03,13,Primaria 6°,TopKids,176,13,163
2025-09-03,13,Primaria 6°,SuperSchool,176,11,165
2025-09-03,13,Primaria 6°,TopKids,108,14,94
2025-09-03,13,Primaria 6°,SuperSchool,170,9,161
2025-09-03,13,Primaria 6°,SuperSchool,115,3,112
2025-09-03,13,Primaria 6°,SuperSchool,253,17,236
2025-09-03,13,Primaria 6°,TopKids,175,14,161
2025-09-03,14,Preescolar,SuperSchool,185,1,184
2025-09-03,14,Preescolar,EduMax,222,3,219
2025-09-03,14,Preescolar,EduMax,127,19,108
2025-09-03,14,Preescolar,TopKids,119,4,115
2025-09-03,14,Preescolar,SuperSchool,237,10,227
2025-09-03,14,Preescolar,SuperSchool,189,11,178
2025-09-03,14,Preescolar,SuperSchool,224,21,203
2025-09-03,14,Preescolar,SuperSchool,116,10,106
2025-09-03,14,Preescolar,SuperSchool,95,19,76
2025-09-03,14,Kínder,SuperSchool,287,6,281
2025-09-03,14,Kínder,TopKids,299,2,297
2025-09-03,14,Kínder,SuperSchool,178,17,161
2025-09-03,14,Kínder,SuperSchool,54,16,38
2025-09-03,14,Kínder,EduMax,101,10,91
2025-09-03,14,Kínder,SuperSchool,202,3,199
2025-09-03,14,Kínder,TopKids,259,24,235
2025-09-03,14,Kínder,TopKids,227,4,223
2025-09-03,14,Kínder,TopKids,82,16,66
2025-09-03,14,Primaria 1°,EduMax,83,10,73
2025-09-03,14,Primaria 1°,TopKids,162,19,143
2025-09-03,14,Primaria 1°,SuperSchool,134,19,115
2025-09-03,14,Primaria 1°,TopKids,257,13,244
2025-09-03,14,Primaria 1°,EduMax,81,5,76
2025-09-03,14,Primaria 2°,TopKids,236,9,227
2025-09-03,14,Primaria 2°,SuperSchool,117,10,107
2025-09-03,14,Primaria 2°,TopKids,142,9,133
2025-09-03,14,Primaria 2°,SuperSchool,298,11,287
2025-09-03,14,Primaria 2°,EduMax,186,17,169
2025-09-03,14,Primaria 2°,EduMax,252,21,231
2025-09-03,14,Primaria 2°,EduMax,75,16,59
2025-09-03,14,Primaria 2°,TopKids,63,3,60
2025-09-03,14,Primaria 2°,EduMax,102,23,79
2025-09-03,14,Primaria 2°,EduMax,230,2,228
2025-09-03,14,Primaria 2°,SuperSchool,60,12,48
2025-09-03,14,Primaria 2°,SuperSchool,135,21,114
2025-09-03,14,Primaria 2°,SuperSchool,285,7,278
2025-09-03,14,Primaria 2°,SuperSchool,238,10,228
2025-09-03,14,Primaria 2°,EduMax,172,7,165
2025-09-03,14,Primaria 2°,TopKids,159,11,148
2025-09-03,14,Primaria 3°,SuperSchool,209,10,199
2025-09-03,14,Primaria 3°,SuperSchool,136,11,125
2025-09-03,14,Primaria 3°,SuperSchool,261,10,251
2025-09-03,14,Primaria 3°,SuperSchool,68,23,45
2025-09-03,14,Primaria 3°,SuperSchool,234,11,223
2025-09-03,14,Primaria 3°,TopKids,108,16,92
2025-09-03,14,Primaria 4°,EduMax,51,19,32
2025-09-03,14,Primaria 4°,EduMax,92,17,75
2025-09-03,14,Primaria 4°,TopKids,128,22,106
2025-09-03,14,Primaria 4°,SuperSchool,281,24,257
2025-09-03,14,Primaria 4°,SuperSchool,78,18,60
2025-09-03,14,Primaria 4°,EduMax,107,2,105
2025-09-03,14,Primaria 4°,EduMax,288,21,267
2025-09-03,14,Primaria 4°,EduMax,58,12,46
2025-09-03,14,Primaria 4°,EduMax,88,5,83
2025-09-03,14,Primaria 4°,EduMax,296,8,288
2025-09-03,14,Primaria 5°,SuperSchool,251,11,240
2025-09-03,14,Primaria 5°,TopKids,264,20,244
2025-09-03,14,Primaria 5°,SuperSchool,254,18,236
2025-09-03,14,Primaria 5°,EduMax,294,17,277
2025-09-03,14,Primaria 5°,TopKids,213,9,204
2025-09-03,14,Primaria 5°,EduMax,65,7,58
2025-09-03,14,Primaria 5°,SuperSchool,93,4,89
2025-09-03,14,Primaria 5°,SuperSchool,141,12,129
2025-09-03,14,Primaria 5°,EduMax,117,12,105
2025-09-03,14,Primaria 5°,TopKids,153,24,129
2025-09-03,14,Primaria 5°,TopKids,175,3,172
2025-09-03,14,Primaria 5°,EduMax,151,17,134
2025-09-03,14,Primaria 5°,SuperSchool,97,7,90
2025-09-03,14,Primaria 5°,TopKids,294,5,289
2025-09-03,14,Primaria 5°,TopKids,120,18,102
2025-09-03,14,Primaria 6°,TopKids,70,2,68
2025-09-03,14,Primaria 6°,TopKids,226,8,218
2025-09-03,14,Primaria 6°,EduMax,67,19,48
2025-09-03,14,Primaria 6°,SuperSchool,189,22,167
2025-09-03,14,Primaria 6°,TopKids,240,8,232
2025-09-03,14,Primaria 6°,EduMax,185,10,175
2025-09-03,15,Preescolar,EduMax,96,24,72
2025-09-03,15,Preescolar,TopKids,198,14,184
2025-09-03,15,Preescolar,TopKids,63,12,51
2025-09-03,15,Preescolar,TopKids,285,7,278
2025-09-03,15,Preescolar,TopKids,295,19,276
2025-09-03,15,Preescolar,EduMax,114,7,107
2025-09-03,15,Preescolar,SuperSchool,80,22,58
2025-09-03,15,Preescolar,EduMax,259,13,246
2025-09-03,15,Preescolar,SuperSchool,171,15,156
2025-09-03,15,Preescolar,SuperSchool,146,3,143
2025-09-03,15,Preescolar,TopKids,79,9,70
2025-09-03,15,Preescolar,TopKids,96,14,82
2025-09-03,15,Preescolar,EduMax,50,3,47
2025-09-03,15,Preescolar,EduMax,202,1,201
2025-09-03,15,Preescolar,TopKids,195,1,194
2025-09-03,15,Preescolar,SuperSchool,184,13,171
2025-09-03,15,Kínder,SuperSchool,62,10,52
2025-09-03,15,Kínder,EduMax,150,10,140
2025-09-03,15,Kínder,EduMax,240,11,229
2025-09-03,15,Kínder,SuperSchool,85,3,82
2025-09-03,15,Kínder,EduMax,222,24,198
2025-09-03,15,Primaria 1°,SuperSchool,221,23,198
2025-09-03,15,Primaria 1°,EduMax,147,7,140
2025-09-03,15,Primaria 1°,TopKids,53,12,41
2025-09-03,15,Primaria 1°,TopKids,293,13,280
2025-09-03,15,Primaria 1°,EduMax,79,3,76
2025-09-03,15,Primaria 1°,EduMax,59,6,53
2025-09-03,15,Primaria 1°,TopKids,120,16,104
2025-09-03,15,Primaria 1°,EduMax,257,24,233
2025-09-03,15,Primaria 1°,EduMax,256,22,234
2025-09-03,15,Primaria 1°,TopKids,173,16,157
2025-09-03,15,Primaria 1°,EduMax,256,23,233
2025-09-03,15,Primaria 2°,SuperSchool,179,2,177
2025-09-03,15,Primaria 2°,SuperSchool,196,5,191
2025-09-03,15,Primaria 2°,EduMax,153,9,144
2025-09-03,15,Primaria 2°,TopKids,299,18,281
2025-09-03,15,Primaria 2°,TopKids,176,22,154
2025-09-03,15,Primaria 2°,TopKids,225,16,209
2025-09-03,15,Primaria 2°,SuperSchool,218,13,205
2025-09-03,15,Primaria 2°,SuperSchool,133,8,125
2025-09-03,15,Primaria 2°,TopKids,166,9,157
2025-09-03,15,Primaria 2°,EduMax,80,20,60
2025-09-03,15,Primaria 3°,TopKids,207,18,189
2025-09-03,15,Primaria 3°,TopKids,218,24,194
2025-09-03,15,Primaria 3°,EduMax,135,16,119
2025-09-03,15,Primaria 3°,EduMax,196,22,174
2025-09-03,15,Primaria 3°,EduMax,192,21,171
2025-09-03,15,Primaria 3°,EduMax,149,12,137
2025-09-03,15,Primaria 3°,TopKids,252,7,245
2025-09-03,15,Primaria 4°,TopKids,117,2,115
2025-09-03,15,Primaria 4°,TopKids,133,12,121
2025-09-03,15,Primaria 4°,SuperSchool,66,18,48
2025-09-03,15,Primaria 4°,SuperSchool,297,9,288
2025-09-03,15,Primaria 4°,EduMax,133,20,113
2025-09-03,15,Primaria 4°,TopKids,86,10,76
2025-09-03,15,Primaria 4°,SuperSchool,201,4,197
2025-09-03,15,Primaria 4°,EduMax,269,12,257
2025-09-03,15,Primaria 5°,TopKids,67,5,62
2025-09-03,15,Primaria 5°,EduMax,75,14,61
2025-09-03,15,Primaria 5°,TopKids,120,11,109
2025-09-03,15,Primaria 5°,TopKids,134,11,123
2025-09-03,15,Primaria 5°,TopKids,294,23,271
2025-09-03,15,Primaria 5°,EduMax,277,24,253
2025-09-03,15,Primaria 5°,SuperSchool,107,21,86
2025-09-03,15,Primaria 5°,EduMax,83,4,79
2025-09-03,15,Primaria 6°,EduMax,209,2,207
2025-09-03,15,Primaria 6°,EduMax,271,24,247
2025-09-03,15,Primaria 6°,EduMax,180,21,159
2025-09-03,15,Primaria 6°,EduMax,295,10,285
2025-09-03,15,Primaria 6°,EduMax,147,20,127
2025-09-03,15,Primaria 6°,TopKids,99,14,85
2025-09-03,15,Primaria 6°,EduMax,229,13,216
2025-09-03,15,Primaria 6°,SuperSchool,108,7,101
2025-09-03,15,Primaria 6°,SuperSchool,235,20,215
2025-09-03,16,Preescolar,EduMax,203,19,184
2025-09-03,16,Preescolar,SuperSchool,110,13,97
2025-09-03,16,Preescolar,EduMax,211,20,191
2025-09-03,16,Preescolar,EduMax,170,2,168
2025-09-03,16,Preescolar,TopKids,273,13,260
2025-09-03,16,Preescolar,EduMax,279,1,278
2025-09-03,16,Preescolar,EduMax,152,13,139
2025-09-03,16,Preescolar,TopKids,53,9,44
2025-09-03,16,Preescolar,TopKids,261,3,258
2025-09-03,16,Preescolar,TopKids,115,16,99
2025-09-03,16,Preescolar,EduMax,77,12,65
2025-09-03,16,Preescolar,EduMax,51,14,37
2025-09-03,16,Preescolar,TopKids,167,7,160
2025-09-03,16,Preescolar,SuperSchool,96,14,82
2025-09-03,16,Preescolar,SuperSchool,185,18,167
2025-09-03,16,Preescolar,SuperSchool,72,9,63
2025-09-03,16,Preescolar,EduMax,162,3,159
2025-09-03,16,Preescolar,SuperSchool,120,15,105
2025-09-03,16,Preescolar,TopKids,185,11,174
2025-09-03,16,Kínder,TopKids,165,2,163
2025-09-03,16,Kínder,TopKids,261,17,244
2025-09-03,16,Kínder,SuperSchool,283,5,278
2025-09-03,16,Kínder,TopKids,58,20,38
2025-09-03,16,Kínder,EduMax,138,2,136
2025-09-03,16,Kínder,TopKids,228,17,211
2025-09-03,16,Primaria 1°,SuperSchool,253,20,233
2025-09-03,16,Primaria 1°,SuperSchool,264,4,260
2025-09-03,16,Primaria 1°,EduMax,289,21,268
2025-09-03,16,Primaria 1°,EduMax,107,22,85
2025-09-03,16,Primaria 1°,EduMax,109,11,98
2025-09-03,16,Primaria 1°,SuperSchool,261,11,250
2025-09-03,16,Primaria 1°,TopKids,279,13,266
2025-09-03,16,Primaria 1°,TopKids,148,18,130
2025-09-03,16,Primaria 1°,SuperSchool,138,17,121
2025-09-03,16,Primaria 1°,TopKids,165,6,159
2025-09-03,16,Primaria 1°,SuperSchool,213,7,206
2025-09-03,16,Primaria 1°,TopKids,270,22,248
2025-09-03,16,Primaria 1°,SuperSchool,188,23,165
2025-09-03,16,Primaria 2°,EduMax,56,12,44
2025-09-03,16,Primaria 2°,TopKids,110,22,88
2025-09-03,16,Primaria 2°,TopKids,135,16,119
2025-09-03,16,Primaria 2°,EduMax,283,1,282
2025-09-03,16,Primaria 2°,TopKids,207,16,191
2025-09-03,16,Primaria 2°,TopKids,51,12,39
2025-09-03,16,Primaria 2°,TopKids,240,24,216
2025-09-03,16,Primaria 3°,SuperSchool,288,17,271
2025-09-03,16,Primaria 3°,EduMax,144,18,126
2025-09-03,16,Primaria 3°,SuperSchool,235,5,230
2025-09-03,16,Primaria 3°,TopKids,142,4,138
2025-09-03,16,Primaria 3°,EduMax,187,4,183
2025-09-03,16,Primaria 3°,TopKids,276,16,260
2025-09-03,16,Primaria 4°,TopKids,154,1,153
2025-09-03,16,Primaria 4°,EduMax,189,24,165
2025-09-03,16,Primaria 4°,EduMax,224,24,200
2025-09-03,16,Primaria 4°,EduMax,254,18,236
2025-09-03,16,Primaria 4°,SuperSchool,231,19,212
2025-09-03,16,Primaria 4°,TopKids,63,3,60
2025-09-03,16,Primaria 4°,SuperSchool,177,5,172
2025-09-03,16,Primaria 4°,EduMax,152,12,140
2025-09-03,16,Primaria 4°,SuperSchool,259,11,248
2025-09-03,16,Primaria 5°,SuperSchool,220,18,202
2025-09-03,16,Primaria 5°,EduMax,69,13,56
2025-09-03,16,Primaria 5°,TopKids,57,5,52
2025-09-03,16,Primaria 5°,SuperSchool,120,12,108
2025-09-03,16,Primaria 5°,SuperSchool,53,8,45
2025-09-03,16,Primaria 5°,TopKids,231,1,230
2025-09-03,16,Primaria 5°,TopKids,284,23,261
2025-09-03,16,Primaria 5°,SuperSchool,99,21,78
2025-09-03,16,Primaria 5°,EduMax,158,12,146
2025-09-03,16,Primaria 5°,SuperSchool,147,3,144
2025-09-03,16,Primaria 5°,SuperSchool,130,21,109
2025-09-03,16,Primaria 5°,TopKids,125,16,109
2025-09-03,16,Primaria 5°,TopKids,133,22,111
2025-09-03,16,Primaria 5°,EduMax,136,23,113
2025-09-03,16,Primaria 5°,TopKids,271,8,263
2025-09-03,16,Primaria 6°,SuperSchool,125,10,115
2025-09-03,16,Primaria 6°,EduMax,127,22,105
2025-09-03,16,Primaria 6°,SuperSchool,102,21,81
2025-09-03,16,Primaria 6°,SuperSchool,242,22,220
2025-09-03,16,Primaria 6°,EduMax,235,5,230
2025-09-03,16,Primaria 6°,TopKids,219,6,213
2025-09-03,16,Primaria 6°,TopKids,282,8,274
2025-09-04,9,Preescolar,TopKids,279,6,273
2025-09-04,9,Preescolar,SuperSchool,177,12,165
2025-09-04,9,Preescolar,TopKids,86,16,70
2025-09-04,9,Preescolar,TopKids,87,8,79
2025-09-04,9,Preescolar,TopKids,217,7,210
2025-09-04,9,Preescolar,SuperSchool,292,20,272
2025-09-04,9,Preescolar,EduMax,202,6,196
2025-09-04,9,Preescolar,TopKids,88,5,83
2025-09-04,9,Preescolar,TopKids,70,7,63
2025-09-04,9,Preescolar,SuperSchool,61,15,46
2025-09-04,9,Preescolar,TopKids,141,24,117
2025-09-04,9,Kínder,TopKids,293,15,278
2025-09-04,9,Kínder,SuperSchool,61,4,57
2025-09-04,9,Kínder,TopKids,144,1,143
2025-09-04,9,Kínder,SuperSchool,214,12,202
2025-09-04,9,Kínder,EduMax,215,5,210
2025-09-04,9,Kínder,TopKids,163,24,139
2025-09-04,9,Kínder,SuperSchool,67,16,51
2025-09-04,9,Kínder,SuperSchool,115,17,98
2025-09-04,9,Kínder,EduMax,107,3,104
2025-09-04,9,Primaria 1°,TopKids,253,1,252
2025-09-04,9,Primaria 1°,TopKids,299,7,292
2025-09-04,9,Primaria 1°,SuperSchool,58,5,53
2025-09-04,9,Primaria 1°,SuperSchool,105,24,81
2025-09-04,9,Primaria 1°,SuperSchool,181,20,161
2025-09-04,9,Primaria 1°,TopKids,64,24,40
2025-09-04,9,Primaria 1°,EduMax,131,20,111
2025-09-04,9,Primaria 1°,SuperSchool,242,11,231
2025-09-04,9,Primaria 1°,SuperSchool,238,24,214
2025-09-04,9,Primaria 1°,EduMax,240,6,234
2025-09-04,9,Primaria 1°,SuperSchool,94,10,84
2025-09-04,9,Primaria 1°,EduMax,117,4,113
2025-09-04,9,Primaria 1°,TopKids,97,1,96
2025-09-04,9,Primaria 1°,SuperSchool,139,19,120
2025-09-04,9,Primaria 1°,TopKids,282,21,261
2025-09-04,9,Primaria 1°,EduMax,210,1,209
2025-09-04,9,Primaria 1°,SuperSchool,262,9,253
2025-09-04,9,Primaria 1°,SuperSchool,100,16,84
2025-09-04,9,Primaria 2°,SuperSchool,152,15,137
2025-09-04,9,Primaria 2°,TopKids,64,5,59
2025-09-04,9,Primaria 2°,EduMax,266,23,243
2025-09-04,9,Primaria 2°,EduMax,125,19,106
2025-09-04,9,Primaria 2°,TopKids,81,23,58
2025-09-04,9,Primaria 2°,SuperSchool,104,3,101
2025-09-04,9,Primaria 2°,SuperSchool,279,13,266
2025-09-04,9,Primaria 3°,TopKids,213,20,193
2025-09-04,9,Primaria 3°,TopKids,263,18,245
2025-09-04,9,Primaria 3°,SuperSchool,134,22,112
2025-09-04,9,Primaria 3°,TopKids,125,11,114
2025-09-04,9,Primaria 3°,EduMax,79,15,64
2025-09-04,9,Primaria 3°,TopKids,230,18,212
2025-09-04,9,Primaria 3°,EduMax,185,6,179
2025-09-04,9,Primaria 3°,TopKids,69,12,57
2025-09-04,9,Primaria 4°,TopKids,261,18,243
2025-09-04,9,Primaria 4°,EduMax,189,22,167
2025-09-04,9,Primaria 4°,EduMax,123,19,104
2025-09-04,9,Primaria 4°,SuperSchool,191,20,171
2025-09-04,9,Primaria 4°,EduMax,199,4,195
2025-09-04,9,Primaria 5°,TopKids,211,18,193
2025-09-04,9,Primaria 5°,EduMax,131,8,123
2025-09-04,9,Primaria 5°,TopKids,283,20,263
2025-09-04,9,Primaria 5°,EduMax,251,3,248
2025-09-04,9,Primaria 5°,SuperSchool,277,23,254
2025-09-04,9,Primaria 5°,EduMax,120,22,98
2025-09-04,9,Primaria 5°,TopKids,125,7,118
2025-09-04,9,Primaria 5°,SuperSchool,217,13,204
2025-09-04,9,Primaria 5°,SuperSchool,144,16,128
2025-09-04,9,Primaria 5°,TopKids,241,19,222
2025-09-04,9,Primaria 5°,SuperSchool,145,13,132
2025-09-04,9,Primaria 5°,SuperSchool,248,15,233
2025-09-04,9,Primaria 5°,EduMax,247,4,243
2025-09-04,9,Primaria 5°,EduMax,200,20,180
2025-09-04,9,Primaria 5°,TopKids,233,21,212
2025-09-04,9,Primaria 5°,TopKids,147,17,130
2025-09-04,9,Primaria 5°,TopKids,293,18,275
2025-09-04,9,Primaria 5°,TopKids,226,14,212
2025-09-04,9,Primaria 5°,SuperSchool,247,4,243
2025-09-04,9,Primaria 6°,TopKids,145,8,137
2025-09-04,9,Primaria 6°,TopKids,133,22,111
2025-09-04,9,Primaria 6°,TopKids,185,13,172
2025-09-04,9,Primaria 6°,TopKids,80,15,65
2025-09-04,9,Primaria 6°,TopKids,152,3,149
2025-09-04,9,Primaria 6°,TopKids,171,10,161
2025-09-04,9,Primaria 6°,TopKids,225,14,211
2025-09-04,9,Primaria 6°,TopKids,272,19,253
2025-09-04,9,Primaria 6°,EduMax,246,11,235
2025-09-04,10,Preescolar,SuperSchool,285,18,267
2025-09-04,10,Preescolar,SuperSchool,152,9,143
2025-09-04,10,Preescolar,TopKids,127,24,103
2025-09-04,10,Preescolar,EduMax,299,19,280
2025-09-04,10,Preescolar,EduMax,106,15,91
2025-09-04,10,Preescolar,SuperSchool,230,4,226
2025-09-04,10,Preescolar,SuperSchool,246,12,234
2025-09-04,10,Preescolar,EduMax,162,10,152
2025-09-04,10,Preescolar,EduMax,267,12,255
2025-09-04,10,Preescolar,EduMax,204,20,184
2025-09-04,10,Preescolar,SuperSchool,134,17,117
2025-09-04,10,Kínder,EduMax,292,5,287
2025-09-04,10,Kínder,EduMax,278,8,270
2025-09-04,10,Kínder,EduMax,66,3,63
2025-09-04,10,Kínder,SuperSchool,65,19,46
2025-09-04,10,Kínder,EduMax,91,16,75
2025-09-04,10,Kínder,SuperSchool,52,22,30
2025-09-04,10,Kínder,TopKids,108,11,97
2025-09-04,10,Kínder,SuperSchool,101,3,98
2025-09-04,10,Primaria 1°,SuperSchool,273,7,266
2025-09-04,10,Primaria 1°,TopKids,258,18,240
2025-09-04,10,Primaria 1°,SuperSchool,58,13,45
2025-09-04,10,Primaria 1°,SuperSchool,111,15,96
2025-09-04,10,Primaria 1°,TopKids,192,7,185
2025-09-04,10,Primaria 1°,TopKids,297,8,289
2025-09-04,10,Primaria 1°,SuperSchool,193,3,190
2025-09-04,10,Primaria 1°,SuperSchool,144,23,121
2025-09-04,10,Primaria 1°,SuperSchool,84,16,68
2025-09-04,10,Primaria 2°,EduMax,63,7,56
2025-09-04,10,Primaria 2°,TopKids,148,22,126
2025-09-04,10,Primaria 2°,SuperSchool,55,18,37
2025-09-04,10,Primaria 2°,SuperSchool,138,13,125
2025-09-04,10,Primaria 2°,EduMax,285,4,281
2025-09-04,10,Primaria 3°,TopKids,86,10,76
2025-09-04,10,Primaria 3°,EduMax,274,20,254
2025-09-04,10,Primaria 3°,SuperSchool,119,22,97
2025-09-04,10,Primaria 3°,SuperSchool,260,11,249
2025-09-04,10,Primaria 3°,TopKids,147,15,132
2025-09-04,10,Primaria 3°,TopKids,258,12,246
2025-09-04,10,Primaria 3°,SuperSchool,101,7,94
2025-09-04,10,Primaria 3°,EduMax,268,13,255
2025-09-04,10,Primaria 3°,SuperSchool,238,15,223
2025-09-04,10,Primaria 3°,EduMax,288,1,287
2025-09-04,10,Primaria 3°,SuperSchool,165,21,144
2025-09-04,10,Primaria 3°,SuperSchool,176,3,173
2025-09-04,10,Primaria 3°,EduMax,178,19,159
2025-09-04,10,Primaria 4°,SuperSchool,96,13,83
2025-09-04,10,Primaria 4°,EduMax,162,1,161
2025-09-04,10,Primaria 4°,TopKids,73,4,69
2025-09-04,10,Primaria 4°,EduMax,139,19,120
2025-09-04,10,Primaria 4°,EduMax,193,8,185
2025-09-04,10,Primaria 4°,EduMax,65,5,60
2025-09-04,10,Primaria 4°,TopKids,183,10,173
2025-09-04,10,Primaria 4°,EduMax,278,21,257
2025-09-04,10,Primaria 5°,TopKids,286,15,271
2025-09-04,10,Primaria 5°,TopKids,176,1,175
2025-09-04,10,Primaria 5°,SuperSchool,199,22,177
2025-09-04,10,Primaria 5°,EduMax,107,13,94
2025-09-04,10,Primaria 5°,TopKids,76,7,69
2025-09-04,10,Primaria 5°,EduMax,170,8,162
2025-09-04,10,Primaria 5°,EduMax,168,15,153
2025-09-04,10,Primaria 6°,SuperSchool,123,15,108
2025-09-04,10,Primaria 6°,SuperSchool,68,13,55
2025-09-04,10,Primaria 6°,SuperSchool,80,21,59
2025-09-04,10,Primaria 6°,TopKids,127,23,104
2025-09-04,10,Primaria 6°,SuperSchool,195,4,191
2025-09-04,10,Primaria 6°,SuperSchool,124,5,119
2025-09-04,10,Primaria 6°,TopKids,134,7,127
2025-09-04,10,Primaria 6°,EduMax,268,6,262
2025-09-04,10,Primaria 6°,EduMax,231,4,227
2025-09-04,10,Primaria 6°,EduMax,112,3,109
2025-09-04,10,Primaria 6°,EduMax,295,6,289
2025-09-04,10,Primaria 6°,EduMax,79,10,69
2025-09-04,10,Primaria 6°,SuperSchool,65,20,45
2025-09-04,10,Primaria 6°,EduMax,206,11,195
2025-09-04,10,Primaria 6°,TopKids,91,7,84
2025-09-04,10,Primaria 6°,TopKids,67,3,64
2025-09-04,11,Preescolar,EduMax,69,2,67
2025-09-04,11,Preescolar,EduMax,122,10,112
2025-09-04,11,Preescolar,TopKids,119,17,102
2025-09-04,11,Preescolar,TopKids,274,24,250
2025-09-04,11,Preescolar,TopKids,231,13,218
2025-09-04,11,Preescolar,EduMax,93,23,70
2025-09-04,11,Preescolar,EduMax,129,2,127
2025-09-04,11,Preescolar,TopKids,249,20,229
2025-09-04,11,Preescolar,SuperSchool,96,24,72
2025-09-04,11,Preescolar,TopKids,195,23,172
2025-09-04,11,Preescolar,SuperSchool,172,19,153
2025-09-04,11,Preescolar,EduMax,182,18,164
2025-09-04,11,Preescolar,EduMax,166,3,163
2025-09-04,11,Preescolar,SuperSchool,155,24,131
2025-09-04,11,Preescolar,SuperSchool,198,10,188
2025-09-04,11,Preescolar,TopKids,88,2,86
2025-09-04,11,Preescolar,TopKids,205,18,187
2025-09-04,11,Preescolar,EduMax,188,17,171
2025-09-04,11,Preescolar,TopKids,133,12,121
2025-09-04,11,Kínder,EduMax,298,1,297
2025-09-04,11,Kínder,SuperSchool,199,24,175
2025-09-04,11,Kínder,TopKids,281,9,272
2025-09-04,11,Kínder,TopKids,213,22,191
2025-09-04,11,Kínder,EduMax,291,2,289
2025-09-04,11,Kínder,TopKids,182,17,165
2025-09-04,11,Kínder,SuperSchool,235,3,232
2025-09-04,11,Kínder,TopKids,121,11,110
2025-09-04,11,Kínder,TopKids,244,1,243
2025-09-04,11,Kínder,EduMax,265,13,252
2025-09-04,11,Kínder,TopKids,207,10,197
2025-09-04,11,Kínder,EduMax,215,11,204
2025-09-04,11,Kínder,TopKids,156,6,150
2025-09-04,11,Primaria 1°,EduMax,116,13,103
2025-09-04,11,Primaria 1°,SuperSchool,97,12,85
2025-09-04,11,Primaria 1°,TopKids,285,8,277
2025-09-04,11,Primaria 1°,SuperSchool,160,2,158
2025-09-04,11,Primaria 1°,TopKids,252,24,228
2025-09-04,11,Primaria 1°,SuperSchool,278,23,255
2025-09-04,11,Primaria 1°,EduMax,132,14,118
2025-09-04,11,Primaria 1°,TopKids,177,12,165
2025-09-04,11,Primaria 1°,EduMax,226,4,222
2025-09-04,11,Primaria 1°,EduMax,295,10,285
2025-09-04,11,Primaria 1°,SuperSchool,206,23,183
2025-09-04,11,Primaria 1°,EduMax,277,13,264
2025-09-04,11,Primaria 1°,EduMax,235,15,220
2025-09-04,11,Primaria 1°,EduMax,234,3,231
2025-09-04,11,Primaria 1°,TopKids,279,2,277
2025-09-04,11,Primaria 1°,SuperSchool,207,13,194
2025-09-04,11,Primaria 1°,EduMax,221,21,200
2025-09-04,11,Primaria 1°,EduMax,245,23,222
2025-09-04,11,Primaria 1°,SuperSchool,184,12,172
2025-09-04,11,Primaria 2°,TopKids,88,10,78
2025-09-04,11,Primaria 2°,SuperSchool,147,5,142
2025-09-04,11,Primaria 2°,EduMax,266,14,252
2025-09-04,11,Primaria 2°,TopKids,65,2,63
2025-09-04,11,Primaria 2°,TopKids,200,9,191
2025-09-04,11,Primaria 2°,EduMax,224,19,205
2025-09-04,11,Primaria 2°,TopKids,267,8,259
2025-09-04,11,Primaria 2°,TopKids,160,8,152
2025-09-04,11,Primaria 2°,TopKids,110,6,104
2025-09-04,11,Primaria 2°,TopKids,177,12,165
2025-09-04,11,Primaria 2°,SuperSchool,195,17,178
2025-09-04,11,Primaria 3°,EduMax,52,13,39
2025-09-04,11,Primaria 3°,EduMax,269,14,255
2025-09-04,11,Primaria 3°,TopKids,178,4,174
2025-09-04,11,Primaria 3°,EduMax,291,11,280
2025-09-04,11,Primaria 3°,TopKids,217,4,213
2025-09-04,11,Primaria 3°,EduMax,242,24,218
2025-09-04,11,Primaria 3°,EduMax,130,7,123
2025-09-04,11,Primaria 3°,TopKids,241,13,228
2025-09-04,11,Primaria 3°,EduMax,105,1,104
2025-09-04,11,Primaria 4°,SuperSchool,190,1,189
2025-09-04,11,Primaria 4°,EduMax,296,10,286
2025-09-04,11,Primaria 4°,SuperSchool,210,5,205
2025-09-04,11,Primaria 4°,EduMax,234,2,232
2025-09-04,11,Primaria 4°,EduMax,180,23,157
2025-09-04,11,Primaria 4°,TopKids,240,18,222
2025-09-04,11,Primaria 4°,TopKids,249,9,240
2025-09-04,11,Primaria 4°,EduMax,238,2,236
2025-09-04,11,Primaria 4°,TopKids,225,7,218
2025-09-04,11,Primaria 4°,EduMax,112,4,108
2025-09-04,11,Primaria 4°,SuperSchool,178,22,156
2025-09-04,11,Primaria 4°,EduMax,158,24,134
2025-09-04,11,Primaria 4°,TopKids,256,1,255
2025-09-04,11,Primaria 4°,EduMax,72,14,58
2025-09-04,11,Primaria 4°,EduMax,138,22,116
2025-09-04,11,Primaria 4°,SuperSchool,56,24,32
2025-09-04,11,Primaria 5°,SuperSchool,119,21,98
2025-09-04,11,Primaria 5°,TopKids,195,15,180
2025-09-04,11,Primaria 5°,SuperSchool,244,13,231
2025-09-04,11,Primaria 5°,SuperSchool,165,15,150
2025-09-04,11,Primaria 5°,EduMax,203,16,187
2025-09-04,11,Primaria 5°,TopKids,181,19,162
2025-09-04,11,Primaria 5°,TopKids,147,6,141
2025-09-04,11,Primaria 5°,SuperSchool,128,10,118
2025-09-04,11,Primaria 5°,EduMax,155,4,151
2025-09-04,11,Primaria 5°,EduMax,153,6,147
2025-09-04,11,Primaria 5°,EduMax,256,19,237
2025-09-04,11,Primaria 5°,EduMax,52,18,34
2025-09-04,11,Primaria 5°,EduMax,159,14,145
2025-09-04,11,Primaria 5°,EduMax,280,7,273
2025-09-04,11,Primaria 5°,SuperSchool,167,23,144
2025-09-04,11,Primaria 5°,TopKids,163,10,153
2025-09-04,11,Primaria 5°,TopKids,79,12,67
2025-09-04,11,Primaria 6°,SuperSchool,295,24,271
2025-09-04,11,Primaria 6°,SuperSchool,66,1,65
2025-09-04,11,Primaria 6°,EduMax,70,15,55
2025-09-04,11,Primaria 6°,TopKids,255,10,245
2025-09-04,11,Primaria 6°,SuperSchool,283,23,260
2025-09-04,11,Primaria 6°,TopKids,88,14,74
2025-09-04,11,Primaria 6°,TopKids,135,20,115
2025-09-04,11,Primaria 6°,SuperSchool,269,15,254
2025-09-04,11,Primaria 6°,SuperSchool,136,7,129
2025-09-04,11,Primaria 6°,TopKids,86,9,77
2025-09-04,11,Primaria 6°,EduMax,248,23,225
2025-09-04,12,Preescolar,TopKids,287,19,268
2025-09-04,12,Preescolar,EduMax,295,11,284
2025-09-04,12,Preescolar,TopKids,247,4,243
2025-09-04,12,Preescolar,EduMax,71,3,68
2025-09-04,12,Preescolar,SuperSchool,224,1,223
2025-09-04,12,Preescolar,SuperSchool,252,13,239
2025-09-04,12,Preescolar,EduMax,105,3,102
2025-09-04,12,Preescolar,SuperSchool,99,24,75
2025-09-04,12,Preescolar,SuperSchool,234,2,232
2025-09-04,12,Preescolar,EduMax,145,23,122
2025-09-04,12,Preescolar,SuperSchool,201,3,198
2025-09-04,12,Preescolar,SuperSchool,130,7,123
2025-09-04,12,Preescolar,EduMax,132,24,108
2025-09-04,12,Kínder,EduMax,64,17,47
2025-09-04,12,Kínder,EduMax,135,17,118
2025-09-04,12,Kínder,TopKids,58,6,52
2025-09-04,12,Kínder,TopKids,185,6,179
2025-09-04,12,Kínder,SuperSchool,151,13,138
2025-09-04,12,Kínder,SuperSchool,297,2,295
2025-09-04,12,Kínder,TopKids,145,6,139
2025-09-04,12,Kínder,SuperSchool,81,8,73
2025-09-04,12,Kínder,EduMax,270,19,251
2025-09-04,12,Kínder,SuperSchool,232,9,223
2025-09-04,12,Kínder,EduMax,225,18,207
2025-09-04,12,Kínder,TopKids,216,8,208
2025-09-04,12,Kínder,SuperSchool,272,19,253
2025-09-04,12,Primaria 1°,EduMax,222,1,221
2025-09-04,12,Primaria 1°,TopKids,243,21,222
2025-09-04,12,Primaria 1°,TopKids,126,7,119
2025-09-04,12,Primaria 1°,EduMax,275,3,272
2025-09-04,12,Primaria 1°,SuperSchool,125,1,124
2025-09-04,12,Primaria 2°,SuperSchool,132,10,122
2025-09-04,12,Primaria 2°,EduMax,163,15,148
2025-09-04,12,Primaria 2°,EduMax,169,16,153
2025-09-04,12,Primaria 2°,TopKids,134,8,126
2025-09-04,12,Primaria 2°,SuperSchool,178,20,158
2025-09-04,12,Primaria 2°,EduMax,231,13,218
2025-09-04,12,Primaria 3°,SuperSchool,192,15,177
2025-09-04,12,Primaria 3°,EduMax,118,17,101
2025-09-04,12,Primaria 3°,EduMax,218,20,198
2025-09-04,12,Primaria 3°,EduMax,299,19,280
2025-09-04,12,Primaria 3°,TopKids,232,21,211
2025-09-04,12,Primaria 3°,EduMax,226,7,219
2025-09-04,12,Primaria 3°,TopKids,247,1,246
2025-09-04,12,Primaria 3°,SuperSchool,56,22,34
2025-09-04,12,Primaria 3°,TopKids,53,1,52
2025-09-04,12,Primaria 3°,SuperSchool,115,16,99
2025-09-04,12,Primaria 3°,EduMax,212,14,198
2025-09-04,12,Primaria 3°,SuperSchool,130,10,120
2025-09-04,12,Primaria 3°,TopKids,117,5,112
2025-09-04,12,Primaria 4°,EduMax,270,1,269
2025-09-04,12,Primaria 4°,TopKids,79,7,72
2025-09-04,12,Primaria 4°,TopKids,187,12,175
2025-09-04,12,Primaria 4°,TopKids,110,1,109
2025-09-04,12,Primaria 4°,SuperSchool,130,23,107
2025-09-04,12,Primaria 4°,EduMax,122,12,110
2025-09-04,12,Primaria 4°,SuperSchool,298,4,294
2025-09-04,12,Primaria 4°,EduMax,238,12,226
2025-09-04,12,Primaria 4°,EduMax,148,22,126
2025-09-04,12,Primaria 4°,SuperSchool,296,18,278
2025-09-04,12,Primaria 4°,SuperSchool,104,8,96
2025-09-04,12,Primaria 4°,TopKids,199,4,195
2025-09-04,12,Primaria 4°,EduMax,264,16,248
2025-09-04,12,Primaria 4°,TopKids,162,23,139
2025-09-04,12,Primaria 4°,SuperSchool,107,8,99
2025-09-04,12,Primaria 5°,TopKids,280,12,268
2025-09-04,12,Primaria 5°,SuperSchool,169,17,152
2025-09-04,12,Primaria 5°,TopKids,151,24,127
2025-09-04,12,Primaria 5°,EduMax,118,20,98
2025-09-04,12,Primaria 5°,TopKids,295,22,273
2025-09-04,12,Primaria 5°,TopKids,221,5,216
2025-09-04,12,Primaria 5°,EduMax,149,17,132
2025-09-04,12,Primaria 5°,SuperSchool,234,8,226
2025-09-04,12,Primaria 6°,SuperSchool,66,20,46
2025-09-04,12,Primaria 6°,TopKids,294,18,276
2025-09-04,12,Primaria 6°,EduMax,269,18,251
2025-09-04,12,Primaria 6°,TopKids,121,12,109
2025-09-04,12,Primaria 6°,EduMax,295,18,277
2025-09-04,12,Primaria 6°,SuperSchool,281,16,265
2025-09-04,12,Primaria 6°,EduMax,98,2,96
2025-09-04,12,Primaria 6°,EduMax,198,22,176
2025-09-04,13,Preescolar,SuperSchool,263,24,239
2025-09-04,13,Preescolar,TopKids,241,7,234
2025-09-04,13,Preescolar,SuperSchool,243,4,239
2025-09-04,13,Preescolar,SuperSchool,297,4,293
2025-09-04,13,Preescolar,TopKids,200,8,192
2025-09-04,13,Preescolar,SuperSchool,186,14,172
2025-09-04,13,Preescolar,TopKids,122,15,107
2025-09-04,13,Preescolar,SuperSchool,139,4,135
2025-09-04,13,Preescolar,TopKids,295,10,285
2025-09-04,13,Preescolar,TopKids,138,4,134
2025-09-04,13,Preescolar,EduMax,291,11,280
2025-09-04,13,Preescolar,TopKids,196,18,178
2025-09-04,13,Preescolar,SuperSchool,234,4,230
2025-09-04,13,Preescolar,TopKids,161,14,147
2025-09-04,13,Preescolar,EduMax,215,8,207
2025-09-04,13,Preescolar,TopKids,137,16,121
2025-09-04,13,Preescolar,EduMax,167,21,146
2025-09-04,13,Preescolar,TopKids,56,19,37
2025-09-04,13,Preescolar,EduMax,131,13,118
2025-09-04,13,Kínder,TopKids,237,14,223
2025-09-04,13,Kínder,SuperSchool,93,6,87
2025-09-04,13,Kínder,EduMax,77,23,54
2025-09-04,13,Kínder,TopKids,157,22,135
2025-09-04,13,Kínder,EduMax,75,22,53
2025-09-04,13,Kínder,EduMax,248,15,233
2025-09-04,13,Kínder,EduMax,117,6,111
2025-09-04,13,Kínder,TopKids,179,24,155
2025-09-04,13,Kínder,TopKids,96,8,88
2025-09-04,13,Kínder,EduMax,299,2,297
2025-09-04,13,Kínder,TopKids,153,22,131
2025-09-04,13,Kínder,TopKids,194,22,172
2025-09-04,13,Primaria 1°,SuperSchool,71,1,70
2025-09-04,13,Primaria 1°,TopKids,78,15,63
2025-09-04,13,Primaria 1°,SuperSchool,295,2,293
2025-09-04,13,Primaria 1°,EduMax,101,6,95
2025-09-04,13,Primaria 1°,TopKids,202,13,189
2025-09-04,13,Primaria 1°,EduMax,272,15,257
2025-09-04,13,Primaria 1°,EduMax,154,10,144
2025-09-04,13,Primaria 1°,SuperSchool,291,9,282
2025-09-04,13,Primaria 1°,TopKids,163,9,154
2025-09-04,13,Primaria 1°,SuperSchool,158,12,146
2025-09-04,13,Primaria 1°,SuperSchool,260,20,240
2025-09-04,13,Primaria 1°,SuperSchool,156,5,151
2025-09-04,13,Primaria 1°,TopKids,216,13,203
2025-09-04,13,Primaria 1°,TopKids,279,13,266
2025-09-04,13,Primaria 1°,EduMax,288,8,280
2025-09-04,13,Primaria 1°,TopKids,187,9,178
2025-09-04,13,Primaria 1°,EduMax,181,24,157
2025-09-04,13,Primaria 2°,SuperSchool,187,14,173
2025-09-04,13,Primaria 2°,SuperSchool,247,16,231
2025-09-04,13,Primaria 2°,SuperSchool,93,4,89
2025-09-04,13,Primaria 2°,SuperSchool,143,4,139
2025-09-04,13,Primaria 2°,SuperSchool,62,7,55
2025-09-04,13,Primaria 2°,TopKids,215,14,201
2025-09-04,13,Primaria 2°,EduMax,117,1,116
2025-09-04,13,Primaria 2°,SuperSchool,52,13,39
2025-09-04,13,Primaria 2°,EduMax,238,4,234
2025-09-04,13,Primaria 2°,TopKids,63,7,56
2025-09-04,13,Primaria 2°,SuperSchool,116,7,109
2025-09-04,13,Primaria 2°,TopKids,297,16,281
2025-09-04,13,Primaria 2°,EduMax,74,17,57
2025-09-04,13,Primaria 2°,EduMax,167,4,163
2025-09-04,13,Primaria 2°,SuperSchool,195,4,191
2025-09-04,13,Primaria 2°,SuperSchool,96,22,74
2025-09-04,13,Primaria 2°,SuperSchool,94,3,91
2025-09-04,13,Primaria 2°,TopKids,194,22,172
2025-09-04,13,Primaria 2°,EduMax,88,7,81
2025-09-04,13,Primaria 3°,TopKids,289,4,285
2025-09-04,13,Primaria 3°,SuperSchool,228,22,206
2025-09-04,13,Primaria 3°,SuperSchool,255,7,248
2025-09-04,13,Primaria 3°,SuperSchool,234,13,221
2025-09-04,13,Primaria 3°,SuperSchool,181,7,174
2025-09-04,13,Primaria 3°,EduMax,148,20,128
2025-09-04,13,Primaria 3°,TopKids,298,21,277
2025-09-04,13,Primaria 3°,EduMax,223,7,216
2025-09-04,13,Primaria 3°,EduMax,138,5,133
2025-09-04,13,Primaria 3°,SuperSchool,165,8,157
2025-09-04,13,Primaria 3°,TopKids,69,18,51
2025-09-04,13,Primaria 3°,SuperSchool,260,20,240
2025-09-04,13,Primaria 3°,TopKids,232,6,226
2025-09-04,13,Primaria 3°,EduMax,140,15,125
2025-09-04,13,Primaria 4°,SuperSchool,199,8,191
2025-09-04,13,Primaria 4°,TopKids,156,12,144
2025-09-04,13,Primaria 4°,TopKids,112,3,109
2025-09-04,13,Primaria 4°,EduMax,276,8,268
2025-09-04,13,Primaria 4°,TopKids,117,23,94
2025-09-04,13,Primaria 4°,SuperSchool,135,17,118
2025-09-04,13,Primaria 4°,SuperSchool,268,24,244
2025-09-04,13,Primaria 4°,EduMax,67,5,62
2025-09-04,13,Primaria 4°,EduMax,219,7,212
2025-09-04,13,Primaria 4°,TopKids,172,22,150
2025-09-04,13,Primaria 4°,TopKids,64,16,48
2025-09-04,13,Primaria 4°,EduMax,235,1,234
2025-09-04,13,Primaria 4°,TopKids,244,10,234
2025-09-04,13,Primaria 4°,EduMax,130,1,129
2025-09-04,13,Primaria 4°,TopKids,66,2,64
2025-09-04,13,Primaria 4°,SuperSchool,142,6,136
2025-09-04,13,Primaria 4°,TopKids,149,24,125
2025-09-04,13,Primaria 4°,TopKids,54,10,44
2025-09-04,13,Primaria 5°,TopKids,140,24,116
2025-09-04,13,Primaria 5°,TopKids,171,22,149
2025-09-04,13,Primaria 5°,EduMax,244,6,238
2025-09-04,13,Primaria 5°,EduMax,158,16,142
2025-09-04,13,Primaria 5°,TopKids,259,3,256
2025-09-04,13,Primaria 5°,EduMax,91,16,75
2025-09-04,13,Primaria 5°,SuperSchool,62,24,38
2025-09-04,13,Primaria 5°,SuperSchool,236,16,220
2025-09-04,13,Primaria 5°,TopKids,282,10,272
2025-09-04,13,Primaria 6°,SuperSchool,106,21,85
2025-09-04,13,Primaria 6°,TopKids,231,15,216
2025-09-04,13,Primaria 6°,SuperSchool,222,17,205
2025-09-04,13,Primaria 6°,TopKids,175,11,164
2025-09-04,13,Primaria 6°,SuperSchool,50,1,49
2025-09-04,13,Primaria 6°,TopKids,168,15,153
2025-09-04,13,Primaria 6°,SuperSchool,81,23,58
2025-09-04,13,Primaria 6°,EduMax,175,16,159
2025-09-04,13,Primaria 6°,SuperSchool,250,5,245
2025-09-04,13,Primaria 6°,SuperSchool,112,6,106
2025-09-04,13,Primaria 6°,TopKids,154,3,151
2025-09-04,13,Primaria 6°,TopKids,70,13,57
2025-09-04,13,Primaria 6°,SuperSchool,136,3,133
2025-09-04,13,Primaria 6°,EduMax,243,10,233
2025-09-04,13,Primaria 6°,SuperSchool,126,11,115
2025-09-04,14,Preescolar,SuperSchool,50,8,42
2025-09-04,14,Preescolar,EduMax,97,14,83
2025-09-04,14,Preescolar,EduMax,75,2,73
2025-09-04,14,Preescolar,EduMax,107,21,86
2025-09-04,14,Preescolar,TopKids,74,12,62
2025-09-04,14,Preescolar,TopKids,288,22,266
2025-09-04,14,Kínder,EduMax,130,11,119
2025-09-04,14,Kínder,SuperSchool,83,19,64
2025-09-04,14,Kínder,SuperSchool,235,17,218
2025-09-04,14,Kínder,EduMax,286,13,273
2025-09-04,14,Kínder,SuperSchool,81,5,76
2025-09-04,14,Kínder,SuperSchool,261,19,242
2025-09-04,14,Primaria 1°,TopKids,72,1,71
2025-09-04,14,Primaria 1°,TopKids,244,13,231
2025-09-04,14,Primaria 1°,TopKids,112,6,106
2025-09-04,14,Primaria 1°,TopKids,103,15,88
2025-09-04,14,Primaria 1°,SuperSchool,244,19,225
2025-09-04,14,Primaria 1°,SuperSchool,81,21,60
2025-09-04,14,Primaria 1°,SuperSchool,250,22,228
2025-09-04,14,Primaria 1°,SuperSchool,287,23,264
2025-09-04,14,Primaria 1°,TopKids,171,10,161
2025-09-04,14,Primaria 1°,TopKids,54,23,31
2025-09-04,14,Primaria 1°,EduMax,53,11,42
2025-09-04,14,Primaria 2°,EduMax,275,3,272
2025-09-04,14,Primaria 2°,EduMax,273,18,255
2025-09-04,14,Primaria 2°,TopKids,166,13,153
2025-09-04,14,Primaria 2°,SuperSchool,55,3,52
2025-09-04,14,Primaria 2°,TopKids,283,21,262
2025-09-04,14,Primaria 2°,SuperSchool,284,4,280
2025-09-04,14,Primaria 2°,EduMax,53,13,40
2025-09-04,14,Primaria 2°,EduMax,124,2,122
2025-09-04,14,Primaria 2°,EduMax,259,22,237
2025-09-04,14,Primaria 2°,SuperSchool,100,17,83
2025-09-04,14,Primaria 2°,SuperSchool,98,16,82
2025-09-04,14,Primaria 2°,SuperSchool,252,12,240
2025-09-04,14,Primaria 2°,TopKids,286,22,264
2025-09-04,14,Primaria 2°,EduMax,57,14,43
2025-09-04,14,Primaria 2°,EduMax,287,16,271
2025-09-04,14,Primaria 3°,EduMax,261,7,254
2025-09-04,14,Primaria 3°,EduMax,87,13,74
2025-09-04,14,Primaria 3°,SuperSchool,281,11,270
2025-09-04,14,Primaria 3°,SuperSchool,250,2,248
2025-09-04,14,Primaria 3°,TopKids,91,22,69
2025-09-04,14,Primaria 3°,SuperSchool,287,2,285
2025-09-04,14,Primaria 3°,SuperSchool,66,24,42
2025-09-04,14,Primaria 3°,EduMax,227,22,205
2025-09-04,14,Primaria 3°,TopKids,201,8,193
2025-09-04,14,Primaria 3°,EduMax,79,23,56
2025-09-04,14,Primaria 3°,TopKids,238,14,224
2025-09-04,14,Primaria 3°,TopKids,277,1,276
2025-09-04,14,Primaria 3°,SuperSchool,191,10,181
2025-09-04,14,Primaria 3°,EduMax,91,7,84
2025-09-04,14,Primaria 3°,EduMax,149,11,138
2025-09-04,14,Primaria 3°,TopKids,155,17,138
2025-09-04,14,Primaria 3°,SuperSchool,155,10,145
2025-09-04,14,Primaria 3°,EduMax,56,17,39
2025-09-04,14,Primaria 3°,SuperSchool,293,12,281
2025-09-04,14,Primaria 4°,SuperSchool,104,4,100
2025-09-04,14,Primaria 4°,EduMax,56,24,32
2025-09-04,14,Primaria 4°,EduMax,175,1,174
2025-09-04,14,Primaria 4°,SuperSchool,75,10,65
2025-09-04,14,Primaria 4°,SuperSchool,94,17,77
2025-09-04,14,Primaria 4°,SuperSchool,213,9,204
2025-09-04,14,Primaria 4°,TopKids,112,23,89
2025-09-04,14,Primaria 4°,SuperSchool,115,18,97
2025-09-04,14,Primaria 4°,SuperSchool,288,10,278
2025-09-04,14,Primaria 5°,TopKids,124,7,117
2025-09-04,14,Primaria 5°,TopKids,265,23,242
2025-09-04,14,Primaria 5°,TopKids,208,19,189
2025-09-04,14,Primaria 5°,TopKids,233,10,223
2025-09-04,14,Primaria 5°,SuperSchool,179,10,169
2025-09-04,14,Primaria 6°,EduMax,58,18,40
2025-09-04,14,Primaria 6°,TopKids,145,2,143
2025-09-04,14,Primaria 6°,SuperSchool,294,11,283
2025-09-04,14,Primaria 6°,EduMax,249,8,241
2025-09-04,14,Primaria 6°,SuperSchool,283,11,272
2025-09-04,14,Primaria 6°,TopKids,266,14,252
2025-09-04,14,Primaria 6°,TopKids,148,1,147
2025-09-04,14,Primaria 6°,TopKids,166,23,143
2025-09-04,14,Primaria 6°,TopKids,282,1,281
2025-09-04,14,Primaria 6°,EduMax,112,12,100
2025-09-04,14,Primaria 6°,EduMax,239,8,231
2025-09-04,14,Primaria 6°,TopKids,206,3,203
2025-09-04,14,Primaria 6°,SuperSchool,188,11,177
2025-09-04,14,Primaria 6°,TopKids,246,24,222
2025-09-04,15,Preescolar,TopKids,272,7,265
2025-09-04,15,Preescolar,EduMax,121,21,100
2025-09-04,15,Preescolar,TopKids,198,14,184
2025-09-04,15,Preescolar,TopKids,178,13,165
2025-09-04,15,Preescolar,SuperSchool,183,6,177
2025-09-04,15,Preescolar,TopKids,166,5,161
2025-09-04,15,Preescolar,EduMax,84,12,72
2025-09-04,15,Preescolar,TopKids,84,16,68
2025-09-04,15,Preescolar,EduMax,154,8,146
2025-09-04,15,Preescolar,TopKids,84,5,79
2025-09-04,15,Preescolar,TopKids,155,5,150
2025-09-04,15,Kínder,EduMax,136,21,115
2025-09-04,15,Kínder,SuperSchool,185,4,181
2025-09-04,15,Kínder,SuperSchool,162,3,159
2025-09-04,15,Kínder,TopKids,163,16,147
2025-09-04,15,Kínder,EduMax,126,1,125
2025-09-04,15,Kínder,EduMax,176,24,152
2025-09-04,15,Kínder,TopKids,82,2,80
2025-09-04,15,Kínder,TopKids,263,3,260
2025-09-04,15,Kínder,SuperSchool,77,1,76
2025-09-04,15,Kínder,TopKids,75,24,51
2025-09-04,15,Kínder,SuperSchool,185,5,180
2025-09-04,15,Kínder,SuperSchool,64,17,47
2025-09-04,15,Primaria 1°,TopKids,57,23,34
2025-09-04,15,Primaria 1°,SuperSchool,177,3,174
2025-09-04,15,Primaria 1°,SuperSchool,293,14,279
2025-09-04,15,Primaria 1°,EduMax,140,20,120
2025-09-04,15,Primaria 1°,SuperSchool,53,24,29
2025-09-04,15,Primaria 1°,TopKids,125,3,122
2025-09-04,15,Primaria 1°,TopKids,116,21,95
2025-09-04,15,Primaria 1°,SuperSchool,183,15,168
2025-09-04,15,Primaria 1°,TopKids,259,3,256
2025-09-04,15,Primaria 1°,TopKids,130,11,119
2025-09-04,15,Primaria 1°,EduMax,150,10,140
2025-09-04,15,Primaria 1°,EduMax,224,11,213
2025-09-04,15,Primaria 1°,SuperSchool,223,14,209
2025-09-04,15,Primaria 1°,TopKids,269,22,247
2025-09-04,15,Primaria 1°,EduMax,193,14,179
2025-09-04,15,Primaria 1°,EduMax,167,8,159
2025-09-04,15,Primaria 1°,SuperSchool,267,13,254
2025-09-04,15,Primaria 1°,TopKids,81,23,58
2025-09-04,15,Primaria 2°,SuperSchool,168,6,162
2025-09-04,15,Primaria 2°,SuperSchool,279,13,266
2025-09-04,15,Primaria 2°,TopKids,115,11,104
2025-09-04,15,Primaria 2°,EduMax,275,10,265
2025-09-04,15,Primaria 2°,SuperSchool,273,8,265
2025-09-04,15,Primaria 3°,SuperSchool,90,8,82
2025-09-04,15,Primaria 3°,SuperSchool,298,20,278
2025-09-04,15,Primaria 3°,SuperSchool,140,5,135
2025-09-04,15,Primaria 3°,TopKids,298,24,274
2025-09-04,15,Primaria 3°,SuperSchool,193,22,171
2025-09-04,15,Primaria 3°,TopKids,204,11,193
2025-09-04,15,Primaria 3°,TopKids,107,17,90
2025-09-04,15,Primaria 3°,TopKids,264,12,252
2025-09-04,15,Primaria 3°,SuperSchool,129,15,114
2025-09-04,15,Primaria 3°,TopKids,262,20,242
2025-09-04,15,Primaria 3°,TopKids,166,24,142
2025-09-04,15,Primaria 4°,TopKids,120,12,108
2025-09-04,15,Primaria 4°,SuperSchool,220,5,215
2025-09-04,15,Primaria 4°,EduMax,223,17,206
2025-09-04,15,Primaria 4°,TopKids,74,3,71
2025-09-04,15,Primaria 4°,TopKids,79,1,78
2025-09-04,15,Primaria 5°,EduMax,134,7,127
2025-09-04,15,Primaria 5°,SuperSchool,297,7,290
2025-09-04,15,Primaria 5°,SuperSchool,237,2,235
2025-09-04,15,Primaria 5°,TopKids,180,18,162
2025-09-04,15,Primaria 5°,TopKids,125,14,111
2025-09-04,15,Primaria 5°,SuperSchool,269,10,259
2025-09-04,15,Primaria 5°,SuperSchool,73,24,49
2025-09-04,15,Primaria 5°,TopKids,236,9,227
2025-09-04,15,Primaria 5°,EduMax,168,8,160
2025-09-04,15,Primaria 5°,TopKids,186,13,173
2025-09-04,15,Primaria 5°,TopKids,237,7,230
2025-09-04,15,Primaria 5°,SuperSchool,211,21,190
2025-09-04,15,Primaria 5°,SuperSchool,142,17,125
2025-09-04,15,Primaria 5°,EduMax,96,16,80
2025-09-04,15,Primaria 5°,TopKids,230,13,217
2025-09-04,15,Primaria 5°,SuperSchool,185,9,176
2025-09-04,15,Primaria 5°,EduMax,146,4,142
2025-09-04,15,Primaria 6°,TopKids,131,1,130
2025-09-04,15,Primaria 6°,TopKids,155,24,131
2025-09-04,15,Primaria 6°,EduMax,227,2,225
2025-09-04,15,Primaria 6°,SuperSchool,102,9,93
2025-09-04,15,Primaria 6°,TopKids,238,23,215
2025-09-04,15,Primaria 6°,TopKids,243,2,241
2025-09-04,15,Primaria 6°,SuperSchool,109,14,95
2025-09-04,15,Primaria 6°,TopKids,296,3,293
2025-09-04,15,Primaria 6°,EduMax,50,9,41
2025-09-04,15,Primaria 6°,SuperSchool,217,15,202
2025-09-04,15,Primaria 6°,EduMax,70,8,62
2025-09-04,15,Primaria 6°,TopKids,154,2,152
2025-09-04,15,Primaria 6°,SuperSchool,241,10,231
2025-09-04,15,Primaria 6°,SuperSchool,289,21,268
2025-09-04,15,Primaria 6°,SuperSchool,247,10,237
2025-09-04,15,Primaria 6°,EduMax,139,19,120
2025-09-04,15,Primaria 6°,SuperSchool,267,19,248
2025-09-04,15,Primaria 6°,TopKids,158,4,154
2025-09-04,15,Primaria 6°,SuperSchool,185,12,173
2025-09-04,16,Preescolar,SuperSchool,202,1,201
2025-09-04,16,Preescolar,TopKids,179,9,170
2025-09-04,16,Preescolar,TopKids,235,1,234
2025-09-04,16,Preescolar,TopKids,226,5,221
2025-09-04,16,Preescolar,TopKids,261,24,237
2025-09-04,16,Preescolar,SuperSchool,144,12,132
2025-09-04,16,Preescolar,TopKids,276,14,262
2025-09-04,16,Preescolar,TopKids,183,17,166
2025-09-04,16,Preescolar,EduMax,121,19,102
2025-09-04,16,Preescolar,SuperSchool,144,19,125
2025-09-04,16,Kínder,TopKids,283,16,267
2025-09-04,16,Kínder,SuperSchool,162,9,153
2025-09-04,16,Kínder,TopKids,172,8,164
2025-09-04,16,Kínder,SuperSchool,251,8,243
2025-09-04,16,Kínder,TopKids,168,23,145
2025-09-04,16,Primaria 1°,TopKids,93,24,69
2025-09-04,16,Primaria 1°,TopKids,295,18,277
2025-09-04,16,Primaria 1°,TopKids,58,21,37
2025-09-04,16,Primaria 1°,EduMax,280,18,262
2025-09-04,16,Primaria 1°,EduMax,170,2,168
2025-09-04,16,Primaria 1°,EduMax,180,19,161
2025-09-04,16,Primaria 1°,EduMax,267,3,264
2025-09-04,16,Primaria 1°,SuperSchool,156,11,145
2025-09-04,16,Primaria 1°,TopKids,244,5,239
2025-09-04,16,Primaria 1°,TopKids,264,17,247
2025-09-04,16,Primaria 1°,EduMax,66,15,51
2025-09-04,16,Primaria 1°,EduMax,94,2,92
2025-09-04,16,Primaria 1°,SuperSchool,114,10,104
2025-09-04,16,Primaria 1°,EduMax,93,3,90
2025-09-04,16,Primaria 1°,SuperSchool,68,1,67
2025-09-04,16,Primaria 1°,TopKids,213,13,200
2025-09-04,16,Primaria 1°,TopKids,287,14,273
2025-09-04,16,Primaria 1°,TopKids,132,11,121
2025-09-04,16,Primaria 2°,EduMax,107,4,103
2025-09-04,16,Primaria 2°,EduMax,150,9,141
2025-09-04,16,Primaria 2°,SuperSchool,264,15,249
2025-09-04,16,Primaria 2°,TopKids,200,1,199
2025-09-04,16,Primaria 2°,EduMax,130,15,115
2025-09-04,16,Primaria 2°,EduMax,218,23,195
2025-09-04,16,Primaria 2°,SuperSchool,182,3,179
2025-09-04,16,Primaria 2°,EduMax,58,4,54
2025-09-04,16,Primaria 2°,TopKids,242,16,226
2025-09-04,16,Primaria 2°,SuperSchool,173,6,167
2025-09-04,16,Primaria 2°,EduMax,191,22,169
2025-09-04,16,Primaria 2°,SuperSchool,252,1,251
2025-09-04,16,Primaria 2°,EduMax,114,21,93
2025-09-04,16,Primaria 3°,SuperSchool,57,14,43
2025-09-04,16,Primaria 3°,SuperSchool,282,6,276
2025-09-04,16,Primaria 3°,SuperSchool,296,23,273
2025-09-04,16,Primaria 3°,SuperSchool,82,14,68
2025-09-04,16,Primaria 3°,TopKids,105,11,94
2025-09-04,16,Primaria 3°,TopKids,221,6,215
2025-09-04,16,Primaria 3°,SuperSchool,92,10,82
2025-09-04,16,Primaria 3°,TopKids,185,12,173
2025-09-04,16,Primaria 3°,SuperSchool,245,21,224
2025-09-04,16,Primaria 3°,SuperSchool,207,13,194
2025-09-04,16,Primaria 3°,EduMax,52,20,32
2025-09-04,16,Primaria 3°,SuperSchool,71,2,69
2025-09-04,16,Primaria 3°,SuperSchool,89,24,65
2025-09-04,16,Primaria 3°,EduMax,54,16,38
2025-09-04,16,Primaria 3°,SuperSchool,64,19,45
2025-09-04,16,Primaria 3°,SuperSchool,124,16,108
2025-09-04,16,Primaria 3°,EduMax,266,15,251
2025-09-04,16,Primaria 4°,SuperSchool,107,16,91
2025-09-04,16,Primaria 4°,SuperSchool,124,20,104
2025-09-04,16,Primaria 4°,TopKids,211,22,189
2025-09-04,16,Primaria 4°,EduMax,124,4,120
2025-09-04,16,Primaria 4°,EduMax,180,24,156
2025-09-04,16,Primaria 4°,EduMax,106,5,101
2025-09-04,16,Primaria 4°,EduMax,90,4,86
2025-09-04,16,Primaria 4°,EduMax,88,13,75
2025-09-04,16,Primaria 4°,EduMax,157,10,147
2025-09-04,16,Primaria 4°,TopKids,60,22,38
2025-09-04,16,Primaria 5°,EduMax,69,6,63
2025-09-04,16,Primaria 5°,TopKids,270,14,256
2025-09-04,16,Primaria 5°,EduMax,172,23,149
2025-09-04,16,Primaria 5°,TopKids,155,10,145
2025-09-04,16,Primaria 5°,TopKids,267,10,257
2025-09-04,16,Primaria 5°,EduMax,182,22,160
2025-09-04,16,Primaria 5°,TopKids,78,7,71
2025-09-04,16,Primaria 5°,EduMax,208,11,197
2025-09-04,16,Primaria 5°,SuperSchool,84,7,77
2025-09-04,16,Primaria 5°,SuperSchool,143,4,139
2025-09-04,16,Primaria 6°,EduMax,79,21,58
2025-09-04,16,Primaria 6°,EduMax,284,14,270
2025-09-04,16,Primaria 6°,EduMax,191,4,187
2025-09-04,16,Primaria 6°,TopKids,189,12,177
2025-09-04,16,Primaria 6°,EduMax,75,6,69
2025-09-04,16,Primaria 6°,SuperSchool,164,21,143
2025-09-04,16,Primaria 6°,TopKids,155,7,148
2025-09-05,9,Preescolar,TopKids,264,4,260
2025-09-05,9,Preescolar,SuperSchool,144,5,139
2025-09-05,9,Preescolar,EduMax,156,16,140
2025-09-05,9,Preescolar,EduMax,237,15,222
2025-09-05,9,Preescolar,SuperSchool,82,8,74
2025-09-05,9,Preescolar,SuperSchool,68,7,61
2025-09-05,9,Preescolar,TopKids,276,12,264
2025-09-05,9,Kínder,EduMax,228,24,204
2025-09-05,9,Kínder,TopKids,252,19,233
2025-09-05,9,Kínder,SuperSchool,81,9,72
2025-09-05,9,Kínder,EduMax,195,15,180
2025-09-05,9,Kínder,TopKids,92,24,68
2025-09-05,9,Kínder,TopKids,198,18,180
2025-09-05,9,Kínder,EduMax,299,21,278
2025-09-05,9,Kínder,TopKids,254,16,238
2025-09-05,9,Kínder,EduMax,234,2,232
2025-09-05,9,Kínder,SuperSchool,139,22,117
2025-09-05,9,Kínder,TopKids,71,20,51
2025-09-05,9,Primaria 1°,EduMax,270,10,260
2025-09-05,9,Primaria 1°,TopKids,212,6,206
2025-09-05,9,Primaria 1°,SuperSchool,172,21,151
2025-09-05,9,Primaria 1°,EduMax,241,8,233
2025-09-05,9,Primaria 1°,EduMax,257,14,243
2025-09-05,9,Primaria 1°,EduMax,188,6,182
2025-09-05,9,Primaria 1°,SuperSchool,128,6,122
2025-09-05,9,Primaria 1°,EduMax,230,16,214
2025-09-05,9,Primaria 1°,EduMax,166,1,165
2025-09-05,9,Primaria 1°,TopKids,175,23,152
2025-09-05,9,Primaria 1°,TopKids,184,14,170
2025-09-05,9,Primaria 1°,EduMax,143,24,119
2025-09-05,9,Primaria 1°,TopKids,62,19,43
2025-09-05,9,Primaria 1°,SuperSchool,71,2,69
2025-09-05,9,Primaria 1°,TopKids,254,4,250
2025-09-05,9,Primaria 1°,EduMax,67,19,48
2025-09-05,9,Primaria 1°,TopKids,177,3,174
2025-09-05,9,Primaria 2°,SuperSchool,161,13,148
2025-09-05,9,Primaria 2°,EduMax,172,22,150
2025-09-05,9,Primaria 2°,SuperSchool,139,14,125
2025-09-05,9,Primaria 2°,TopKids,187,15,172
2025-09-05,9,Primaria 2°,EduMax,257,8,249
2025-09-05,9,Primaria 2°,EduMax,238,17,221
2025-09-05,9,Primaria 2°,EduMax,193,2,191
2025-09-05,9,Primaria 2°,TopKids,169,21,148
2025-09-05,9,Primaria 3°,TopKids,253,5,248
2025-09-05,9,Primaria 3°,EduMax,231,24,207
2025-09-05,9,Primaria 3°,EduMax,103,6,97
2025-09-05,9,Primaria 3°,SuperSchool,122,15,107
2025-09-05,9,Primaria 3°,EduMax,149,7,142
2025-09-05,9,Primaria 3°,EduMax,227,18,209
2025-09-05,9,Primaria 4°,EduMax,245,13,232
2025-09-05,9,Primaria 4°,EduMax,70,13,57
2025-09-05,9,Primaria 4°,EduMax,200,22,178
2025-09-05,9,Primaria 4°,EduMax,272,16,256
2025-09-05,9,Primaria 4°,TopKids,155,9,146
2025-09-05,9,Primaria 4°,TopKids,130,24,106
2025-09-05,9,Primaria 4°,TopKids,204,2,202
2025-09-05,9,Primaria 5°,TopKids,178,2,176
2025-09-05,9,Primaria 5°,TopKids,150,18,132
2025-09-05,9,Primaria 5°,SuperSchool,55,6,49
2025-09-05,9,Primaria 5°,EduMax,237,16,221
2025-09-05,9,Primaria 5°,EduMax,112,3,109
2025-09-05,9,Primaria 5°,TopKids,84,23,61
2025-09-05,9,Primaria 5°,SuperSchool,85,6,79
2025-09-05,9,Primaria 5°,TopKids,106,9,97
2025-09-05,9,Primaria 5°,TopKids,180,6,174
2025-09-05,9,Primaria 5°,SuperSchool,101,24,77
2025-09-05,9,Primaria 5°,EduMax,154,15,139
2025-09-05,9,Primaria 5°,SuperSchool,86,21,65
2025-09-05,9,Primaria 5°,TopKids,225,3,222
2025-09-05,9,Primaria 5°,SuperSchool,98,3,95
2025-09-05,9,Primaria 5°,TopKids,120,21,99
2025-09-05,9,Primaria 5°,EduMax,197,8,189
2025-09-05,9,Primaria 6°,EduMax,256,6,250
2025-09-05,9,Primaria 6°,SuperSchool,157,14,143
2025-09-05,9,Primaria 6°,EduMax,247,3,244
2025-09-05,9,Primaria 6°,SuperSchool,132,10,122
2025-09-05,9,Primaria 6°,TopKids,286,1,285
2025-09-05,9,Primaria 6°,SuperSchool,194,22,172
2025-09-05,9,Primaria 6°,EduMax,55,14,41
2025-09-05,9,Primaria 6°,TopKids,274,20,254
2025-09-05,10,Preescolar,EduMax,50,13,37
2025-09-05,10,Preescolar,EduMax,117,2,115
2025-09-05,10,Preescolar,SuperSchool,86,23,63
2025-09-05,10,Preescolar,TopKids,166,24,142
2025-09-05,10,Preescolar,TopKids,190,5,185
2025-09-05,10,Preescolar,EduMax,225,22,203
2025-09-05,10,Preescolar,SuperSchool,284,21,263
2025-09-05,10,Preescolar,SuperSchool,53,3,50
2025-09-05,10,Kínder,TopKids,129,13,116
2025-09-05,10,Kínder,SuperSchool,216,24,192
2025-09-05,10,Kínder,TopKids,177,15,162
2025-09-05,10,Kínder,SuperSchool,176,17,159
2025-09-05,10,Kínder,EduMax,135,11,124
2025-09-05,10,Kínder,SuperSchool,251,15,236
2025-09-05,10,Primaria 1°,TopKids,234,11,223
2025-09-05,10,Primaria 1°,SuperSchool,199,1,198
2025-09-05,10,Primaria 1°,SuperSchool,249,17,232
2025-09-05,10,Primaria 1°,SuperSchool,72,5,67
2025-09-05,10,Primaria 1°,TopKids,78,6,72
2025-09-05,10,Primaria 1°,SuperSchool,138,14,124
2025-09-05,10,Primaria 2°,SuperSchool,164,2,162
2025-09-05,10,Primaria 2°,SuperSchool,85,5,80
2025-09-05,10,Primaria 2°,EduMax,293,1,292
2025-09-05,10,Primaria 2°,SuperSchool,227,3,224
2025-09-05,10,Primaria 2°,SuperSchool,158,10,148
2025-09-05,10,Primaria 3°,TopKids,284,1,283
2025-09-05,10,Primaria 3°,TopKids,192,24,168
2025-09-05,10,Primaria 3°,SuperSchool,117,15,102
2025-09-05,10,Primaria 3°,TopKids,160,4,156
2025-09-05,10,Primaria 3°,EduMax,244,23,221
2025-09-05,10,Primaria 3°,EduMax,183,1,182
2025-09-05,10,Primaria 3°,SuperSchool,189,18,171
2025-09-05,10,Primaria 3°,SuperSchool,276,21,255
2025-09-05,10,Primaria 3°,TopKids,228,3,225
2025-09-05,10,Primaria 3°,EduMax,85,13,72
2025-09-05,10,Primaria 3°,SuperSchool,235,2,233
2025-09-05,10,Primaria 3°,SuperSchool,211,10,201
2025-09-05,10,Primaria 3°,TopKids,177,24,153
2025-09-05,10,Primaria 3°,TopKids,212,14,198
2025-09-05,10,Primaria 4°,TopKids,132,1,131
2025-09-05,10,Primaria 4°,TopKids,148,20,128
2025-09-05,10,Primaria 4°,SuperSchool,177,8,169
2025-09-05,10,Primaria 4°,SuperSchool,258,1,257
2025-09-05,10,Primaria 4°,EduMax,226,21,205
2025-09-05,10,Primaria 4°,EduMax,205,1,204
2025-09-05,10,Primaria 5°,SuperSchool,263,20,243
2025-09-05,10,Primaria 5°,TopKids,126,8,118
2025-09-05,10,Primaria 5°,SuperSchool,218,17,201
2025-09-05,10,Primaria 5°,EduMax,184,4,180
2025-09-05,10,Primaria 5°,SuperSchool,270,24,246
2025-09-05,10,Primaria 5°,TopKids,248,17,231
2025-09-05,10,Primaria 5°,SuperSchool,210,2,208
2025-09-05,10,Primaria 5°,EduMax,195,9,186
2025-09-05,10,Primaria 5°,SuperSchool,178,7,171
2025-09-05,10,Primaria 5°,EduMax,275,3,272
2025-09-05,10,Primaria 5°,TopKids,228,12,216
2025-09-05,10,Primaria 5°,TopKids,181,24,157
2025-09-05,10,Primaria 5°,SuperSchool,65,6,59
2025-09-05,10,Primaria 5°,TopKids,290,5,285
2025-09-05,10,Primaria 5°,TopKids,126,12,114
2025-09-05,10,Primaria 5°,SuperSchool,234,12,222
2025-09-05,10,Primaria 5°,TopKids,74,22,52
2025-09-05,10,Primaria 6°,EduMax,275,18,257
2025-09-05,10,Primaria 6°,SuperSchool,257,20,237
2025-09-05,10,Primaria 6°,TopKids,199,10,189
2025-09-05,10,Primaria 6°,EduMax,240,4,236
2025-09-05,10,Primaria 6°,EduMax,80,19,61
2025-09-05,10,Primaria 6°,EduMax,63,8,55
2025-09-05,10,Primaria 6°,SuperSchool,118,8,110
2025-09-05,10,Primaria 6°,TopKids,297,23,274
2025-09-05,10,Primaria 6°,SuperSchool,216,13,203
2025-09-05,10,Primaria 6°,SuperSchool,68,3,65
2025-09-05,10,Primaria 6°,EduMax,279,19,260
2025-09-05,10,Primaria 6°,TopKids,277,19,258
2025-09-05,10,Primaria 6°,TopKids,229,21,208
2025-09-05,10,Primaria 6°,EduMax,120,20,100
2025-09-05,10,Primaria 6°,EduMax,231,22,209
2025-09-05,10,Primaria 6°,SuperSchool,144,15,129
2025-09-05,10,Primaria 6°,EduMax,194,24,170
2025-09-05,10,Primaria 6°,SuperSchool,86,19,67
2025-09-05,10,Primaria 6°,EduMax,93,2,91
2025-09-05,11,Preescolar,SuperSchool,86,15,71
2025-09-05,11,Preescolar,TopKids,190,20,170
2025-09-05,11,Preescolar,TopKids,272,18,254
2025-09-05,11,Preescolar,SuperSchool,97,24,73
2025-09-05,11,Preescolar,TopKids,245,24,221
2025-09-05,11,Kínder,SuperSchool,250,15,235
2025-09-05,11,Kínder,EduMax,293,22,271
2025-09-05,11,Kínder,TopKids,262,12,250
2025-09-05,11,Kínder,EduMax,110,7,103
2025-09-05,11,Kínder,EduMax,268,15,253
2025-09-05,11,Kínder,TopKids,270,19,251
2025-09-05,11,Kínder,SuperSchool,199,3,196
2025-09-05,11,Kínder,EduMax,192,2,190
2025-09-05,11,Kínder,SuperSchool,283,22,261
2025-09-05,11,Kínder,TopKids,152,19,133
2025-09-05,11,Kínder,TopKids,61,2,59
2025-09-05,11,Kínder,EduMax,94,20,74
2025-09-05,11,Kínder,TopKids,56,24,32
2025-09-05,11,Kínder,TopKids,119,1,118
2025-09-05,11,Kínder,SuperSchool,211,1,210
2025-09-05,11,Kínder,SuperSchool,200,4,196
2025-09-05,11,Primaria 1°,EduMax,257,8,249
2025-09-05,11,Primaria 1°,TopKids,92,10,82
2025-09-05,11,Primaria 1°,EduMax,244,23,221
2025-09-05,11,Primaria 1°,TopKids,98,10,88
2025-09-05,11,Primaria 1°,SuperSchool,127,23,104
2025-09-05,11,Primaria 1°,SuperSchool,77,9,68
2025-09-05,11,Primaria 1°,TopKids,53,20,33
2025-09-05,11,Primaria 1°,SuperSchool,138,3,135
2025-09-05,11,Primaria 1°,EduMax,102,7,95
2025-09-05,11,Primaria 2°,SuperSchool,135,3,132
2025-09-05,11,Primaria 2°,EduMax,295,15,280
2025-09-05,11,Primaria 2°,EduMax,257,17,240
2025-09-05,11,Primaria 2°,TopKids,132,1,131
2025-09-05,11,Primaria 2°,SuperSchool,230,14,216
2025-09-05,11,Primaria 2°,EduMax,203,2,201
2025-09-05,11,Primaria 2°,EduMax,77,20,57
2025-09-05,11,Primaria 2°,EduMax,288,15,273
2025-09-05,11,Primaria 2°,TopKids,121,11,110
2025-09-05,11,Primaria 3°,TopKids,138,7,131
2025-09-05,11,Primaria 3°,SuperSchool,106,19,87
2025-09-05,11,Primaria 3°,EduMax,271,24,247
2025-09-05,11,Primaria 3°,SuperSchool,131,8,123
2025-09-05,11,Primaria 3°,SuperSchool,281,22,259
2025-09-05,11,Primaria 3°,EduMax,63,24,39
2025-09-05,11,Primaria 3°,EduMax,212,7,205
2025-09-05,11,Primaria 3°,TopKids,174,15,159
2025-09-05,11,Primaria 3°,TopKids,147,22,125
2025-09-05,11,Primaria 3°,EduMax,95,18,77
2025-09-05,11,Primaria 3°,TopKids,172,2,170
2025-09-05,11,Primaria 3°,EduMax,152,15,137
2025-09-05,11,Primaria 3°,EduMax,86,20,66
2025-09-05,11,Primaria 3°,EduMax,220,8,212
2025-09-05,11,Primaria 4°,EduMax,272,15,257
2025-09-05,11,Primaria 4°,TopKids,281,4,277
2025-09-05,11,Primaria 4°,SuperSchool,64,11,53
2025-09-05,11,Primaria 4°,SuperSchool,179,8,171
2025-09-05,11,Primaria 4°,SuperSchool,212,18,194
2025-09-05,11,Primaria 4°,EduMax,289,21,268
2025-09-05,11,Primaria 4°,SuperSchool,69,4,65
2025-09-05,11,Primaria 4°,EduMax,147,13,134
2025-09-05,11,Primaria 4°,SuperSchool,272,20,252
2025-09-05,11,Primaria 4°,EduMax,88,7,81
2025-09-05,11,Primaria 4°,SuperSchool,155,12,143
2025-09-05,11,Primaria 4°,SuperSchool,104,22,82
2025-09-05,11,Primaria 4°,EduMax,225,2,223
2025-09-05,11,Primaria 4°,EduMax,262,9,253
2025-09-05,11,Primaria 4°,SuperSchool,257,5,252
2025-09-05,11,Primaria 4°,TopKids,234,17,217
2025-09-05,11,Primaria 4°,EduMax,212,17,195
2025-09-05,11,Primaria 5°,TopKids,196,15,181
2025-09-05,11,Primaria 5°,EduMax,203,12,191
2025-09-05,11,Primaria 5°,TopKids,92,23,69
2025-09-05,11,Primaria 5°,EduMax,199,15,184
2025-09-05,11,Primaria 5°,TopKids,60,23,37
2025-09-05,11,Primaria 5°,EduMax,178,20,158
2025-09-05,11,Primaria 5°,SuperSchool,239,21,218
2025-09-05,11,Primaria 5°,SuperSchool,130,15,115
2025-09-05,11,Primaria 5°,SuperSchool,114,3,111
2025-09-05,11,Primaria 5°,TopKids,105,21,84
2025-09-05,11,Primaria 5°,TopKids,175,17,158
2025-09-05,11,Primaria 5°,EduMax,239,24,215
2025-09-05,11,Primaria 5°,EduMax,277,8,269
2025-09-05,11,Primaria 5°,TopKids,57,14,43
2025-09-05,11,Primaria 5°,EduMax,201,22,179
2025-09-05,11,Primaria 6°,TopKids,205,22,183
2025-09-05,11,Primaria 6°,TopKids,250,24,226
2025-09-05,11,Primaria 6°,TopKids,239,23,216
2025-09-05,11,Primaria 6°,SuperSchool,158,7,151
2025-09-05,11,Primaria 6°,SuperSchool,89,5,84
2025-09-05,11,Primaria 6°,TopKids,120,8,112
2025-09-05,11,Primaria 6°,TopKids,135,12,123
2025-09-05,11,Primaria 6°,EduMax,166,21,145
2025-09-05,11,Primaria 6°,TopKids,142,3,139
2025-09-05,11,Primaria 6°,SuperSchool,132,8,124
2025-09-05,11,Primaria 6°,TopKids,86,13,73
2025-09-05,11,Primaria 6°,EduMax,183,1,182
2025-09-05,11,Primaria 6°,EduMax,252,20,232
2025-09-05,11,Primaria 6°,SuperSchool,272,16,256
2025-09-05,11,Primaria 6°,TopKids,182,15,167
2025-09-05,11,Primaria 6°,SuperSchool,64,4,60
2025-09-05,11,Primaria 6°,EduMax,280,23,257
2025-09-05,11,Primaria 6°,SuperSchool,263,2,261
2025-09-05,11,Primaria 6°,EduMax,253,2,251
2025-09-05,12,Preescolar,TopKids,101,6,95
2025-09-05,12,Preescolar,EduMax,292,17,275
2025-09-05,12,Preescolar,TopKids,293,10,283
2025-09-05,12,Preescolar,SuperSchool,101,23,78
2025-09-05,12,Preescolar,SuperSchool,78,18,60
2025-09-05,12,Preescolar,TopKids,258,8,250
2025-09-05,12,Preescolar,EduMax,184,23,161
2025-09-05,12,Preescolar,TopKids,244,2,242
2025-09-05,12,Preescolar,TopKids,205,24,181
2025-09-05,12,Preescolar,SuperSchool,124,8,116
2025-09-05,12,Preescolar,TopKids,179,12,167
2025-09-05,12,Preescolar,SuperSchool,282,6,276
2025-09-05,12,Preescolar,EduMax,202,5,197
2025-09-05,12,Preescolar,TopKids,103,17,86
2025-09-05,12,Preescolar,SuperSchool,271,2,269
2025-09-05,12,Preescolar,SuperSchool,101,2,99
2025-09-05,12,Preescolar,SuperSchool,289,1,288
2025-09-05,12,Preescolar,TopKids,149,20,129
2025-09-05,12,Kínder,EduMax,125,24,101
2025-09-05,12,Kínder,EduMax,158,18,140
2025-09-05,12,Kínder,SuperSchool,168,12,156
2025-09-05,12,Kínder,TopKids,274,9,265
2025-09-05,12,Kínder,SuperSchool,105,18,87
2025-09-05,12,Kínder,TopKids,205,3,202
2025-09-05,12,Kínder,EduMax,113,22,91
2025-09-05,12,Primaria 1°,SuperSchool,168,21,147
2025-09-05,12,Primaria 1°,SuperSchool,221,4,217
2025-09-05,12,Primaria 1°,EduMax,228,6,222
2025-09-05,12,Primaria 1°,EduMax,60,22,38
2025-09-05,12,Primaria 1°,EduMax,239,3,236
2025-09-05,12,Primaria 1°,SuperSchool,217,4,213
2025-09-05,12,Primaria 1°,TopKids,65,18,47
2025-09-05,12,Primaria 1°,TopKids,60,8,52
2025-09-05,12,Primaria 2°,EduMax,169,16,153
2025-09-05,12,Primaria 2°,SuperSchool,170,6,164
2025-09-05,12,Primaria 2°,EduMax,238,2,236
2025-09-05,12,Primaria 2°,TopKids,280,9,271
2025-09-05,12,Primaria 2°,TopKids,134,14,120
2025-09-05,12,Primaria 2°,SuperSchool,77,13,64
2025-09-05,12,Primaria 2°,TopKids,182,17,165
2025-09-05,12,Primaria 2°,SuperSchool,107,24,83
2025-09-05,12,Primaria 2°,TopKids,276,9,267
2025-09-05,12,Primaria 2°,SuperSchool,295,4,291
2025-09-05,12,Primaria 2°,TopKids,261,11,250
2025-09-05,12,Primaria 2°,SuperSchool,223,10,213
2025-09-05,12,Primaria 2°,SuperSchool,198,21,177
2025-09-05,12,Primaria 2°,SuperSchool,257,1,256
2025-09-05,12,Primaria 2°,EduMax,285,18,267
2025-09-05,12,Primaria 3°,SuperSchool,144,24,120
2025-09-05,12,Primaria 3°,EduMax,185,14,171
2025-09-05,12,Primaria 3°,SuperSchool,103,4,99
2025-09-05,12,Primaria 3°,EduMax,161,6,155
2025-09-05,12,Primaria 3°,TopKids,213,22,191
2025-09-05,12,Primaria 4°,SuperSchool,175,14,161
2025-09-05,12,Primaria 4°,TopKids,117,19,98
2025-09-05,12,Primaria 4°,TopKids,224,24,200
2025-09-05,12,Primaria 4°,EduMax,285,8,277
2025-09-05,12,Primaria 4°,SuperSchool,273,10,263
2025-09-05,12,Primaria 4°,TopKids,90,17,73
2025-09-05,12,Primaria 4°,EduMax,180,9,171
2025-09-05,12,Primaria 4°,EduMax,237,18,219
2025-09-05,12,Primaria 4°,SuperSchool,143,5,138
2025-09-05,12,Primaria 4°,EduMax,165,21,144
2025-09-05,12,Primaria 4°,TopKids,262,24,238
2025-09-05,12,Primaria 4°,EduMax,244,16,228
2025-09-05,12,Primaria 5°,SuperSchool,249,9,240
2025-09-05,12,Primaria 5°,SuperSchool,233,3,230
2025-09-05,12,Primaria 5°,SuperSchool,79,7,72
2025-09-05,12,Primaria 5°,SuperSchool,143,17,126
2025-09-05,12,Primaria 5°,TopKids,229,17,212
2025-09-05,12,Primaria 5°,EduMax,236,5,231
2025-09-05,12,Primaria 5°,SuperSchool,207,22,185
2025-09-05,12,Primaria 5°,TopKids,71,6,65
2025-09-05,12,Primaria 5°,TopKids,274,19,255
2025-09-05,12,Primaria 5°,TopKids,281,22,259
2025-09-05,12,Primaria 5°,EduMax,158,1,157
2025-09-05,12,Primaria 5°,SuperSchool,182,12,170
2025-09-05,12,Primaria 5°,TopKids,265,18,247
2025-09-05,12,Primaria 5°,SuperSchool,233,22,211
2025-09-05,12,Primaria 5°,SuperSchool,243,23,220
2025-09-05,12,Primaria 5°,EduMax,186,11,175
2025-09-05,12,Primaria 5°,EduMax,157,19,138
2025-09-05,12,Primaria 5°,SuperSchool,85,12,73
2025-09-05,12,Primaria 5°,SuperSchool,63,17,46
2025-09-05,12,Primaria 6°,SuperSchool,175,22,153
2025-09-05,12,Primaria 6°,EduMax,179,17,162
2025-09-05,12,Primaria 6°,TopKids,263,1,262
2025-09-05,12,Primaria 6°,SuperSchool,255,10,245
2025-09-05,12,Primaria 6°,SuperSchool,135,18,117
2025-09-05,13,Preescolar,TopKids,143,15,128
2025-09-05,13,Preescolar,TopKids,127,9,118
2025-09-05,13,Preescolar,SuperSchool,210,16,194
2025-09-05,13,Preescolar,SuperSchool,137,8,129
2025-09-05,13,Preescolar,TopKids,229,12,217
2025-09-05,13,Preescolar,TopKids,279,20,259
2025-09-05,13,Preescolar,EduMax,142,9,133
2025-09-05,13,Preescolar,EduMax,131,1,130
2025-09-05,13,Preescolar,TopKids,96,12,84
2025-09-05,13,Preescolar,TopKids,292,20,272
2025-09-05,13,Preescolar,TopKids,155,16,139
2025-09-05,13,Kínder,SuperSchool,89,22,67
2025-09-05,13,Kínder,EduMax,295,18,277
2025-09-05,13,Kínder,SuperSchool,229,12,217
2025-09-05,13,Kínder,EduMax,275,4,271
2025-09-05,13,Kínder,SuperSchool,73,14,59
2025-09-05,13,Kínder,SuperSchool,164,4,160
2025-09-05,13,Kínder,EduMax,157,2,155
2025-09-05,13,Kínder,EduMax,279,3,276
2025-09-05,13,Kínder,TopKids,115,21,94
2025-09-05,13,Kínder,SuperSchool,264,1,263
2025-09-05,13,Primaria 1°,EduMax,153,22,131
2025-09-05,13,Primaria 1°,EduMax,142,13,129
2025-09-05,13,Primaria 1°,TopKids,192,13,179
2025-09-05,13,Primaria 1°,SuperSchool,244,12,232
2025-09-05,13,Primaria 1°,EduMax,133,12,121
2025-09-05,13,Primaria 1°,TopKids,88,1,87
2025-09-05,13,Primaria 2°,TopKids,96,9,87
2025-09-05,13,Primaria 2°,EduMax,103,20,83
2025-09-05,13,Primaria 2°,EduMax,186,14,172
2025-09-05,13,Primaria 2°,TopKids,89,6,83
2025-09-05,13,Primaria 2°,EduMax,180,14,166
2025-09-05,13,Primaria 2°,SuperSchool,148,4,144
2025-09-05,13,Primaria 2°,TopKids,143,22,121
2025-09-05,13,Primaria 2°,EduMax,239,7,232
2025-09-05,13,Primaria 2°,TopKids,255,16,239
2025-09-05,13,Primaria 2°,TopKids,126,23,103
2025-09-05,13,Primaria 2°,SuperSchool,261,17,244
2025-09-05,13,Primaria 2°,SuperSchool,201,10,191
2025-09-05,13,Primaria 2°,TopKids,165,17,148
2025-09-05,13,Primaria 2°,EduMax,108,12,96
2025-09-05,13,Primaria 2°,TopKids,91,23,68
2025-09-05,13,Primaria 2°,EduMax,237,22,215
2025-09-05,13,Primaria 3°,EduMax,160,22,138
2025-09-05,13,Primaria 3°,EduMax,168,13,155
2025-09-05,13,Primaria 3°,EduMax,161,13,148
2025-09-05,13,Primaria 3°,TopKids,76,19,57
2025-09-05,13,Primaria 3°,EduMax,285,21,264
2025-09-05,13,Primaria 3°,TopKids,133,21,112
2025-09-05,13,Primaria 3°,TopKids,293,10,283
2025-09-05,13,Primaria 3°,TopKids,286,13,273
2025-09-05,13,Primaria 3°,SuperSchool,131,7,124
2025-09-05,13,Primaria 3°,EduMax,127,5,122
2025-09-05,13,Primaria 3°,SuperSchool,79,22,57
2025-09-05,13,Primaria 3°,TopKids,98,5,93
2025-09-05,13,Primaria 4°,TopKids,218,17,201
2025-09-05,13,Primaria 4°,EduMax,259,3,256
2025-09-05,13,Primaria 4°,SuperSchool,79,22,57
2025-09-05,13,Primaria 4°,SuperSchool,162,20,142
2025-09-05,13,Primaria 4°,EduMax,277,4,273
2025-09-05,13,Primaria 4°,SuperSchool,265,21,244
2025-09-05,13,Primaria 4°,TopKids,57,22,35
2025-09-05,13,Primaria 4°,EduMax,112,2,110
2025-09-05,13,Primaria 4°,SuperSchool,187,5,182
2025-09-05,13,Primaria 4°,SuperSchool,170,7,163
2025-09-05,13,Primaria 4°,EduMax,151,10,141
2025-09-05,13,Primaria 4°,SuperSchool,237,5,232
2025-09-05,13,Primaria 4°,TopKids,188,10,178
2025-09-05,13,Primaria 4°,TopKids,197,19,178
2025-09-05,13,Primaria 4°,SuperSchool,267,11,256
2025-09-05,13,Primaria 4°,SuperSchool,128,7,121
2025-09-05,13,Primaria 4°,EduMax,265,23,242
2025-09-05,13,Primaria 4°,TopKids,274,16,258
2025-09-05,13,Primaria 4°,TopKids,119,11,108
2025-09-05,13,Primaria 5°,EduMax,155,6,149
2025-09-05,13,Primaria 5°,EduMax,263,23,240
2025-09-05,13,Primaria 5°,SuperSchool,77,9,68
2025-09-05,13,Primaria 5°,TopKids,290,12,278
2025-09-05,13,Primaria 5°,EduMax,138,11,127
2025-09-05,13,Primaria 5°,EduMax,268,24,244
2025-09-05,13,Primaria 5°,SuperSchool,284,11,273
2025-09-05,13,Primaria 5°,EduMax,193,2,191
2025-09-05,13,Primaria 5°,EduMax,246,14,232
2025-09-05,13,Primaria 5°,SuperSchool,109,10,99
2025-09-05,13,Primaria 5°,EduMax,195,20,175
2025-09-05,13,Primaria 5°,SuperSchool,213,17,196
2025-09-05,13,Primaria 5°,SuperSchool,115,14,101
2025-09-05,13,Primaria 5°,EduMax,274,23,251
2025-09-05,13,Primaria 5°,TopKids,144,4,140
2025-09-05,13,Primaria 5°,SuperSchool,52,5,47
2025-09-05,13,Primaria 5°,SuperSchool,169,10,159
2025-09-05,13,Primaria 5°,EduMax,145,4,141
2025-09-05,13,Primaria 6°,TopKids,102,17,85
2025-09-05,13,Primaria 6°,TopKids,151,1,150
2025-09-05,13,Primaria 6°,EduMax,223,13,210
2025-09-05,13,Primaria 6°,TopKids,296,2,294
2025-09-05,13,Primaria 6°,EduMax,216,12,204
2025-09-05,14,Preescolar,TopKids,289,5,284
2025-09-05,14,Preescolar,EduMax,205,17,188
2025-09-05,14,Preescolar,TopKids,63,16,47
2025-09-05,14,Preescolar,SuperSchool,100,4,96
2025-09-05,14,Preescolar,SuperSchool,101,20,81
2025-09-05,14,Preescolar,SuperSchool,234,9,225
2025-09-05,14,Kínder,SuperSchool,156,13,143
2025-09-05,14,Kínder,SuperSchool,51,22,29
2025-09-05,14,Kínder,EduMax,219,13,206
2025-09-05,14,Kínder,SuperSchool,188,15,173
2025-09-05,14,Kínder,SuperSchool,69,5,64
2025-09-05,14,Kínder,TopKids,251,2,249
2025-09-05,14,Kínder,TopKids,50,20,30
2025-09-05,14,Kínder,TopKids,178,4,174
2025-09-05,14,Kínder,TopKids,224,6,218
2025-09-05,14,Kínder,EduMax,178,7,171
2025-09-05,14,Kínder,EduMax,241,5,236
2025-09-05,14,Kínder,EduMax,98,7,91
2025-09-05,14,Kínder,TopKids,125,15,110
2025-09-05,14,Kínder,SuperSchool,198,12,186
2025-09-05,14,Kínder,SuperSchool,153,15,138
2025-09-05,14,Primaria 1°,TopKids,222,1,221
2025-09-05,14,Primaria 1°,TopKids,94,2,92
2025-09-05,14,Primaria 1°,TopKids,188,1,187
2025-09-05,14,Primaria 1°,SuperSchool,57,13,44
2025-09-05,14,Primaria 1°,EduMax,153,14,139
2025-09-05,14,Primaria 1°,EduMax,94,5,89
2025-09-05,14,Primaria 1°,SuperSchool,250,20,230
2025-09-05,14,Primaria 1°,EduMax,271,11,260
2025-09-05,14,Primaria 1°,EduMax,130,6,124
2025-09-05,14,Primaria 1°,TopKids,265,4,261
2025-09-05,14,Primaria 1°,SuperSchool,274,22,252
2025-09-05,14,Primaria 2°,TopKids,54,16,38
2025-09-05,14,Primaria 2°,EduMax,58,2,56
2025-09-05,14,Primaria 2°,SuperSchool,133,17,116
2025-09-05,14,Primaria 2°,EduMax,266,19,247
2025-09-05,14,Primaria 2°,EduMax,185,20,165
2025-09-05,14,Primaria 2°,TopKids,254,13,241
2025-09-05,14,Primaria 3°,SuperSchool,259,8,251
2025-09-05,14,Primaria 3°,SuperSchool,229,14,215
2025-09-05,14,Primaria 3°,EduMax,263,16,247
2025-09-05,14,Primaria 3°,SuperSchool,201,23,178
2025-09-05,14,Primaria 3°,SuperSchool,62,18,44
2025-09-05,14,Primaria 3°,TopKids,242,7,235
2025-09-05,14,Primaria 3°,EduMax,281,3,278
2025-09-05,14,Primaria 3°,TopKids,216,16,200
2025-09-05,14,Primaria 3°,TopKids,133,10,123
2025-09-05,14,Primaria 3°,SuperSchool,111,1,110
2025-09-05,14,Primaria 3°,TopKids,219,12,207
2025-09-05,14,Primaria 3°,EduMax,135,11,124
2025-09-05,14,Primaria 3°,SuperSchool,250,8,242
2025-09-05,14,Primaria 4°,TopKids,208,5,203
2025-09-05,14,Primaria 4°,EduMax,183,10,173
2025-09-05,14,Primaria 4°,EduMax,176,11,165
2025-09-05,14,Primaria 4°,SuperSchool,77,3,74
2025-09-05,14,Primaria 4°,EduMax,53,8,45
2025-09-05,14,Primaria 4°,SuperSchool,177,10,167
2025-09-05,14,Primaria 4°,TopKids,260,1,259
2025-09-05,14,Primaria 4°,EduMax,107,11,96
2025-09-05,14,Primaria 4°,TopKids,296,1,295
2025-09-05,14,Primaria 4°,SuperSchool,153,1,152
2025-09-05,14,Primaria 4°,EduMax,66,18,48
2025-09-05,14,Primaria 4°,EduMax,167,17,150
2025-09-05,14,Primaria 4°,TopKids,206,9,197
2025-09-05,14,Primaria 4°,EduMax,276,20,256
2025-09-05,14,Primaria 5°,SuperSchool,163,21,142
2025-09-05,14,Primaria 5°,EduMax,258,7,251
2025-09-05,14,Primaria 5°,EduMax,145,15,130
2025-09-05,14,Primaria 5°,SuperSchool,231,14,217
2025-09-05,14,Primaria 5°,SuperSchool,65,19,46
2025-09-05,14,Primaria 5°,SuperSchool,89,18,71
2025-09-05,14,Primaria 5°,EduMax,267,4,263
2025-09-05,14,Primaria 5°,SuperSchool,178,19,159
2025-09-05,14,Primaria 5°,TopKids,169,6,163
2025-09-05,14,Primaria 6°,EduMax,141,23,118
2025-09-05,14,Primaria 6°,TopKids,199,21,178
2025-09-05,14,Primaria 6°,TopKids,73,13,60
2025-09-05,14,Primaria 6°,SuperSchool,251,19,232
2025-09-05,14,Primaria 6°,TopKids,73,24,49
2025-09-05,14,Primaria 6°,TopKids,217,17,200
2025-09-05,14,Primaria 6°,TopKids,119,12,107
2025-09-05,15,Preescolar,TopKids,248,6,242
2025-09-05,15,Preescolar,TopKids,78,12,66
2025-09-05,15,Preescolar,TopKids,117,21,96
2025-09-05,15,Preescolar,SuperSchool,98,2,96
2025-09-05,15,Preescolar,SuperSchool,70,23,47
2025-09-05,15,Preescolar,EduMax,279,6,273
2025-09-05,15,Preescolar,SuperSchool,150,8,142
2025-09-05,15,Preescolar,SuperSchool,135,3,132
2025-09-05,15,Preescolar,TopKids,95,5,90
2025-09-05,15,Preescolar,TopKids,154,15,139
2025-09-05,15,Preescolar,TopKids,129,8,121
2025-09-05,15,Preescolar,TopKids,156,23,133
2025-09-05,15,Preescolar,SuperSchool,201,10,191
2025-09-05,15,Preescolar,TopKids,75,10,65
2025-09-05,15,Preescolar,EduMax,153,8,145
2025-09-05,15,Preescolar,SuperSchool,243,14,229
2025-09-05,15,Preescolar,EduMax,117,3,114
2025-09-05,15,Preescolar,TopKids,127,21,106
2025-09-05,15,Preescolar,TopKids,88,18,70
2025-09-05,15,Kínder,EduMax,205,21,184
2025-09-05,15,Kínder,TopKids,243,23,220
2025-09-05,15,Kínder,EduMax,255,9,246
2025-09-05,15,Kínder,TopKids,157,3,154
2025-09-05,15,Kínder,EduMax,54,9,45
2025-09-05,15,Kínder,SuperSchool,212,18,194
2025-09-05,15,Kínder,EduMax,245,13,232
2025-09-05,15,Kínder,SuperSchool,186,19,167
2025-09-05,15,Primaria 1°,SuperSchool,118,18,100
2025-09-05,15,Primaria 1°,TopKids,140,11,129
2025-09-05,15,Primaria 1°,EduMax,164,5,159
2025-09-05,15,Primaria 1°,TopKids,147,19,128
2025-09-05,15,Primaria 1°,EduMax,79,24,55
2025-09-05,15,Primaria 1°,TopKids,78,10,68
2025-09-05,15,Primaria 1°,TopKids,111,2,109
2025-09-05,15,Primaria 1°,SuperSchool,238,8,230
2025-09-05,15,Primaria 1°,SuperSchool,250,23,227
2025-09-05,15,Primaria 1°,SuperSchool,200,13,187
2025-09-05,15,Primaria 1°,SuperSchool,273,15,258
2025-09-05,15,Primaria 1°,SuperSchool,118,5,113
2025-09-05,15,Primaria 1°,TopKids,269,23,246
2025-09-05,15,Primaria 1°,EduMax,123,20,103
2025-09-05,15,Primaria 1°,TopKids,148,10,138
2025-09-05,15,Primaria 1°,SuperSchool,73,23,50
2025-09-05,15,Primaria 1°,TopKids,213,13,200
2025-09-05,15,Primaria 1°,EduMax,117,12,105
2025-09-05,15,Primaria 2°,TopKids,81,24,57
2025-09-05,15,Primaria 2°,SuperSchool,270,7,263
2025-09-05,15,Primaria 2°,EduMax,179,14,165
2025-09-05,15,Primaria 2°,EduMax,87,23,64
2025-09-05,15,Primaria 2°,TopKids,83,14,69
2025-09-05,15,Primaria 2°,TopKids,179,4,175
2025-09-05,15,Primaria 2°,EduMax,85,22,63
2025-09-05,15,Primaria 2°,SuperSchool,215,9,206
2025-09-05,15,Primaria 2°,EduMax,199,16,183
2025-09-05,15,Primaria 2°,TopKids,156,24,132
2025-09-05,15,Primaria 2°,TopKids,102,21,81
2025-09-05,15,Primaria 2°,EduMax,142,1,141
2025-09-05,15,Primaria 2°,EduMax,226,8,218
2025-09-05,15,Primaria 2°,EduMax,289,6,283
2025-09-05,15,Primaria 3°,SuperSchool,147,9,138
2025-09-05,15,Primaria 3°,TopKids,196,17,179
2025-09-05,15,Primaria 3°,SuperSchool,265,2,263
2025-09-05,15,Primaria 3°,SuperSchool,83,3,80
2025-09-05,15,Primaria 3°,SuperSchool,108,23,85
2025-09-05,15,Primaria 3°,SuperSchool,150,14,136
2025-09-05,15,Primaria 3°,EduMax,242,16,226
2025-09-05,15,Primaria 3°,EduMax,286,13,273
2025-09-05,15,Primaria 3°,TopKids,129,22,107
2025-09-05,15,Primaria 3°,EduMax,188,5,183
2025-09-05,15,Primaria 3°,EduMax,234,10,224
2025-09-05,15,Primaria 3°,SuperSchool,234,15,219
2025-09-05,15,Primaria 3°,TopKids,240,3,237
2025-09-05,15,Primaria 3°,TopKids,250,10,240
2025-09-05,15,Primaria 3°,TopKids,117,22,95
2025-09-05,15,Primaria 3°,SuperSchool,293,18,275
2025-09-05,15,Primaria 3°,SuperSchool,287,9,278
2025-09-05,15,Primaria 3°,EduMax,77,20,57
2025-09-05,15,Primaria 4°,EduMax,72,7,65
2025-09-05,15,Primaria 4°,SuperSchool,70,24,46
2025-09-05,15,Primaria 4°,EduMax,226,11,215
2025-09-05,15,Primaria 4°,EduMax,141,4,137
2025-09-05,15,Primaria 4°,SuperSchool,134,5,129
2025-09-05,15,Primaria 4°,TopKids,266,24,242
2025-09-05,15,Primaria 4°,EduMax,177,10,167
2025-09-05,15,Primaria 4°,EduMax,148,21,127
2025-09-05,15,Primaria 4°,EduMax,262,8,254
2025-09-05,15,Primaria 4°,SuperSchool,89,10,79
2025-09-05,15,Primaria 4°,TopKids,299,19,280
2025-09-05,15,Primaria 4°,SuperSchool,213,6,207
2025-09-05,15,Primaria 4°,TopKids,109,4,105
2025-09-05,15,Primaria 4°,TopKids,149,5,144
2025-09-05,15,Primaria 4°,TopKids,96,16,80
2025-09-05,15,Primaria 5°,EduMax,75,12,63
2025-09-05,15,Primaria 5°,TopKids,168,12,156
2025-09-05,15,Primaria 5°,EduMax,190,11,179
2025-09-05,15,Primaria 5°,TopKids,115,14,101
2025-09-05,15,Primaria 5°,TopKids,264,1,263
2025-09-05,15,Primaria 5°,EduMax,227,21,206
2025-09-05,15,Primaria 5°,TopKids,212,12,200
2025-09-05,15,Primaria 5°,SuperSchool,182,3,179
2025-09-05,15,Primaria 5°,TopKids,193,20,173
2025-09-05,15,Primaria 5°,SuperSchool,198,8,190
2025-09-05,15,Primaria 6°,TopKids,72,8,64
2025-09-05,15,Primaria 6°,SuperSchool,188,21,167
2025-09-05,15,Primaria 6°,EduMax,168,10,158
2025-09-05,15,Primaria 6°,EduMax,250,16,234
2025-09-05,15,Primaria 6°,SuperSchool,263,6,257
2025-09-05,15,Primaria 6°,EduMax,104,2,102
2025-09-05,15,Primaria 6°,SuperSchool,135,6,129
2025-09-05,15,Primaria 6°,SuperSchool,287,24,263
2025-09-05,15,Primaria 6°,SuperSchool,152,23,129
2025-09-05,15,Primaria 6°,SuperSchool,184,3,181
2025-09-05,15,Primaria 6°,TopKids,190,22,168
2025-09-05,15,Primaria 6°,TopKids,125,6,119
2025-09-05,15,Primaria 6°,EduMax,256,15,241
2025-09-05,15,Primaria 6°,EduMax,104,17,87
2025-09-05,15,Primaria 6°,SuperSchool,52,22,30
2025-09-05,15,Primaria 6°,TopKids,77,9,68
2025-09-05,15,Primaria 6°,EduMax,189,23,166
2025-09-05,15,Primaria 6°,SuperSchool,149,21,128
2025-09-05,15,Primaria 6°,TopKids,72,5,67
2025-09-05,16,Preescolar,SuperSchool,166,5,161
2025-09-05,16,Preescolar,SuperSchool,103,15,88
2025-09-05,16,Preescolar,EduMax,182,14,168
2025-09-05,16,Preescolar,TopKids,77,21,56
2025-09-05,16,Preescolar,SuperSchool,292,8,284
2025-09-05,16,Preescolar,EduMax,164,19,145
2025-09-05,16,Preescolar,EduMax,89,10,79
2025-09-05,16,Preescolar,SuperSchool,130,1,129
2025-09-05,16,Preescolar,TopKids,157,22,135
2025-09-05,16,Preescolar,EduMax,258,7,251
2025-09-05,16,Preescolar,EduMax,63,12,51
2025-09-05,16,Preescolar,EduMax,89,2,87
2025-09-05,16,Preescolar,TopKids,114,10,104
2025-09-05,16,Preescolar,EduMax,161,2,159
2025-09-05,16,Preescolar,TopKids,226,16,210
2025-09-05,16,Preescolar,TopKids,278,23,255
2025-09-05,16,Kínder,EduMax,201,17,184
2025-09-05,16,Kínder,TopKids,225,9,216
2025-09-05,16,Kínder,TopKids,119,16,103
2025-09-05,16,Kínder,SuperSchool,78,4,74
2025-09-05,16,Kínder,EduMax,167,6,161
2025-09-05,16,Kínder,EduMax,203,14,189
2025-09-05,16,Kínder,TopKids,296,17,279
2025-09-05,16,Kínder,TopKids,137,8,129
2025-09-05,16,Kínder,SuperSchool,240,4,236
2025-09-05,16,Kínder,TopKids,65,22,43
2025-09-05,16,Kínder,TopKids,60,7,53
2025-09-05,16,Kínder,EduMax,177,6,171
2025-09-05,16,Kínder,TopKids,117,5,112
2025-09-05,16,Kínder,TopKids,183,14,169
2025-09-05,16,Kínder,SuperSchool,165,14,151
2025-09-05,16,Kínder,EduMax,148,17,131
2025-09-05,16,Kínder,EduMax,273,14,259
2025-09-05,16,Kínder,TopKids,265,7,258
2025-09-05,16,Primaria 1°,TopKids,222,24,198
2025-09-05,16,Primaria 1°,TopKids,294,24,270
2025-09-05,16,Primaria 1°,EduMax,201,11,190
2025-09-05,16,Primaria 1°,TopKids,221,15,206
2025-09-05,16,Primaria 1°,EduMax,295,2,293
2025-09-05,16,Primaria 1°,SuperSchool,123,17,106
2025-09-05,16,Primaria 1°,SuperSchool,298,22,276
2025-09-05,16,Primaria 1°,EduMax,263,6,257
2025-09-05,16,Primaria 1°,TopKids,197,1,196
2025-09-05,16,Primaria 1°,SuperSchool,50,5,45
2025-09-05,16,Primaria 1°,SuperSchool,256,23,233
2025-09-05,16,Primaria 1°,SuperSchool,258,14,244
2025-09-05,16,Primaria 1°,SuperSchool,109,11,98
2025-09-05,16,Primaria 1°,EduMax,156,2,154
2025-09-05,16,Primaria 1°,EduMax,189,23,166
2025-09-05,16,Primaria 2°,SuperSchool,185,18,167
2025-09-05,16,Primaria 2°,EduMax,72,21,51
2025-09-05,16,Primaria 2°,SuperSchool,108,10,98
2025-09-05,16,Primaria 2°,EduMax,174,20,154
2025-09-05,16,Primaria 2°,EduMax,123,14,109
2025-09-05,16,Primaria 2°,TopKids,261,9,252
2025-09-05,16,Primaria 2°,TopKids,56,20,36
2025-09-05,16,Primaria 2°,SuperSchool,265,10,255
2025-09-05,16,Primaria 2°,SuperSchool,87,4,83
2025-09-05,16,Primaria 2°,SuperSchool,134,14,120
2025-09-05,16,Primaria 2°,TopKids,244,1,243
2025-09-05,16,Primaria 2°,EduMax,179,8,171
2025-09-05,16,Primaria 2°,TopKids,261,10,251
2025-09-05,16,Primaria 2°,SuperSchool,226,21,205
2025-09-05,16,Primaria 2°,TopKids,58,7,51
2025-09-05,16,Primaria 2°,TopKids,198,3,195
2025-09-05,16,Primaria 2°,TopKids,213,17,196
2025-09-05,16,Primaria 2°,SuperSchool,116,11,105
2025-09-05,16,Primaria 2°,EduMax,170,14,156
2025-09-05,16,Primaria 3°,TopKids,97,14,83
2025-09-05,16,Primaria 3°,TopKids,123,12,111
2025-09-05,16,Primaria 3°,TopKids,281,23,258
2025-09-05,16,Primaria 3°,TopKids,229,13,216
2025-09-05,16,Primaria 3°,TopKids,102,12,90
2025-09-05,16,Primaria 3°,EduMax,248,19,229
2025-09-05,16,Primaria 3°,EduMax,204,7,197
2025-09-05,16,Primaria 3°,TopKids,99,24,75
2025-09-05,16,Primaria 4°,SuperSchool,93,4,89
2025-09-05,16,Primaria 4°,SuperSchool,146,5,141
2025-09-05,16,Primaria 4°,EduMax,152,20,132
2025-09-05,16,Primaria 4°,SuperSchool,240,7,233
2025-09-05,16,Primaria 4°,EduMax,237,13,224
2025-09-05,16,Primaria 4°,EduMax,86,21,65
2025-09-05,16,Primaria 4°,EduMax,95,21,74
2025-09-05,16,Primaria 4°,EduMax,121,20,101
2025-09-05,16,Primaria 4°,EduMax,78,5,73
2025-09-05,16,Primaria 4°,EduMax,253,7,246
2025-09-05,16,Primaria 4°,TopKids,294,13,281
2025-09-05,16,Primaria 5°,EduMax,85,16,69
2025-09-05,16,Primaria 5°,TopKids,286,4,282
2025-09-05,16,Primaria 5°,EduMax,157,20,137
2025-09-05,16,Primaria 5°,TopKids,211,5,206
2025-09-05,16,Primaria 5°,TopKids,206,2,204
2025-09-05,16,Primaria 5°,SuperSchool,279,3,276
2025-09-05,16,Primaria 5°,SuperSchool,287,10,277
2025-09-05,16,Primaria 5°,TopKids,118,22,96
2025-09-05,16,Primaria 5°,SuperSchool,102,16,86
2025-09-05,16,Primaria 5°,SuperSchool,290,12,278
2025-09-05,16,Primaria 5°,TopKids,91,4,87
2025-09-05,16,Primaria 5°,SuperSchool,259,18,241
2025-09-05,16,Primaria 5°,EduMax,220,21,199
2025-09-05,16,Primaria 5°,SuperSchool,219,3,216
2025-09-05,16,Primaria 5°,TopKids,279,17,262
2025-09-05,16,Primaria 5°,TopKids,130,3,127
2025-09-05,16,Primaria 5°,SuperSchool,227,6,221
2025-09-05,16,Primaria 5°,TopKids,55,11,44
2025-09-05,16,Primaria 5°,TopKids,88,13,75
2025-09-05,16,Primaria 6°,TopKids,223,2,221
2025-09-05,16,Primaria 6°,TopKids,209,4,205
2025-09-05,16,Primaria 6°,SuperSchool,114,9,105
2025-09-05,16,Primaria 6°,SuperSchool,291,7,284
2025-09-05,16,Primaria 6°,TopKids,52,22,30
2025-09-05,16,Primaria 6°,SuperSchool,98,19,79
2025-09-05,16,Primaria 6°,TopKids,291,22,269
2025-09-05,16,Primaria 6°,EduMax,150,7,143
2025-09-05,16,Primaria 6°,EduMax,271,13,258
2025-09-05,16,Primaria 6°,EduMax,252,5,247
2025-09-05,16,Primaria 6°,EduMax,256,21,235
2025-09-05,16,Primaria 6°,TopKids,86,7,79
2025-09-05,16,Primaria 6°,SuperSchool,176,9,167
2025-09-05,16,Primaria 6°,EduMax,154,17,137
2025-09-05,16,Primaria 6°,EduMax,136,20,116
2025-09-05,16,Primaria 6°,EduMax,62,17,45
2025-09-05,16,Primaria 6°,SuperSchool,197,6,191
2025-09-08,9,Preescolar,TopKids,208,19,189
2025-09-08,9,Preescolar,EduMax,147,13,134
2025-09-08,9,Preescolar,EduMax,123,9,114
2025-09-08,9,Preescolar,SuperSchool,184,18,166
2025-09-08,9,Preescolar,EduMax,63,4,59
2025-09-08,9,Preescolar,SuperSchool,265,10,255
2025-09-08,9,Preescolar,TopKids,239,14,225
2025-09-08,9,Preescolar,SuperSchool,100,5,95
2025-09-08,9,Preescolar,TopKids,244,1,243
2025-09-08,9,Preescolar,SuperSchool,150,1,149
2025-09-08,9,Preescolar,SuperSchool,298,14,284
2025-09-08,9,Preescolar,SuperSchool,250,3,247
2025-09-08,9,Preescolar,TopKids,62,20,42
2025-09-08,9,Preescolar,SuperSchool,87,14,73
2025-09-08,9,Preescolar,EduMax,299,17,282
2025-09-08,9,Preescolar,SuperSchool,213,23,190
2025-09-08,9,Preescolar,TopKids,167,18,149
2025-09-08,9,Kínder,TopKids,163,7,156
2025-09-08,9,Kínder,TopKids,138,5,133
2025-09-08,9,Kínder,TopKids,124,24,100
2025-09-08,9,Kínder,EduMax,185,4,181
2025-09-08,9,Kínder,EduMax,88,1,87
2025-09-08,9,Kínder,SuperSchool,129,14,115
2025-09-08,9,Kínder,SuperSchool,86,14,72
2025-09-08,9,Kínder,EduMax,190,14,176
2025-09-08,9,Kínder,TopKids,205,22,183
2025-09-08,9,Kínder,TopKids,196,11,185
2025-09-08,9,Kínder,EduMax,231,15,216
2025-09-08,9,Kínder,EduMax,78,21,57
2025-09-08,9,Kínder,EduMax,157,19,138
2025-09-08,9,Kínder,EduMax,282,16,266
2025-09-08,9,Kínder,TopKids,77,19,58
2025-09-08,9,Kínder,TopKids,66,21,45
2025-09-08,9,Kínder,SuperSchool,285,19,266
2025-09-08,9,Kínder,EduMax,274,4,270
2025-09-08,9,Kínder,TopKids,267,18,249
2025-09-08,9,Primaria 1°,TopKids,257,10,247
2025-09-08,9,Primaria 1°,EduMax,210,10,200
2025-09-08,9,Primaria 1°,EduMax,109,10,99
2025-09-08,9,Primaria 1°,SuperSchool,51,20,31
2025-09-08,9,Primaria 1°,TopKids,81,1,80
2025-09-08,9,Primaria 1°,EduMax,220,24,196
2025-09-08,9,Primaria 1°,SuperSchool,87,16,71
2025-09-08,9,Primaria 1°,TopKids,66,16,50
2025-09-08,9,Primaria 1°,TopKids,97,12,85
2025-09-08,9,Primaria 2°,TopKids,136,6,130
2025-09-08,9,Primaria 2°,TopKids,253,2,251
2025-09-08,9,Primaria 2°,EduMax,132,15,117
2025-09-08,9,Primaria 2°,TopKids,200,16,184
2025-09-08,9,Primaria 2°,SuperSchool,271,13,258
2025-09-08,9,Primaria 3°,SuperSchool,61,10,51
2025-09-08,9,Primaria 3°,TopKids,130,1,129
2025-09-08,9,Primaria 3°,EduMax,64,16,48
2025-09-08,9,Primaria 3°,TopKids,59,10,49
2025-09-08,9,Primaria 3°,EduMax,98,22,76
2025-09-08,9,Primaria 3°,TopKids,241,17,224
2025-09-08,9,Primaria 3°,EduMax,154,22,132
2025-09-08,9,Primaria 3°,TopKids,181,7,174
2025-09-08,9,Primaria 3°,SuperSchool,144,19,125
2025-09-08,9,Primaria 3°,EduMax,175,22,153
2025-09-08,9,Primaria 3°,TopKids,264,4,260
2025-09-08,9,Primaria 4°,TopKids,255,17,238
2025-09-08,9,Primaria 4°,SuperSchool,164,3,161
2025-09-08,9,Primaria 4°,TopKids,262,1,261
2025-09-08,9,Primaria 4°,EduMax,164,4,160
2025-09-08,9,Primaria 4°,EduMax,195,12,183
2025-09-08,9,Primaria 4°,EduMax,91,4,87
2025-09-08,9,Primaria 4°,SuperSchool,116,7,109
2025-09-08,9,Primaria 4°,EduMax,148,22,126
2025-09-08,9,Primaria 4°,TopKids,256,6,250
2025-09-08,9,Primaria 4°,SuperSchool,275,10,265
2025-09-08,9,Primaria 4°,TopKids,77,6,71
2025-09-08,9,Primaria 4°,EduMax,160,16,144
2025-09-08,9,Primaria 4°,EduMax,126,16,110
2025-09-08,9,Primaria 4°,EduMax,197,12,185
2025-09-08,9,Primaria 4°,SuperSchool,287,8,279
2025-09-08,9,Primaria 4°,EduMax,287,24,263
2025-09-08,9,Primaria 4°,TopKids,261,3,258
2025-09-08,9,Primaria 4°,TopKids,80,16,64
2025-09-08,9,Primaria 5°,EduMax,145,17,128
2025-09-08,9,Primaria 5°,TopKids,73,3,70
2025-09-08,9,Primaria 5°,EduMax,200,8,192
2025-09-08,9,Primaria 5°,EduMax,136,21,115
2025-09-08,9,Primaria 5°,TopKids,208,18,190
2025-09-08,9,Primaria 5°,TopKids,161,24,137
2025-09-08,9,Primaria 5°,EduMax,185,13,172
2025-09-08,9,Primaria 5°,TopKids,211,13,198
2025-09-08,9,Primaria 5°,SuperSchool,167,3,164
2025-09-08,9,Primaria 5°,SuperSchool,114,2,112
2025-09-08,9,Primaria 5°,SuperSchool,91,11,80
2025-09-08,9,Primaria 6°,TopKids,265,8,257
2025-09-08,9,Primaria 6°,TopKids,214,8,206
2025-09-08,9,Primaria 6°,EduMax,195,12,183
2025-09-08,9,Primaria 6°,EduMax,133,24,109
2025-09-08,9,Primaria 6°,TopKids,153,12,141
2025-09-08,9,Primaria 6°,EduMax,175,17,158
2025-09-08,9,Primaria 6°,EduMax,223,6,217
2025-09-08,9,Primaria 6°,SuperSchool,187,24,163
2025-09-08,9,Primaria 6°,EduMax,210,7,203
2025-09-08,9,Primaria 6°,TopKids,94,16,78
2025-09-08,9,Primaria 6°,SuperSchool,132,6,126
2025-09-08,9,Primaria 6°,TopKids,202,17,185
2025-09-08,9,Primaria 6°,SuperSchool,100,5,95
2025-09-08,9,Primaria 6°,TopKids,73,22,51
2025-09-08,10,Preescolar,SuperSchool,267,21,246
2025-09-08,10,Preescolar,TopKids,234,9,225
2025-09-08,10,Preescolar,SuperSchool,292,13,279
2025-09-08,10,Preescolar,EduMax,198,4,194
2025-09-08,10,Preescolar,SuperSchool,273,18,255
2025-09-08,10,Preescolar,SuperSchool,176,12,164
2025-09-08,10,Kínder,EduMax,162,23,139
2025-09-08,10,Kínder,TopKids,137,10,127
2025-09-08,10,Kínder,EduMax,98,8,90
2025-09-08,10,Kínder,EduMax,93,3,90
2025-09-08,10,Kínder,SuperSchool,106,23,83
2025-09-08,10,Kínder,EduMax,120,1,119
2025-09-08,10,Primaria 1°,TopKids,249,10,239
2025-09-08,10,Primaria 1°,SuperSchool,97,10,87
2025-09-08,10,Primaria 1°,TopKids,225,18,207
2025-09-08,10,Primaria 1°,SuperSchool,152,12,140
2025-09-08,10,Primaria 1°,TopKids,253,23,230
2025-09-08,10,Primaria 2°,SuperSchool,294,24,270
2025-09-08,10,Primaria 2°,TopKids,112,7,105
2025-09-08,10,Primaria 2°,TopKids,179,1,178
2025-09-08,10,Primaria 2°,EduMax,98,18,80
2025-09-08,10,Primaria 2°,TopKids,214,6,208
2025-09-08,10,Primaria 2°,SuperSchool,256,8,248
2025-09-08,10,Primaria 2°,EduMax,290,14,276
2025-09-08,10,Primaria 2°,TopKids,165,5,160
2025-09-08,10,Primaria 2°,SuperSchool,298,6,292
2025-09-08,10,Primaria 3°,EduMax,111,3,108
2025-09-08,10,Primaria 3°,EduMax,147,18,129
2025-09-08,10,Primaria 3°,TopKids,216,5,211
2025-09-08,10,Primaria 3°,EduMax,130,12,118
2025-09-08,10,Primaria 3°,SuperSchool,112,11,101
2025-09-08,10,Primaria 3°,SuperSchool,90,8,82
2025-09-08,10,Primaria 3°,EduMax,53,11,42
2025-09-08,10,Primaria 3°,SuperSchool,204,8,196
2025-09-08,10,Primaria 3°,SuperSchool,274,18,256
2025-09-08,10,Primaria 3°,TopKids,54,8,46
2025-09-08,10,Primaria 3°,TopKids,75,8,67
2025-09-08,10,Primaria 3°,SuperSchool,250,18,232
2025-09-08,10,Primaria 3°,TopKids,155,21,134
2025-09-08,10,Primaria 3°,TopKids,145,10,135
2025-09-08,10,Primaria 3°,EduMax,273,8,265
2025-09-08,10,Primaria 3°,EduMax,53,12,41
2025-09-08,10,Primaria 3°,SuperSchool,278,4,274
2025-09-08,10,Primaria 3°,TopKids,228,19,209
2025-09-08,10,Primaria 4°,TopKids,80,12,68
2025-09-08,10,Primaria 4°,EduMax,158,6,152
2025-09-08,10,Primaria 4°,SuperSchool,66,20,46
2025-09-08,10,Primaria 4°,EduMax,159,15,144
2025-09-08,10,Primaria 4°,EduMax,247,16,231
2025-09-08,10,Primaria 4°,EduMax,251,5,246
2025-09-08,10,Primaria 4°,TopKids,282,19,263
2025-09-08,10,Primaria 4°,TopKids,90,16,74
2025-09-08,10,Primaria 4°,SuperSchool,164,20,144
2025-09-08,10,Primaria 5°,SuperSchool,277,5,272
2025-09-08,10,Primaria 5°,EduMax,121,13,108
2025-09-08,10,Primaria 5°,SuperSchool,123,4,119
2025-09-08,10,Primaria 5°,TopKids,208,4,204
2025-09-08,10,Primaria 5°,SuperSchool,158,23,135
2025-09-08,10,Primaria 5°,SuperSchool,60,2,58
2025-09-08,10,Primaria 5°,EduMax,182,13,169
2025-09-08,10,Primaria 5°,EduMax,241,3,238
2025-09-08,10,Primaria 5°,TopKids,78,23,55
2025-09-08,10,Primaria 5°,TopKids,129,16,113
2025-09-08,10,Primaria 5°,EduMax,52,23,29
2025-09-08,10,Primaria 5°,SuperSchool,186,19,167
2025-09-08,10,Primaria 5°,SuperSchool,255,24,231
2025-09-08,10,Primaria 5°,TopKids,99,20,79
2025-09-08,10,Primaria 5°,TopKids,87,12,75
2025-09-08,10,Primaria 5°,SuperSchool,175,24,151
2025-09-08,10,Primaria 6°,SuperSchool,229,1,228
2025-09-08,10,Primaria 6°,TopKids,288,20,268
2025-09-08,10,Primaria 6°,EduMax,113,15,98
2025-09-08,10,Primaria 6°,EduMax,220,8,212
2025-09-08,10,Primaria 6°,SuperSchool,62,1,61
2025-09-08,10,Primaria 6°,SuperSchool,227,5,222
2025-09-08,11,Preescolar,SuperSchool,166,16,150
2025-09-08,11,Preescolar,TopKids,291,2,289
2025-09-08,11,Preescolar,TopKids,112,22,90
2025-09-08,11,Preescolar,EduMax,60,10,50
2025-09-08,11,Preescolar,TopKids,222,13,209
2025-09-08,11,Kínder,TopKids,123,4,119
2025-09-08,11,Kínder,EduMax,264,17,247
2025-09-08,11,Kínder,SuperSchool,234,15,219
2025-09-08,11,Kínder,EduMax,166,2,164
2025-09-08,11,Kínder,EduMax,241,7,234
2025-09-08,11,Kínder,EduMax,77,13,64
2025-09-08,11,Kínder,TopKids,52,13,39
2025-09-08,11,Kínder,SuperSchool,203,4,199
2025-09-08,11,Kínder,EduMax,153,16,137
2025-09-08,11,Kínder,TopKids,136,2,134
2025-09-08,11,Kínder,SuperSchool,140,13,127
2025-09-08,11,Kínder,EduMax,236,22,214
2025-09-08,11,Primaria 1°,EduMax,122,1,121
2025-09-08,11,Primaria 1°,EduMax,233,2,231
2025-09-08,11,Primaria 1°,TopKids,299,15,284
2025-09-08,11,Primaria 1°,EduMax,248,13,235
2025-09-08,11,Primaria 1°,SuperSchool,268,12,256
2025-09-08,11,Primaria 1°,SuperSchool,198,11,187
2025-09-08,11,Primaria 1°,EduMax,267,7,260
2025-09-08,11,Primaria 1°,SuperSchool,283,10,273
2025-09-08,11,Primaria 1°,SuperSchool,136,19,117
2025-09-08,11,Primaria 1°,EduMax,168,17,151
2025-09-08,11,Primaria 1°,TopKids,133,7,126
2025-09-08,11,Primaria 1°,TopKids,181,17,164
2025-09-08,11,Primaria 1°,TopKids,143,24,119
2025-09-08,11,Primaria 1°,EduMax,133,8,125
2025-09-08,11,Primaria 1°,SuperSchool,161,15,146
2025-09-08,11,Primaria 1°,EduMax,200,19,181
2025-09-08,11,Primaria 2°,SuperSchool,238,16,222
2025-09-08,11,Primaria 2°,SuperSchool,58,20,38
2025-09-08,11,Primaria 2°,SuperSchool,162,4,158
2025-09-08,11,Primaria 2°,TopKids,220,14,206
2025-09-08,11,Primaria 2°,SuperSchool,77,13,64
2025-09-08,11,Primaria 2°,SuperSchool,233,16,217
2025-09-08,11,Primaria 2°,EduMax,64,7,57
2025-09-08,11,Primaria 2°,SuperSchool,112,11,101
2025-09-08,11,Primaria 2°,SuperSchool,52,7,45
2025-09-08,11,Primaria 2°,EduMax,150,9,141
2025-09-08,11,Primaria 3°,TopKids,190,19,171
2025-09-08,11,Primaria 3°,EduMax,242,3,239
2025-09-08,11,Primaria 3°,EduMax,179,24,155
2025-09-08,11,Primaria 3°,SuperSchool,86,12,74
2025-09-08,11,Primaria 3°,EduMax,258,12,246
2025-09-08,11,Primaria 3°,SuperSchool,130,20,110
2025-09-08,11,Primaria 3°,TopKids,142,9,133
2025-09-08,11,Primaria 3°,EduMax,155,6,149
2025-09-08,11,Primaria 4°,SuperSchool,145,2,143
2025-09-08,11,Primaria 4°,EduMax,80,23,57
2025-09-08,11,Primaria 4°,TopKids,270,1,269
2025-09-08,11,Primaria 4°,EduMax,268,21,247
2025-09-08,11,Primaria 4°,TopKids,188,21,167
2025-09-08,11,Primaria 5°,EduMax,95,1,94
2025-09-08,11,Primaria 5°,TopKids,119,7,112
2025-09-08,11,Primaria 5°,EduMax,51,15,36
2025-09-08,11,Primaria 5°,SuperSchool,118,13,105
2025-09-08,11,Primaria 5°,TopKids,132,15,117
2025-09-08,11,Primaria 5°,SuperSchool,276,18,258
2025-09-08,11,Primaria 5°,SuperSchool,298,21,277
2025-09-08,11,Primaria 6°,TopKids,197,8,189
2025-09-08,11,Primaria 6°,SuperSchool,151,6,145
2025-09-08,11,Primaria 6°,EduMax,51,10,41
2025-09-08,11,Primaria 6°,EduMax,122,23,99
2025-09-08,11,Primaria 6°,TopKids,115,4,111
2025-09-08,11,Primaria 6°,SuperSchool,75,2,73
2025-09-08,11,Primaria 6°,EduMax,151,8,143
2025-09-08,11,Primaria 6°,TopKids,124,20,104
2025-09-08,11,Primaria 6°,SuperSchool,253,23,230
2025-09-08,11,Primaria 6°,EduMax,204,11,193
2025-09-08,11,Primaria 6°,SuperSchool,69,20,49
2025-09-08,11,Primaria 6°,SuperSchool,180,9,171
2025-09-08,12,Preescolar,EduMax,241,12,229
2025-09-08,12,Preescolar,TopKids,245,24,221
2025-09-08,12,Preescolar,TopKids,201,20,181
2025-09-08,12,Preescolar,TopKids,51,23,28
2025-09-08,12,Preescolar,SuperSchool,119,7,112
2025-09-08,12,Preescolar,EduMax,259,13,246
2025-09-08,12,Preescolar,SuperSchool,102,19,83
2025-09-08,12,Preescolar,SuperSchool,269,11,258
2025-09-08,12,Preescolar,SuperSchool,51,6,45
2025-09-08,12,Preescolar,EduMax,296,8,288
2025-09-08,12,Preescolar,SuperSchool,105,24,81
2025-09-08,12,Preescolar,EduMax,101,23,78
2025-09-08,12,Preescolar,SuperSchool,250,4,246
2025-09-08,12,Preescolar,SuperSchool,285,4,281
2025-09-08,12,Preescolar,SuperSchool,101,2,99
2025-09-08,12,Preescolar,EduMax,190,15,175
2025-09-08,12,Kínder,EduMax,154,22,132
2025-09-08,12,Kínder,TopKids,104,12,92
2025-09-08,12,Kínder,SuperSchool,169,2,167
2025-09-08,12,Kínder,EduMax,220,8,212
2025-09-08,12,Kínder,EduMax,259,22,237
2025-09-08,12,Kínder,SuperSchool,124,24,100
2025-09-08,12,Kínder,EduMax,58,22,36
2025-09-08,12,Kínder,EduMax,292,21,271
2025-09-08,12,Kínder,EduMax,101,19,82
2025-09-08,12,Kínder,EduMax,223,5,218
2025-09-08,12,Kínder,TopKids,243,15,228
2025-09-08,12,Kínder,EduMax,111,8,103
2025-09-08,12,Primaria 1°,TopKids,151,11,140
2025-09-08,12,Primaria 1°,EduMax,122,17,105
2025-09-08,12,Primaria 1°,TopKids,206,2,204
2025-09-08,12,Primaria 1°,SuperSchool,251,22,229
2025-09-08,12,Primaria 1°,TopKids,219,24,195
2025-09-08,12,Primaria 1°,EduMax,208,23,185
2025-09-08,12,Primaria 1°,EduMax,179,7,172
2025-09-08,12,Primaria 1°,SuperSchool,265,12,253
2025-09-08,12,Primaria 1°,SuperSchool,122,12,110
2025-09-08,12,Primaria 1°,TopKids,285,3,282
2025-09-08,12,Primaria 1°,TopKids,137,1,136
2025-09-08,12,Primaria 1°,EduMax,215,11,204
2025-09-08,12,Primaria 1°,EduMax,89,22,67
2025-09-08,12,Primaria 1°,TopKids,240,12,228
2025-09-08,12,Primaria 1°,TopKids,69,23,46
2025-09-08,12,Primaria 1°,SuperSchool,220,18,202
2025-09-08,12,Primaria 1°,SuperSchool,288,22,266
2025-09-08,12,Primaria 1°,EduMax,89,4,85
2025-09-08,12,Primaria 2°,SuperSchool,96,8,88
2025-09-08,12,Primaria 2°,TopKids,200,23,177
2025-09-08,12,Primaria 2°,TopKids,126,7,119
2025-09-08,12,Primaria 2°,EduMax,153,2,151
2025-09-08,12,Primaria 2°,TopKids,155,7,148
2025-09-08,12,Primaria 2°,TopKids,56,4,52
2025-09-08,12,Primaria 2°,SuperSchool,232,8,224
2025-09-08,12,Primaria 2°,TopKids,167,12,155
2025-09-08,12,Primaria 2°,SuperSchool,187,14,173
2025-09-08,12,Primaria 2°,TopKids,285,21,264
2025-09-08,12,Primaria 2°,SuperSchool,181,19,162
2025-09-08,12,Primaria 2°,SuperSchool,120,21,99
2025-09-08,12,Primaria 2°,SuperSchool,249,11,238
2025-09-08,12,Primaria 2°,SuperSchool,74,1,73
2025-09-08,12,Primaria 2°,EduMax,85,11,74
2025-09-08,12,Primaria 3°,SuperSchool,146,10,136
2025-09-08,12,Primaria 3°,SuperSchool,74,4,70
2025-09-08,12,Primaria 3°,TopKids,106,7,99
2025-09-08,12,Primaria 3°,EduMax,135,13,122
2025-09-08,12,Primaria 3°,EduMax,100,4,96
2025-09-08,12,Primaria 3°,EduMax,236,22,214
2025-09-08,12,Primaria 3°,SuperSchool,203,24,179
2025-09-08,12,Primaria 3°,SuperSchool,51,20,31
2025-09-08,12,Primaria 3°,TopKids,55,18,37
2025-09-08,12,Primaria 3°,TopKids,168,22,146
2025-09-08,12,Primaria 3°,TopKids,104,16,88
2025-09-08,12,Primaria 3°,EduMax,274,10,264
2025-09-08,12,Primaria 3°,EduMax,198,6,192
2025-09-08,12,Primaria 3°,EduMax,200,4,196
2025-09-08,12,Primaria 3°,EduMax,170,17,153
2025-09-08,12,Primaria 3°,TopKids,139,2,137
2025-09-08,12,Primaria 3°,EduMax,259,17,242
2025-09-08,12,Primaria 3°,SuperSchool,164,10,154
2025-09-08,12,Primaria 4°,EduMax,137,4,133
2025-09-08,12,Primaria 4°,SuperSchool,225,19,206
2025-09-08,12,Primaria 4°,EduMax,165,15,150
2025-09-08,12,Primaria 4°,TopKids,148,20,128
2025-09-08,12,Primaria 4°,TopKids,248,18,230
2025-09-08,12,Primaria 4°,TopKids,63,18,45
2025-09-08,12,Primaria 4°,SuperSchool,297,20,277
2025-09-08,12,Primaria 4°,EduMax,94,1,93
2025-09-08,12,Primaria 4°,TopKids,88,23,65
2025-09-08,12,Primaria 5°,EduMax,275,7,268
2025-09-08,12,Primaria 5°,TopKids,263,20,243
2025-09-08,12,Primaria 5°,TopKids,202,14,188
2025-09-08,12,Primaria 5°,SuperSchool,194,16,178
2025-09-08,12,Primaria 5°,SuperSchool,262,24,238
2025-09-08,12,Primaria 5°,TopKids,172,3,169
2025-09-08,12,Primaria 5°,EduMax,101,19,82
2025-09-08,12,Primaria 5°,EduMax,106,14,92
2025-09-08,12,Primaria 5°,TopKids,102,19,83
2025-09-08,12,Primaria 5°,SuperSchool,190,6,184
2025-09-08,12,Primaria 5°,SuperSchool,293,1,292
2025-09-08,12,Primaria 5°,EduMax,148,6,142
2025-09-08,12,Primaria 5°,EduMax,125,3,122
2025-09-08,12,Primaria 5°,TopKids,67,21,46
2025-09-08,12,Primaria 5°,TopKids,241,5,236
2025-09-08,12,Primaria 6°,SuperSchool,105,18,87
2025-09-08,12,Primaria 6°,EduMax,233,10,223
2025-09-08,12,Primaria 6°,TopKids,219,21,198
2025-09-08,12,Primaria 6°,EduMax,251,22,229
2025-09-08,12,Primaria 6°,EduMax,176,4,172
2025-09-08,12,Primaria 6°,TopKids,244,17,227
2025-09-08,12,Primaria 6°,SuperSchool,269,22,247
2025-09-08,13,Preescolar,SuperSchool,62,9,53
2025-09-08,13,Preescolar,SuperSchool,224,19,205
2025-09-08,13,Preescolar,SuperSchool,194,15,179
2025-09-08,13,Preescolar,EduMax,117,7,110
2025-09-08,13,Preescolar,SuperSchool,178,5,173
2025-09-08,13,Preescolar,TopKids,178,3,175
2025-09-08,13,Preescolar,EduMax,270,17,253
2025-09-08,13,Preescolar,EduMax,148,1,147
2025-09-08,13,Preescolar,SuperSchool,94,5,89
2025-09-08,13,Preescolar,EduMax,228,23,205
2025-09-08,13,Preescolar,EduMax,263,4,259
2025-09-08,13,Preescolar,SuperSchool,243,10,233
2025-09-08,13,Preescolar,EduMax,106,7,99
2025-09-08,13,Preescolar,SuperSchool,241,14,227
2025-09-08,13,Preescolar,SuperSchool,266,15,251
2025-09-08,13,Preescolar,EduMax,278,8,270
2025-09-08,13,Kínder,SuperSchool,206,5,201
2025-09-08,13,Kínder,SuperSchool,63,1,62
2025-09-08,13,Kínder,TopKids,54,19,35
2025-09-08,13,Kínder,EduMax,298,12,286
2025-09-08,13,Kínder,TopKids,116,1,115
2025-09-08,13,Kínder,SuperSchool,111,14,97
2025-09-08,13,Kínder,SuperSchool,283,20,263
2025-09-08,13,Kínder,EduMax,63,14,49
2025-09-08,13,Kínder,SuperSchool,230,3,227
2025-09-08,13,Kínder,EduMax,238,24,214
2025-09-08,13,Primaria 1°,EduMax,221,23,198
2025-09-08,13,Primaria 1°,EduMax,50,4,46
2025-09-08,13,Primaria 1°,TopKids,258,14,244
2025-09-08,13,Primaria 1°,EduMax,100,4,96
2025-09-08,13,Primaria 1°,TopKids,196,13,183
2025-09-08,13,Primaria 1°,TopKids,265,14,251
2025-09-08,13,Primaria 1°,SuperSchool,91,14,77
2025-09-08,13,Primaria 2°,TopKids,124,15,109
2025-09-08,13,Primaria 2°,EduMax,226,23,203
2025-09-08,13,Primaria 2°,TopKids,262,6,256
2025-09-08,13,Primaria 2°,EduMax,122,3,119
2025-09-08,13,Primaria 2°,SuperSchool,64,13,51
2025-09-08,13,Primaria 2°,EduMax,111,18,93
2025-09-08,13,Primaria 2°,EduMax,62,9,53
2025-09-08,13,Primaria 2°,TopKids,54,19,35
2025-09-08,13,Primaria 3°,SuperSchool,218,17,201
2025-09-08,13,Primaria 3°,SuperSchool,175,9,166
2025-09-08,13,Primaria 3°,TopKids,211,13,198
2025-09-08,13,Primaria 3°,SuperSchool,217,15,202
2025-09-08,13,Primaria 3°,EduMax,175,2,173
2025-09-08,13,Primaria 3°,TopKids,294,17,277
2025-09-08,13,Primaria 3°,EduMax,236,17,219
2025-09-08,13,Primaria 3°,EduMax,287,11,276
2025-09-08,13,Primaria 3°,TopKids,168,14,154
2025-09-08,13,Primaria 3°,SuperSchool,139,6,133
2025-09-08,13,Primaria 3°,SuperSchool,100,11,89
2025-09-08,13,Primaria 3°,EduMax,219,13,206
2025-09-08,13,Primaria 4°,SuperSchool,179,14,165
2025-09-08,13,Primaria 4°,SuperSchool,154,8,146
2025-09-08,13,Primaria 4°,TopKids,202,16,186
2025-09-08,13,Primaria 4°,TopKids,265,17,248
2025-09-08,13,Primaria 4°,SuperSchool,76,13,63
2025-09-08,13,Primaria 4°,TopKids,112,16,96
2025-09-08,13,Primaria 4°,EduMax,256,12,244
2025-09-08,13,Primaria 4°,EduMax,114,11,103
2025-09-08,13,Primaria 4°,TopKids,146,16,130
2025-09-08,13,Primaria 4°,SuperSchool,216,1,215
2025-09-08,13,Primaria 4°,SuperSchool,235,2,233
2025-09-08,13,Primaria 4°,TopKids,190,5,185
2025-09-08,13,Primaria 4°,EduMax,260,21,239
2025-09-08,13,Primaria 4°,TopKids,203,1,202
2025-09-08,13,Primaria 4°,EduMax,71,5,66
2025-09-08,13,Primaria 4°,TopKids,58,24,34
2025-09-08,13,Primaria 4°,TopKids,253,14,239
2025-09-08,13,Primaria 4°,SuperSchool,176,16,160
2025-09-08,13,Primaria 4°,SuperSchool,268,18,250
2025-09-08,13,Primaria 5°,EduMax,230,21,209
2025-09-08,13,Primaria 5°,EduMax,167,3,164
2025-09-08,13,Primaria 5°,TopKids,277,1,276
2025-09-08,13,Primaria 5°,TopKids,66,5,61
2025-09-08,13,Primaria 5°,TopKids,72,7,65
2025-09-08,13,Primaria 5°,EduMax,143,16,127
2025-09-08,13,Primaria 5°,TopKids,95,2,93
2025-09-08,13,Primaria 5°,EduMax,69,24,45
2025-09-08,13,Primaria 5°,EduMax,150,13,137
2025-09-08,13,Primaria 5°,TopKids,187,22,165
2025-09-08,13,Primaria 5°,SuperSchool,177,14,163
2025-09-08,13,Primaria 5°,SuperSchool,131,20,111
2025-09-08,13,Primaria 5°,TopKids,141,8,133
2025-09-08,13,Primaria 5°,SuperSchool,262,20,242
2025-09-08,13,Primaria 5°,SuperSchool,221,16,205
2025-09-08,13,Primaria 5°,EduMax,197,19,178
2025-09-08,13,Primaria 5°,SuperSchool,248,4,244
2025-09-08,13,Primaria 5°,TopKids,123,8,115
2025-09-08,13,Primaria 6°,EduMax,228,16,212
2025-09-08,13,Primaria 6°,TopKids,253,20,233
2025-09-08,13,Primaria 6°,EduMax,109,11,98
2025-09-08,13,Primaria 6°,TopKids,176,13,163
2025-09-08,13,Primaria 6°,TopKids,194,10,184
2025-09-08,13,Primaria 6°,EduMax,255,19,236
2025-09-08,13,Primaria 6°,EduMax,274,11,263
2025-09-08,13,Primaria 6°,SuperSchool,74,14,60
2025-09-08,14,Preescolar,EduMax,87,4,83
2025-09-08,14,Preescolar,SuperSchool,173,7,166
2025-09-08,14,Preescolar,TopKids,62,2,60
2025-09-08,14,Preescolar,EduMax,173,15,158
2025-09-08,14,Preescolar,EduMax,161,2,159
2025-09-08,14,Preescolar,SuperSchool,118,2,116
2025-09-08,14,Preescolar,TopKids,54,11,43
2025-09-08,14,Preescolar,SuperSchool,127,5,122
2025-09-08,14,Preescolar,TopKids,248,11,237
2025-09-08,14,Preescolar,SuperSchool,167,24,143
2025-09-08,14,Preescolar,EduMax,167,1,166
2025-09-08,14,Preescolar,SuperSchool,177,16,161
2025-09-08,14,Preescolar,SuperSchool,87,6,81
2025-09-08,14,Preescolar,SuperSchool,200,14,186
2025-09-08,14,Preescolar,SuperSchool,207,8,199
2025-09-08,14,Preescolar,EduMax,119,5,114
2025-09-08,14,Preescolar,EduMax,195,13,182
2025-09-08,14,Kínder,EduMax,70,4,66
2025-09-08,14,Kínder,SuperSchool,131,13,118
2025-09-08,14,Kínder,SuperSchool,280,5,275
2025-09-08,14,Kínder,SuperSchool,148,6,142
2025-09-08,14,Kínder,TopKids,235,12,223
2025-09-08,14,Kínder,EduMax,92,20,72
2025-09-08,14,Kínder,TopKids,104,10,94
2025-09-08,14,Kínder,EduMax,277,15,262
2025-09-08,14,Kínder,EduMax,195,22,173
2025-09-08,14,Kínder,TopKids,260,24,236
2025-09-08,14,Kínder,TopKids,115,13,102
2025-09-08,14,Primaria 1°,SuperSchool,186,3,183
2025-09-08,14,Primaria 1°,EduMax,287,16,271
2025-09-08,14,Primaria 1°,EduMax,277,2,275
2025-09-08,14,Primaria 1°,EduMax,50,18,32
2025-09-08,14,Primaria 1°,EduMax,154,12,142
2025-09-08,14,Primaria 1°,SuperSchool,70,3,67
2025-09-08,14,Primaria 1°,EduMax,267,16,251
2025-09-08,14,Primaria 1°,EduMax,157,12,145
2025-09-08,14,Primaria 1°,SuperSchool,53,10,43
2025-09-08,14,Primaria 1°,SuperSchool,213,24,189
2025-09-08,14,Primaria 1°,SuperSchool,182,3,179
2025-09-08,14,Primaria 1°,TopKids,222,22,200
2025-09-08,14,Primaria 1°,TopKids,299,6,293
2025-09-08,14,Primaria 1°,TopKids,135,4,131
2025-09-08,14,Primaria 1°,TopKids,244,22,222
2025-09-08,14,Primaria 1°,EduMax,278,19,259
2025-09-08,14,Primaria 1°,EduMax,205,17,188
2025-09-08,14,Primaria 2°,SuperSchool,54,21,33
2025-09-08,14,Primaria 2°,SuperSchool,234,21,213
2025-09-08,14,Primaria 2°,SuperSchool,220,22,198
2025-09-08,14,Primaria 2°,TopKids,216,2,214
2025-09-08,14,Primaria 2°,EduMax,129,5,124
2025-09-08,14,Primaria 2°,EduMax,181,12,169
2025-09-08,14,Primaria 2°,TopKids,269,13,256
2025-09-08,14,Primaria 2°,TopKids,119,11,108
2025-09-08,14,Primaria 2°,TopKids,262,17,245
2025-09-08,14,Primaria 2°,TopKids,275,13,262
2025-09-08,14,Primaria 2°,TopKids,298,1,297
2025-09-08,14,Primaria 2°,EduMax,208,15,193
2025-09-08,14,Primaria 3°,TopKids,61,12,49
2025-09-08,14,Primaria 3°,TopKids,65,21,44
2025-09-08,14,Primaria 3°,SuperSchool,158,12,146
2025-09-08,14,Primaria 3°,EduMax,107,11,96
2025-09-08,14,Primaria 3°,EduMax,54,20,34
2025-09-08,14,Primaria 3°,SuperSchool,130,12,118
2025-09-08,14,Primaria 3°,SuperSchool,50,8,42
2025-09-08,14,Primaria 3°,TopKids,68,10,58
2025-09-08,14,Primaria 3°,EduMax,170,4,166
2025-09-08,14,Primaria 3°,SuperSchool,262,22,240
2025-09-08,14,Primaria 3°,TopKids,64,14,50
2025-09-08,14,Primaria 3°,TopKids,60,13,47
2025-09-08,14,Primaria 3°,TopKids,281,23,258
2025-09-08,14,Primaria 3°,SuperSchool,275,20,255
2025-09-08,14,Primaria 3°,EduMax,249,18,231
2025-09-08,14,Primaria 4°,EduMax,56,11,45
2025-09-08,14,Primaria 4°,TopKids,238,22,216
2025-09-08,14,Primaria 4°,EduMax,77,20,57
2025-09-08,14,Primaria 4°,SuperSchool,209,16,193
2025-09-08,14,Primaria 4°,SuperSchool,283,24,259
2025-09-08,14,Primaria 4°,SuperSchool,174,10,164
2025-09-08,14,Primaria 4°,EduMax,127,15,112
2025-09-08,14,Primaria 4°,TopKids,177,2,175
2025-09-08,14,Primaria 4°,TopKids,269,13,256
2025-09-08,14,Primaria 4°,SuperSchool,70,23,47
2025-09-08,14,Primaria 4°,TopKids,158,15,143
2025-09-08,14,Primaria 4°,EduMax,153,3,150
2025-09-08,14,Primaria 5°,SuperSchool,73,11,62
2025-09-08,14,Primaria 5°,TopKids,186,24,162
2025-09-08,14,Primaria 5°,SuperSchool,141,7,134
2025-09-08,14,Primaria 5°,TopKids,245,13,232
2025-09-08,14,Primaria 5°,SuperSchool,206,12,194
2025-09-08,14,Primaria 6°,SuperSchool,118,11,107
2025-09-08,14,Primaria 6°,EduMax,245,10,235
2025-09-08,14,Primaria 6°,TopKids,157,8,149
2025-09-08,14,Primaria 6°,EduMax,168,23,145
2025-09-08,14,Primaria 6°,TopKids,136,16,120
2025-09-08,14,Primaria 6°,EduMax,212,17,195
2025-09-08,14,Primaria 6°,TopKids,227,10,217
2025-09-08,14,Primaria 6°,EduMax,51,17,34
2025-09-08,15,Preescolar,SuperSchool,120,19,101
2025-09-08,15,Preescolar,SuperSchool,85,13,72
2025-09-08,15,Preescolar,EduMax,112,11,101
2025-09-08,15,Preescolar,TopKids,256,11,245
2025-09-08,15,Preescolar,TopKids,243,11,232
2025-09-08,15,Preescolar,EduMax,212,5,207
2025-09-08,15,Preescolar,TopKids,85,17,68
2025-09-08,15,Preescolar,SuperSchool,50,12,38
2025-09-08,15,Preescolar,EduMax,218,9,209
2025-09-08,15,Preescolar,SuperSchool,299,20,279
2025-09-08,15,Preescolar,EduMax,63,23,40
2025-09-08,15,Preescolar,SuperSchool,292,10,282
2025-09-08,15,Preescolar,TopKids,229,22,207
2025-09-08,15,Preescolar,SuperSchool,268,3,265
2025-09-08,15,Preescolar,TopKids,208,5,203
2025-09-08,15,Preescolar,TopKids,288,20,268
2025-09-08,15,Preescolar,SuperSchool,153,11,142
2025-09-08,15,Preescolar,TopKids,122,16,106
2025-09-08,15,Preescolar,EduMax,224,14,210
2025-09-08,15,Kínder,EduMax,190,1,189
2025-09-08,15,Kínder,TopKids,175,9,166
2025-09-08,15,Kínder,SuperSchool,203,17,186
2025-09-08,15,Kínder,EduMax,222,18,204
2025-09-08,15,Kínder,SuperSchool,198,24,174
2025-09-08,15,Kínder,SuperSchool,169,10,159
2025-09-08,15,Kínder,TopKids,120,9,111
2025-09-08,15,Kínder,TopKids,266,3,263
2025-09-08,15,Kínder,SuperSchool,92,8,84
2025-09-08,15,Kínder,SuperSchool,112,21,91
2025-09-08,15,Kínder,TopKids,55,10,45
2025-09-08,15,Kínder,EduMax,290,20,270
2025-09-08,15,Primaria 1°,SuperSchool,191,20,171
2025-09-08,15,Primaria 1°,TopKids,286,1,285
2025-09-08,15,Primaria 1°,SuperSchool,105,19,86
2025-09-08,15,Primaria 1°,SuperSchool,290,15,275
2025-09-08,15,Primaria 1°,SuperSchool,277,4,273
2025-09-08,15,Primaria 1°,SuperSchool,256,5,251
2025-09-08,15,Primaria 1°,SuperSchool,143,7,136
2025-09-08,15,Primaria 1°,EduMax,256,20,236
2025-09-08,15,Primaria 1°,EduMax,251,6,245
2025-09-08,15,Primaria 1°,EduMax,104,20,84
2025-09-08,15,Primaria 1°,SuperSchool,254,14,240
2025-09-08,15,Primaria 1°,SuperSchool,274,19,255
2025-09-08,15,Primaria 1°,SuperSchool,214,17,197
2025-09-08,15,Primaria 2°,SuperSchool,119,20,99
2025-09-08,15,Primaria 2°,TopKids,188,19,169
2025-09-08,15,Primaria 2°,SuperSchool,279,23,256
2025-09-08,15,Primaria 2°,EduMax,128,18,110
2025-09-08,15,Primaria 2°,SuperSchool,174,7,167
2025-09-08,15,Primaria 2°,TopKids,141,3,138
2025-09-08,15,Primaria 2°,SuperSchool,130,4,126
2025-09-08,15,Primaria 2°,TopKids,181,12,169
2025-09-08,15,Primaria 2°,TopKids,233,4,229
2025-09-08,15,Primaria 2°,SuperSchool,201,17,184
2025-09-08,15,Primaria 2°,EduMax,259,22,237
2025-09-08,15,Primaria 2°,EduMax,68,5,63
2025-09-08,15,Primaria 2°,EduMax,188,24,164
2025-09-08,15,Primaria 2°,SuperSchool,86,23,63
2025-09-08,15,Primaria 2°,TopKids,53,18,35
2025-09-08,15,Primaria 2°,EduMax,64,5,59
2025-09-08,15,Primaria 3°,TopKids,189,4,185
2025-09-08,15,Primaria 3°,SuperSchool,154,14,140
2025-09-08,15,Primaria 3°,TopKids,107,24,83
2025-09-08,15,Primaria 3°,TopKids,249,23,226
2025-09-08,15,Primaria 3°,SuperSchool,105,11,94
2025-09-08,15,Primaria 3°,TopKids,53,17,36
2025-09-08,15,Primaria 3°,SuperSchool,260,13,247
2025-09-08,15,Primaria 3°,TopKids,299,17,282
2025-09-08,15,Primaria 3°,EduMax,295,9,286
2025-09-08,15,Primaria 3°,SuperSchool,285,24,261
2025-09-08,15,Primaria 3°,TopKids,290,16,274
2025-09-08,15,Primaria 4°,EduMax,171,2,169
2025-09-08,15,Primaria 4°,TopKids,214,16,198
2025-09-08,15,Primaria 4°,SuperSchool,190,24,166
2025-09-08,15,Primaria 4°,EduMax,243,24,219
2025-09-08,15,Primaria 4°,SuperSchool,154,18,136
2025-09-08,15,Primaria 4°,SuperSchool,212,5,207
2025-09-08,15,Primaria 4°,EduMax,138,7,131
2025-09-08,15,Primaria 4°,EduMax,146,24,122
2025-09-08,15,Primaria 4°,SuperSchool,153,17,136
2025-09-08,15,Primaria 4°,TopKids,246,14,232
2025-09-08,15,Primaria 4°,TopKids,131,23,108
2025-09-08,15,Primaria 4°,SuperSchool,248,24,224
2025-09-08,15,Primaria 4°,EduMax,266,14,252
2025-09-08,15,Primaria 4°,EduMax,116,21,95
2025-09-08,15,Primaria 4°,EduMax,127,3,124
2025-09-08,15,Primaria 4°,EduMax,113,9,104
2025-09-08,15,Primaria 5°,TopKids,139,7,132
2025-09-08,15,Primaria 5°,TopKids,285,4,281
2025-09-08,15,Primaria 5°,SuperSchool,244,20,224
2025-09-08,15,Primaria 5°,SuperSchool,102,22,80
2025-09-08,15,Primaria 5°,SuperSchool,146,23,123
2025-09-08,15,Primaria 5°,SuperSchool,264,6,258
2025-09-08,15,Primaria 5°,EduMax,145,24,121
2025-09-08,15,Primaria 5°,EduMax,89,17,72
2025-09-08,15,Primaria 5°,TopKids,234,24,210
2025-09-08,15,Primaria 6°,SuperSchool,181,12,169
2025-09-08,15,Primaria 6°,EduMax,289,18,271
2025-09-08,15,Primaria 6°,EduMax,85,2,83
2025-09-08,15,Primaria 6°,SuperSchool,224,9,215
2025-09-08,15,Primaria 6°,TopKids,209,5,204
2025-09-08,15,Primaria 6°,TopKids,116,17,99
2025-09-08,16,Preescolar,TopKids,269,4,265
2025-09-08,16,Preescolar,EduMax,105,3,102
2025-09-08,16,Preescolar,EduMax,193,12,181
2025-09-08,16,Preescolar,TopKids,115,1,114
2025-09-08,16,Preescolar,SuperSchool,79,18,61
2025-09-08,16,Preescolar,EduMax,62,4,58
2025-09-08,16,Preescolar,TopKids,82,15,67
2025-09-08,16,Preescolar,SuperSchool,55,5,50
2025-09-08,16,Preescolar,SuperSchool,103,16,87
2025-09-08,16,Preescolar,EduMax,201,5,196
2025-09-08,16,Preescolar,TopKids,276,12,264
2025-09-08,16,Preescolar,EduMax,218,23,195
2025-09-08,16,Preescolar,SuperSchool,162,20,142
2025-09-08,16,Preescolar,EduMax,174,3,171
2025-09-08,16,Preescolar,EduMax,256,1,255
2025-09-08,16,Preescolar,TopKids,248,10,238
2025-09-08,16,Preescolar,SuperSchool,267,9,258
2025-09-08,16,Kínder,EduMax,210,16,194
2025-09-08,16,Kínder,EduMax,109,10,99
2025-09-08,16,Kínder,TopKids,221,22,199
2025-09-08,16,Kínder,TopKids,215,8,207
2025-09-08,16,Kínder,TopKids,286,24,262
2025-09-08,16,Kínder,TopKids,89,21,68
2025-09-08,16,Kínder,TopKids,254,4,250
2025-09-08,16,Kínder,TopKids,135,20,115
2025-09-08,16,Kínder,SuperSchool,180,22,158
2025-09-08,16,Kínder,SuperSchool,170,6,164
2025-09-08,16,Kínder,EduMax,133,14,119
2025-09-08,16,Kínder,SuperSchool,156,9,147
2025-09-08,16,Primaria 1°,SuperSchool,253,1,252
2025-09-08,16,Primaria 1°,SuperSchool,85,22,63
2025-09-08,16,Primaria 1°,EduMax,131,17,114
2025-09-08,16,Primaria 1°,EduMax,285,5,280
2025-09-08,16,Primaria 1°,SuperSchool,260,7,253
2025-09-08,16,Primaria 1°,TopKids,287,3,284
2025-09-08,16,Primaria 1°,SuperSchool,247,11,236
2025-09-08,16,Primaria 1°,TopKids,112,22,90
2025-09-08,16,Primaria 1°,TopKids,83,12,71
2025-09-08,16,Primaria 1°,SuperSchool,232,14,218
2025-09-08,16,Primaria 1°,TopKids,250,20,230
2025-09-08,16,Primaria 1°,EduMax,258,17,241
2025-09-08,16,Primaria 1°,EduMax,283,11,272
2025-09-08,16,Primaria 1°,TopKids,239,2,237
2025-09-08,16,Primaria 1°,TopKids,165,18,147
2025-09-08,16,Primaria 1°,SuperSchool,175,24,151
2025-09-08,16,Primaria 1°,TopKids,299,2,297
2025-09-08,16,Primaria 2°,SuperSchool,219,19,200
2025-09-08,16,Primaria 2°,TopKids,226,3,223
2025-09-08,16,Primaria 2°,SuperSchool,160,4,156
2025-09-08,16,Primaria 2°,SuperSchool,284,6,278
2025-09-08,16,Primaria 2°,SuperSchool,123,1,122
2025-09-08,16,Primaria 2°,EduMax,240,14,226
2025-09-08,16,Primaria 2°,TopKids,174,18,156
2025-09-08,16,Primaria 2°,EduMax,80,1,79
2025-09-08,16,Primaria 2°,EduMax,242,9,233
2025-09-08,16,Primaria 2°,EduMax,84,12,72
2025-09-08,16,Primaria 2°,SuperSchool,130,2,128
2025-09-08,16,Primaria 2°,SuperSchool,183,1,182
2025-09-08,16,Primaria 3°,TopKids,189,4,185
2025-09-08,16,Primaria 3°,TopKids,129,20,109
2025-09-08,16,Primaria 3°,TopKids,101,20,81
2025-09-08,16,Primaria 3°,EduMax,205,10,195
2025-09-08,16,Primaria 3°,EduMax,153,1,152
2025-09-08,16,Primaria 3°,SuperSchool,232,7,225
2025-09-08,16,Primaria 3°,EduMax,95,4,91
2025-09-08,16,Primaria 3°,SuperSchool,226,2,224
2025-09-08,16,Primaria 3°,EduMax,136,2,134
2025-09-08,16,Primaria 3°,TopKids,139,8,131
2025-09-08,16,Primaria 3°,SuperSchool,168,17,151
2025-09-08,16,Primaria 4°,TopKids,138,5,133
2025-09-08,16,Primaria 4°,EduMax,192,2,190
2025-09-08,16,Primaria 4°,TopKids,145,17,128
2025-09-08,16,Primaria 4°,SuperSchool,245,24,221
2025-09-08,16,Primaria 4°,EduMax,238,14,224
2025-09-08,16,Primaria 4°,TopKids,244,4,240
2025-09-08,16,Primaria 4°,SuperSchool,250,21,229
2025-09-08,16,Primaria 4°,TopKids,287,17,270
2025-09-08,16,Primaria 4°,SuperSchool,147,14,133
2025-09-08,16,Primaria 4°,EduMax,97,19,78
2025-09-08,16,Primaria 4°,TopKids,236,14,222
2025-09-08,16,Primaria 4°,TopKids,246,8,238
2025-09-08,16,Primaria 4°,SuperSchool,130,14,116
2025-09-08,16,Primaria 4°,TopKids,219,22,197
2025-09-08,16,Primaria 4°,SuperSchool,153,12,141
2025-09-08,16,Primaria 4°,SuperSchool,170,21,149
2025-09-08,16,Primaria 4°,SuperSchool,233,21,212
2025-09-08,16,Primaria 4°,SuperSchool,150,6,144
2025-09-08,16,Primaria 4°,SuperSchool,278,2,276
2025-09-08,16,Primaria 5°,TopKids,123,3,120
2025-09-08,16,Primaria 5°,SuperSchool,217,16,201
2025-09-08,16,Primaria 5°,SuperSchool,174,22,152
2025-09-08,16,Primaria 5°,SuperSchool,107,2,105
2025-09-08,16,Primaria 5°,SuperSchool,283,24,259
2025-09-08,16,Primaria 5°,EduMax,150,22,128
2025-09-08,16,Primaria 5°,TopKids,138,1,137
2025-09-08,16,Primaria 6°,SuperSchool,282,16,266
2025-09-08,16,Primaria 6°,SuperSchool,166,19,147
2025-09-08,16,Primaria 6°,EduMax,264,24,240
2025-09-08,16,Primaria 6°,EduMax,229,1,228
2025-09-08,16,Primaria 6°,TopKids,101,5,96
2025-09-08,16,Primaria 6°,EduMax,256,8,248
2025-09-08,16,Primaria 6°,TopKids,141,10,131
2025-09-08,16,Primaria 6°,EduMax,64,15,49
2025-09-08,16,Primaria 6°,TopKids,59,21,38
2025-09-08,16,Primaria 6°,TopKids,117,22,95
2025-09-08,16,Primaria 6°,TopKids,87,15,72
2025-09-08,16,Primaria 6°,EduMax,163,11,152
2025-09-08,16,Primaria 6°,EduMax,153,24,129
2025-09-08,16,Primaria 6°,EduMax,143,14,129
2025-09-08,16,Primaria 6°,EduMax,55,6,49
2025-09-08,16,Primaria 6°,EduMax,196,2,194
2025-09-08,16,Primaria 6°,SuperSchool,96,3,93
2025-09-09,9,Preescolar,EduMax,286,12,274
2025-09-09,9,Preescolar,SuperSchool,122,11,111
2025-09-09,9,Preescolar,EduMax,209,7,202
2025-09-09,9,Preescolar,EduMax,141,19,122
2025-09-09,9,Preescolar,EduMax,175,23,152
2025-09-09,9,Preescolar,TopKids,132,3,129
2025-09-09,9,Preescolar,TopKids,228,7,221
2025-09-09,9,Preescolar,SuperSchool,255,21,234
2025-09-09,9,Preescolar,EduMax,255,8,247
2025-09-09,9,Preescolar,EduMax,237,15,222
2025-09-09,9,Preescolar,TopKids,99,15,84
2025-09-09,9,Preescolar,TopKids,61,18,43
2025-09-09,9,Preescolar,EduMax,182,15,167
2025-09-09,9,Preescolar,EduMax,58,8,50
2025-09-09,9,Preescolar,TopKids,190,13,177
2025-09-09,9,Preescolar,TopKids,223,1,222
2025-09-09,9,Preescolar,EduMax,168,4,164
2025-09-09,9,Kínder,EduMax,102,13,89
2025-09-09,9,Kínder,SuperSchool,60,18,42
2025-09-09,9,Kínder,SuperSchool,87,23,64
2025-09-09,9,Kínder,SuperSchool,182,10,172
2025-09-09,9,Kínder,SuperSchool,71,10,61
2025-09-09,9,Kínder,SuperSchool,150,20,130
2025-09-09,9,Kínder,SuperSchool,188,5,183
2025-09-09,9,Kínder,SuperSchool,226,21,205
2025-09-09,9,Kínder,SuperSchool,82,13,69
2025-09-09,9,Kínder,TopKids,183,15,168
2025-09-09,9,Kínder,TopKids,294,16,278
2025-09-09,9,Kínder,SuperSchool,110,24,86
2025-09-09,9,Kínder,SuperSchool,175,23,152
2025-09-09,9,Kínder,EduMax,172,7,165
2025-09-09,9,Kínder,TopKids,59,16,43
2025-09-09,9,Kínder,SuperSchool,189,9,180
2025-09-09,9,Kínder,SuperSchool,169,22,147
2025-09-09,9,Primaria 1°,TopKids,88,11,77
2025-09-09,9,Primaria 1°,SuperSchool,177,24,153
2025-09-09,9,Primaria 1°,EduMax,104,10,94
2025-09-09,9,Primaria 1°,TopKids,283,2,281
2025-09-09,9,Primaria 1°,TopKids,265,21,244
2025-09-09,9,Primaria 1°,TopKids,130,22,108
2025-09-09,9,Primaria 1°,SuperSchool,68,21,47
2025-09-09,9,Primaria 1°,SuperSchool,104,8,96
2025-09-09,9,Primaria 1°,EduMax,154,19,135
2025-09-09,9,Primaria 1°,SuperSchool,283,14,269
2025-09-09,9,Primaria 1°,EduMax,238,12,226
2025-09-09,9,Primaria 1°,TopKids,165,24,141
2025-09-09,9,Primaria 1°,EduMax,216,9,207
2025-09-09,9,Primaria 1°,EduMax,280,4,276
2025-09-09,9,Primaria 1°,TopKids,121,18,103
2025-09-09,9,Primaria 1°,SuperSchool,256,7,249
2025-09-09,9,Primaria 1°,SuperSchool,60,10,50
2025-09-09,9,Primaria 1°,SuperSchool,175,2,173
2025-09-09,9,Primaria 1°,EduMax,179,19,160
2025-09-09,9,Primaria 2°,EduMax,145,22,123
2025-09-09,9,Primaria 2°,SuperSchool,149,23,126
2025-09-09,9,Primaria 2°,EduMax,68,10,58
2025-09-09,9,Primaria 2°,TopKids,109,9,100
2025-09-09,9,Primaria 2°,EduMax,144,5,139
2025-09-09,9,Primaria 2°,SuperSchool,232,18,214
2025-09-09,9,Primaria 2°,TopKids,134,1,133
2025-09-09,9,Primaria 2°,EduMax,108,14,94
2025-09-09,9,Primaria 2°,EduMax,210,4,206
2025-09-09,9,Primaria 2°,TopKids,216,24,192
2025-09-09,9,Primaria 2°,SuperSchool,202,15,187
2025-09-09,9,Primaria 2°,EduMax,107,14,93
2025-09-09,9,Primaria 2°,EduMax,157,13,144
2025-09-09,9,Primaria 2°,EduMax,142,3,139
2025-09-09,9,Primaria 2°,SuperSchool,268,13,255
2025-09-09,9,Primaria 3°,EduMax,252,15,237
2025-09-09,9,Primaria 3°,TopKids,299,24,275
2025-09-09,9,Primaria 3°,SuperSchool,211,11,200
2025-09-09,9,Primaria 3°,SuperSchool,105,23,82
2025-09-09,9,Primaria 3°,TopKids,162,24,138
2025-09-09,9,Primaria 3°,SuperSchool,266,16,250
2025-09-09,9,Primaria 3°,SuperSchool,208,10,198
2025-09-09,9,Primaria 3°,TopKids,128,1,127
2025-09-09,9,Primaria 3°,EduMax,65,21,44
2025-09-09,9,Primaria 3°,TopKids,243,3,240
2025-09-09,9,Primaria 3°,TopKids,81,24,57
2025-09-09,9,Primaria 3°,EduMax,160,4,156
2025-09-09,9,Primaria 4°,TopKids,265,20,245
2025-09-09,9,Primaria 4°,EduMax,292,23,269
2025-09-09,9,Primaria 4°,TopKids,181,10,171
2025-09-09,9,Primaria 4°,SuperSchool,91,15,76
2025-09-09,9,Primaria 4°,EduMax,273,18,255
2025-09-09,9,Primaria 4°,EduMax,296,9,287
2025-09-09,9,Primaria 4°,SuperSchool,266,9,257
2025-09-09,9,Primaria 5°,SuperSchool,193,6,187
2025-09-09,9,Primaria 5°,SuperSchool,56,13,43
2025-09-09,9,Primaria 5°,SuperSchool,111,10,101
2025-09-09,9,Primaria 5°,SuperSchool,178,20,158
2025-09-09,9,Primaria 5°,TopKids,240,14,226
2025-09-09,9,Primaria 5°,TopKids,55,20,35
2025-09-09,9,Primaria 5°,EduMax,270,7,263
2025-09-09,9,Primaria 5°,SuperSchool,170,20,150
2025-09-09,9,Primaria 5°,TopKids,246,22,224
2025-09-09,9,Primaria 5°,SuperSchool,281,3,278
2025-09-09,9,Primaria 6°,TopKids,62,6,56
2025-09-09,9,Primaria 6°,SuperSchool,238,23,215
2025-09-09,9,Primaria 6°,EduMax,138,7,131
2025-09-09,9,Primaria 6°,TopKids,199,9,190
2025-09-09,9,Primaria 6°,EduMax,229,17,212
2025-09-09,9,Primaria 6°,EduMax,151,21,130
2025-09-09,9,Primaria 6°,EduMax,92,3,89
2025-09-09,9,Primaria 6°,EduMax,258,7,251
2025-09-09,9,Primaria 6°,EduMax,262,13,249
2025-09-09,9,Primaria 6°,EduMax,164,8,156
2025-09-09,9,Primaria 6°,SuperSchool,101,9,92
2025-09-09,9,Primaria 6°,SuperSchool,118,11,107
2025-09-09,9,Primaria 6°,TopKids,279,12,267
2025-09-09,9,Primaria 6°,EduMax,272,4,268
2025-09-09,9,Primaria 6°,EduMax,126,12,114
2025-09-09,9,Primaria 6°,TopKids,89,13,76
2025-09-09,9,Primaria 6°,TopKids,284,11,273
2025-09-09,9,Primaria 6°,EduMax,196,21,175
2025-09-09,10,Preescolar,SuperSchool,126,20,106
2025-09-09,10,Preescolar,SuperSchool,72,24,48
2025-09-09,10,Preescolar,TopKids,154,17,137
2025-09-09,10,Preescolar,TopKids,217,2,215
2025-09-09,10,Preescolar,EduMax,187,9,178
2025-09-09,10,Kínder,SuperSchool,189,14,175
2025-09-09,10,Kínder,TopKids,292,11,281
2025-09-09,10,Kínder,SuperSchool,194,20,174
2025-09-09,10,Kínder,EduMax,87,6,81
2025-09-09,10,Kínder,EduMax,261,10,251
2025-09-09,10,Kínder,EduMax,272,17,255
2025-09-09,10,Kínder,SuperSchool,255,5,250
2025-09-09,10,Kínder,TopKids,156,19,137
2025-09-09,10,Kínder,TopKids,223,15,208
2025-09-09,10,Kínder,TopKids,180,23,157
2025-09-09,10,Kínder,SuperSchool,188,15,173
2025-09-09,10,Kínder,SuperSchool,226,24,202
2025-09-09,10,Kínder,EduMax,221,17,204
2025-09-09,10,Kínder,SuperSchool,190,8,182
2025-09-09,10,Kínder,TopKids,71,6,65
2025-09-09,10,Kínder,TopKids,75,23,52
2025-09-09,10,Primaria 1°,SuperSchool,152,1,151
2025-09-09,10,Primaria 1°,EduMax,96,14,82
2025-09-09,10,Primaria 1°,TopKids,53,9,44
2025-09-09,10,Primaria 1°,TopKids,93,9,84
2025-09-09,10,Primaria 1°,TopKids,236,15,221
2025-09-09,10,Primaria 1°,SuperSchool,230,11,219
2025-09-09,10,Primaria 1°,EduMax,96,7,89
2025-09-09,10,Primaria 1°,TopKids,159,4,155
2025-09-09,10,Primaria 1°,SuperSchool,50,24,26
2025-09-09,10,Primaria 1°,TopKids,264,13,251
2025-09-09,10,Primaria 1°,TopKids,205,18,187
2025-09-09,10,Primaria 1°,TopKids,269,9,260
2025-09-09,10,Primaria 2°,EduMax,156,6,150
2025-09-09,10,Primaria 2°,SuperSchool,178,22,156
2025-09-09,10,Primaria 2°,EduMax,239,23,216
2025-09-09,10,Primaria 2°,SuperSchool,100,6,94
2025-09-09,10,Primaria 2°,TopKids,216,10,206
2025-09-09,10,Primaria 2°,EduMax,109,13,96
2025-09-09,10,Primaria 2°,TopKids,100,1,99
2025-09-09,10,Primaria 2°,TopKids,287,13,274
2025-09-09,10,Primaria 2°,TopKids,125,8,117
2025-09-09,10,Primaria 3°,TopKids,162,21,141
2025-09-09,10,Primaria 3°,SuperSchool,281,10,271
2025-09-09,10,Primaria 3°,TopKids,112,2,110
2025-09-09,10,Primaria 3°,SuperSchool,110,16,94
2025-09-09,10,Primaria 3°,SuperSchool,277,6,271
2025-09-09,10,Primaria 3°,TopKids,79,23,56
2025-09-09,10,Primaria 3°,TopKids,269,24,245
2025-09-09,10,Primaria 3°,TopKids,213,10,203
2025-09-09,10,Primaria 3°,SuperSchool,53,20,33
2025-09-09,10,Primaria 3°,SuperSchool,95,11,84
2025-09-09,10,Primaria 3°,EduMax,154,22,132
2025-09-09,10,Primaria 3°,TopKids,82,22,60
2025-09-09,10,Primaria 3°,TopKids,183,24,159
2025-09-09,10,Primaria 3°,SuperSchool,226,21,205
2025-09-09,10,Primaria 3°,TopKids,271,14,257
2025-09-09,10,Primaria 3°,EduMax,100,22,78
2025-09-09,10,Primaria 3°,SuperSchool,299,3,296
2025-09-09,10,Primaria 3°,SuperSchool,141,15,126
2025-09-09,10,Primaria 3°,SuperSchool,179,4,175
2025-09-09,10,Primaria 4°,TopKids,172,12,160
2025-09-09,10,Primaria 4°,TopKids,193,12,181
2025-09-09,10,Primaria 4°,EduMax,56,21,35
2025-09-09,10,Primaria 4°,EduMax,144,23,121
2025-09-09,10,Primaria 4°,EduMax,237,3,234
2025-09-09,10,Primaria 4°,TopKids,222,7,215
2025-09-09,10,Primaria 4°,SuperSchool,81,21,60
2025-09-09,10,Primaria 4°,SuperSchool,74,20,54
2025-09-09,10,Primaria 4°,EduMax,151,13,138
2025-09-09,10,Primaria 4°,TopKids,179,22,157
2025-09-09,10,Primaria 4°,SuperSchool,186,19,167
2025-09-09,10,Primaria 4°,EduMax,222,8,214
2025-09-09,10,Primaria 4°,SuperSchool,124,8,116
2025-09-09,10,Primaria 4°,SuperSchool,266,20,246
2025-09-09,10,Primaria 4°,SuperSchool,198,7,191
2025-09-09,10,Primaria 4°,SuperSchool,171,9,162
2025-09-09,10,Primaria 4°,EduMax,179,21,158
2025-09-09,10,Primaria 4°,TopKids,109,6,103
2025-09-09,10,Primaria 5°,SuperSchool,94,10,84
2025-09-09,10,Primaria 5°,TopKids,242,18,224
2025-09-09,10,Primaria 5°,TopKids,198,14,184
2025-09-09,10,Primaria 5°,EduMax,255,17,238
2025-09-09,10,Primaria 5°,TopKids,276,17,259
2025-09-09,10,Primaria 5°,TopKids,104,10,94
2025-09-09,10,Primaria 5°,TopKids,129,6,123
2025-09-09,10,Primaria 5°,TopKids,117,20,97
2025-09-09,10,Primaria 5°,SuperSchool,206,7,199
2025-09-09,10,Primaria 5°,EduMax,93,3,90
2025-09-09,10,Primaria 5°,EduMax,191,9,182
2025-09-09,10,Primaria 5°,TopKids,106,20,86
2025-09-09,10,Primaria 5°,SuperSchool,192,7,185
2025-09-09,10,Primaria 5°,TopKids,183,19,164
2025-09-09,10,Primaria 5°,TopKids,242,7,235
2025-09-09,10,Primaria 6°,SuperSchool,151,23,128
2025-09-09,10,Primaria 6°,SuperSchool,279,11,268
2025-09-09,10,Primaria 6°,EduMax,80,6,74
2025-09-09,10,Primaria 6°,EduMax,163,23,140
2025-09-09,10,Primaria 6°,EduMax,189,9,180
2025-09-09,10,Primaria 6°,SuperSchool,241,20,221
2025-09-09,10,Primaria 6°,TopKids,134,22,112
2025-09-09,11,Preescolar,SuperSchool,90,17,73
2025-09-09,11,Preescolar,SuperSchool,53,6,47
2025-09-09,11,Preescolar,SuperSchool,235,17,218
2025-09-09,11,Preescolar,TopKids,143,23,120
2025-09-09,11,Preescolar,TopKids,297,8,289
2025-09-09,11,Kínder,SuperSchool,258,24,234
2025-09-09,11,Kínder,SuperSchool,256,1,255
2025-09-09,11,Kínder,EduMax,165,10,155
2025-09-09,11,Kínder,TopKids,193,23,170
2025-09-09,11,Kínder,TopKids,118,23,95
2025-09-09,11,Kínder,TopKids,212,18,194
2025-09-09,11,Kínder,TopKids,149,15,134
2025-09-09,11,Kínder,EduMax,64,4,60
2025-09-09,11,Kínder,EduMax,136,3,133
2025-09-09,11,Primaria 1°,TopKids,219,1,218
2025-09-09,11,Primaria 1°,EduMax,182,9,173
2025-09-09,11,Primaria 1°,EduMax,164,9,155
2025-09-09,11,Primaria 1°,EduMax,233,15,218
2025-09-09,11,Primaria 1°,TopKids,127,3,124
2025-09-09,11,Primaria 1°,TopKids,284,4,280
2025-09-09,11,Primaria 1°,TopKids,105,10,95
2025-09-09,11,Primaria 1°,TopKids,298,9,289
2025-09-09,11,Primaria 1°,EduMax,66,9,57
2025-09-09,11,Primaria 1°,SuperSchool,175,23,152
2025-09-09,11,Primaria 1°,SuperSchool,233,9,224
2025-09-09,11,Primaria 1°,TopKids,167,2,165
2025-09-09,11,Primaria 1°,SuperSchool,168,1,167
2025-09-09,11,Primaria 1°,EduMax,183,16,167
2025-09-09,11,Primaria 1°,TopKids,56,2,54
2025-09-09,11,Primaria 1°,EduMax,207,12,195
2025-09-09,11,Primaria 2°,EduMax,143,4,139
2025-09-09,11,Primaria 2°,TopKids,115,18,97
2025-09-09,11,Primaria 2°,TopKids,155,12,143
2025-09-09,11,Primaria 2°,TopKids,229,7,222
2025-09-09,11,Primaria 2°,TopKids,185,3,182
2025-09-09,11,Primaria 2°,TopKids,256,8,248
2025-09-09,11,Primaria 2°,EduMax,78,14,64
2025-09-09,11,Primaria 2°,TopKids,213,3,210
2025-09-09,11,Primaria 3°,SuperSchool,187,8,179
2025-09-09,11,Primaria 3°,EduMax,299,1,298
2025-09-09,11,Primaria 3°,TopKids,181,16,165
2025-09-09,11,Primaria 3°,SuperSchool,145,18,127
2025-09-09,11,Primaria 3°,EduMax,94,16,78
2025-09-09,11,Primaria 3°,SuperSchool,64,19,45
2025-09-09,11,Primaria 3°,SuperSchool,53,19,34
2025-09-09,11,Primaria 3°,EduMax,126,11,115
2025-09-09,11,Primaria 3°,EduMax,234,11,223
2025-09-09,11,Primaria 3°,EduMax,114,15,99
2025-09-09,11,Primaria 4°,EduMax,167,4,163
2025-09-09,11,Primaria 4°,EduMax,83,17,66
2025-09-09,11,Primaria 4°,EduMax,265,5,260
2025-09-09,11,Primaria 4°,TopKids,142,6,136
2025-09-09,11,Primaria 4°,SuperSchool,270,19,251
2025-09-09,11,Primaria 4°,SuperSchool,180,8,172
2025-09-09,11,Primaria 4°,SuperSchool,200,5,195
2025-09-09,11,Primaria 4°,EduMax,81,24,57
2025-09-09,11,Primaria 4°,SuperSchool,228,19,209
2025-09-09,11,Primaria 4°,EduMax,219,3,216
2025-09-09,11,Primaria 4°,EduMax,298,13,285
2025-09-09,11,Primaria 4°,EduMax,262,17,245
2025-09-09,11,Primaria 5°,TopKids,274,12,262
2025-09-09,11,Primaria 5°,EduMax,196,5,191
2025-09-09,11,Primaria 5°,EduMax,230,3,227
2025-09-09,11,Primaria 5°,EduMax,259,12,247
2025-09-09,11,Primaria 5°,EduMax,209,10,199
2025-09-09,11,Primaria 5°,TopKids,105,4,101
2025-09-09,11,Primaria 6°,TopKids,180,15,165
2025-09-09,11,Primaria 6°,EduMax,207,24,183
2025-09-09,11,Primaria 6°,EduMax,224,2,222
2025-09-09,11,Primaria 6°,TopKids,125,10,115
2025-09-09,11,Primaria 6°,TopKids,277,8,269
2025-09-09,11,Primaria 6°,TopKids,164,16,148
2025-09-09,11,Primaria 6°,SuperSchool,106,15,91
2025-09-09,11,Primaria 6°,EduMax,256,12,244
2025-09-09,11,Primaria 6°,TopKids,166,3,163
2025-09-09,11,Primaria 6°,SuperSchool,127,2,125
2025-09-09,11,Primaria 6°,EduMax,84,9,75
2025-09-09,11,Primaria 6°,TopKids,267,3,264
2025-09-09,12,Preescolar,SuperSchool,251,6,245
2025-09-09,12,Preescolar,EduMax,252,17,235
2025-09-09,12,Preescolar,TopKids,115,9,106
2025-09-09,12,Preescolar,EduMax,54,21,33
2025-09-09,12,Preescolar,EduMax,181,9,172
2025-09-09,12,Preescolar,SuperSchool,117,9,108
2025-09-09,12,Preescolar,EduMax,108,11,97
2025-09-09,12,Preescolar,EduMax,78,16,62
2025-09-09,12,Preescolar,TopKids,219,4,215
2025-09-09,12,Kínder,EduMax,154,13,141
2025-09-09,12,Kínder,SuperSchool,275,3,272
2025-09-09,12,Kínder,EduMax,214,4,210
2025-09-09,12,Kínder,EduMax,118,5,113
2025-09-09,12,Kínder,EduMax,112,13,99
2025-09-09,12,Kínder,TopKids,156,19,137
2025-09-09,12,Kínder,TopKids,258,5,253
2025-09-09,12,Kínder,EduMax,175,18,157
2025-09-09,12,Kínder,EduMax,122,18,104
2025-09-09,12,Kínder,TopKids,194,9,185
2025-09-09,12,Kínder,SuperSchool,261,23,238
2025-09-09,12,Kínder,EduMax,201,13,188
2025-09-09,12,Kínder,EduMax,244,4,240
2025-09-09,12,Kínder,TopKids,216,21,195
2025-09-09,12,Kínder,SuperSchool,179,6,173
2025-09-09,12,Kínder,SuperSchool,224,11,213
2025-09-09,12,Primaria 1°,EduMax,89,11,78
2025-09-09,12,Primaria 1°,SuperSchool,191,2,189
2025-09-09,12,Primaria 1°,TopKids,240,23,217
2025-09-09,12,Primaria 1°,EduMax,274,15,259
2025-09-09,12,Primaria 1°,SuperSchool,267,1,266
2025-09-09,12,Primaria 1°,EduMax,194,22,172
2025-09-09,12,Primaria 1°,EduMax,173,7,166
2025-09-09,12,Primaria 1°,EduMax,192,22,170
2025-09-09,12,Primaria 1°,SuperSchool,266,11,255
2025-09-09,12,Primaria 2°,EduMax,92,21,71
2025-09-09,12,Primaria 2°,EduMax,164,16,148
2025-09-09,12,Primaria 2°,SuperSchool,229,5,224
2025-09-09,12,Primaria 2°,EduMax,255,14,241
2025-09-09,12,Primaria 2°,TopKids,135,18,117
2025-09-09,12,Primaria 2°,EduMax,54,10,44
2025-09-09,12,Primaria 2°,TopKids,158,9,149
2025-09-09,12,Primaria 2°,SuperSchool,144,9,135
2025-09-09,12,Primaria 2°,TopKids,234,9,225
2025-09-09,12,Primaria 2°,SuperSchool,110,6,104
2025-09-09,12,Primaria 2°,TopKids,283,10,273
2025-09-09,12,Primaria 2°,EduMax,102,1,101
2025-09-09,12,Primaria 3°,SuperSchool,143,8,135
2025-09-09,12,Primaria 3°,SuperSchool,87,19,68
2025-09-09,12,Primaria 3°,TopKids,185,23,162
2025-09-09,12,Primaria 3°,TopKids,250,19,231
2025-09-09,12,Primaria 3°,TopKids,55,15,40
2025-09-09,12,Primaria 3°,SuperSchool,253,24,229
2025-09-09,12,Primaria 3°,EduMax,134,22,112
2025-09-09,12,Primaria 3°,SuperSchool,148,2,146
2025-09-09,12,Primaria 4°,SuperSchool,66,16,50
2025-09-09,12,Primaria 4°,EduMax,221,4,217
2025-09-09,12,Primaria 4°,SuperSchool,298,19,279
2025-09-09,12,Primaria 4°,EduMax,54,1,53
2025-09-09,12,Primaria 4°,EduMax,223,23,200
2025-09-09,12,Primaria 4°,SuperSchool,194,12,182
2025-09-09,12,Primaria 4°,TopKids,171,20,151
2025-09-09,12,Primaria 5°,TopKids,65,23,42
2025-09-09,12,Primaria 5°,EduMax,71,14,57
2025-09-09,12,Primaria 5°,TopKids,92,15,77
2025-09-09,12,Primaria 5°,SuperSchool,70,8,62
2025-09-09,12,Primaria 5°,SuperSchool,281,4,277
2025-09-09,12,Primaria 5°,SuperSchool,155,6,149
2025-09-09,12,Primaria 5°,EduMax,130,8,122
2025-09-09,12,Primaria 5°,SuperSchool,224,4,220
2025-09-09,12,Primaria 5°,SuperSchool,141,15,126
2025-09-09,12,Primaria 5°,TopKids,208,14,194
2025-09-09,12,Primaria 5°,TopKids,111,20,91
2025-09-09,12,Primaria 5°,SuperSchool,106,10,96
2025-09-09,12,Primaria 5°,EduMax,119,1,118
2025-09-09,12,Primaria 5°,SuperSchool,117,11,106
2025-09-09,12,Primaria 5°,SuperSchool,184,20,164
2025-09-09,12,Primaria 5°,TopKids,179,8,171
2025-09-09,12,Primaria 5°,SuperSchool,299,5,294
2025-09-09,12,Primaria 5°,EduMax,253,17,236
2025-09-09,12,Primaria 6°,EduMax,182,5,177
2025-09-09,12,Primaria 6°,EduMax,288,5,283
2025-09-09,12,Primaria 6°,SuperSchool,185,1,184
2025-09-09,12,Primaria 6°,SuperSchool,276,21,255
2025-09-09,12,Primaria 6°,TopKids,128,4,124
2025-09-09,12,Primaria 6°,TopKids,298,2,296
2025-09-09,12,Primaria 6°,EduMax,107,17,90
2025-09-09,12,Primaria 6°,SuperSchool,182,10,172
2025-09-09,12,Primaria 6°,TopKids,238,9,229
2025-09-09,12,Primaria 6°,SuperSchool,224,2,222
2025-09-09,12,Primaria 6°,SuperSchool,63,21,42
2025-09-09,12,Primaria 6°,EduMax,209,12,197
2025-09-09,12,Primaria 6°,SuperSchool,113,20,93
2025-09-09,12,Primaria 6°,SuperSchool,109,2,107
2025-09-09,12,Primaria 6°,TopKids,196,15,181
2025-09-09,12,Primaria 6°,TopKids,241,15,226
2025-09-09,12,Primaria 6°,SuperSchool,259,21,238
2025-09-09,12,Primaria 6°,TopKids,112,7,105
2025-09-09,13,Preescolar,SuperSchool,154,19,135
2025-09-09,13,Preescolar,TopKids,117,1,116
2025-09-09,13,Preescolar,SuperSchool,98,20,78
2025-09-09,13,Preescolar,SuperSchool,249,4,245
2025-09-09,13,Preescolar,TopKids,168,22,146
2025-09-09,13,Preescolar,EduMax,291,15,276
2025-09-09,13,Preescolar,TopKids,69,23,46
2025-09-09,13,Preescolar,EduMax,220,24,196
2025-09-09,13,Preescolar,SuperSchool,281,16,265
2025-09-09,13,Preescolar,TopKids,94,5,89
2025-09-09,13,Preescolar,SuperSchool,228,2,226
2025-09-09,13,Preescolar,SuperSchool,146,23,123
2025-09-09,13,Preescolar,TopKids,63,7,56
2025-09-09,13,Preescolar,SuperSchool,79,23,56
2025-09-09,13,Kínder,SuperSchool,147,9,138
2025-09-09,13,Kínder,TopKids,73,16,57
2025-09-09,13,Kínder,SuperSchool,237,4,233
2025-09-09,13,Kínder,TopKids,70,10,60
2025-09-09,13,Kínder,TopKids,119,15,104
2025-09-09,13,Kínder,SuperSchool,51,24,27
2025-09-09,13,Kínder,EduMax,240,15,225
2025-09-09,13,Kínder,EduMax,81,14,67
2025-09-09,13,Kínder,EduMax,259,3,256
2025-09-09,13,Kínder,EduMax,63,6,57
2025-09-09,13,Kínder,EduMax,83,22,61
2025-09-09,13,Kínder,SuperSchool,226,16,210
2025-09-09,13,Kínder,EduMax,195,23,172
2025-09-09,13,Kínder,EduMax,97,8,89
2025-09-09,13,Kínder,EduMax,223,17,206
2025-09-09,13,Kínder,EduMax,174,22,152
2025-09-09,13,Kínder,EduMax,289,23,266
2025-09-09,13,Kínder,EduMax,219,21,198
2025-09-09,13,Primaria 1°,TopKids,230,18,212
2025-09-09,13,Primaria 1°,SuperSchool,102,1,101
2025-09-09,13,Primaria 1°,SuperSchool,289,10,279
2025-09-09,13,Primaria 1°,TopKids,246,17,229
2025-09-09,13,Primaria 1°,TopKids,177,9,168
2025-09-09,13,Primaria 1°,SuperSchool,235,6,229
2025-09-09,13,Primaria 2°,EduMax,115,13,102
2025-09-09,13,Primaria 2°,TopKids,291,20,271
2025-09-09,13,Primaria 2°,EduMax,296,22,274
2025-09-09,13,Primaria 2°,TopKids,77,13,64
2025-09-09,13,Primaria 2°,EduMax,296,22,274
2025-09-09,13,Primaria 2°,SuperSchool,240,11,229
2025-09-09,13,Primaria 2°,EduMax,84,23,61
2025-09-09,13,Primaria 2°,SuperSchool,200,12,188
2025-09-09,13,Primaria 2°,TopKids,277,16,261
2025-09-09,13,Primaria 2°,TopKids,133,19,114
2025-09-09,13,Primaria 2°,EduMax,145,18,127
2025-09-09,13,Primaria 2°,SuperSchool,250,11,239
2025-09-09,13,Primaria 2°,TopKids,162,21,141
2025-09-09,13,Primaria 2°,EduMax,183,3,180
2025-09-09,13,Primaria 3°,SuperSchool,212,2,210
2025-09-09,13,Primaria 3°,TopKids,55,3,52
2025-09-09,13,Primaria 3°,SuperSchool,202,9,193
2025-09-09,13,Primaria 3°,EduMax,272,7,265
2025-09-09,13,Primaria 3°,TopKids,205,2,203
2025-09-09,13,Primaria 3°,SuperSchool,150,24,126
2025-09-09,13,Primaria 3°,EduMax,276,7,269
2025-09-09,13,Primaria 3°,EduMax,270,1,269
2025-09-09,13,Primaria 3°,TopKids,228,20,208
2025-09-09,13,Primaria 3°,EduMax,273,10,263
2025-09-09,13,Primaria 3°,EduMax,112,11,101
2025-09-09,13,Primaria 3°,SuperSchool,150,22,128
2025-09-09,13,Primaria 3°,TopKids,227,16,211
2025-09-09,13,Primaria 3°,EduMax,87,22,65
2025-09-09,13,Primaria 3°,EduMax,296,4,292
2025-09-09,13,Primaria 3°,SuperSchool,183,15,168
2025-09-09,13,Primaria 3°,EduMax,164,20,144
2025-09-09,13,Primaria 3°,SuperSchool,277,22,255
2025-09-09,13,Primaria 4°,EduMax,113,18,95
2025-09-09,13,Primaria 4°,TopKids,103,19,84
2025-09-09,13,Primaria 4°,TopKids,216,1,215
2025-09-09,13,Primaria 4°,EduMax,276,19,257
2025-09-09,13,Primaria 4°,EduMax,109,1,108
2025-09-09,13,Primaria 5°,TopKids,248,7,241
2025-09-09,13,Primaria 5°,EduMax,224,5,219
2025-09-09,13,Primaria 5°,EduMax,222,20,202
2025-09-09,13,Primaria 5°,EduMax,167,18,149
2025-09-09,13,Primaria 5°,SuperSchool,126,23,103
2025-09-09,13,Primaria 5°,SuperSchool,133,7,126
2025-09-09,13,Primaria 5°,EduMax,236,9,227
2025-09-09,13,Primaria 5°,EduMax,231,3,228
2025-09-09,13,Primaria 5°,TopKids,266,11,255
2025-09-09,13,Primaria 5°,EduMax,93,12,81
2025-09-09,13,Primaria 5°,SuperSchool,231,23,208
2025-09-09,13,Primaria 5°,SuperSchool,293,1,292
2025-09-09,13,Primaria 5°,EduMax,104,2,102
2025-09-09,13,Primaria 5°,EduMax,287,18,269
2025-09-09,13,Primaria 5°,EduMax,78,21,57
2025-09-09,13,Primaria 5°,SuperSchool,180,20,160
2025-09-09,13,Primaria 5°,EduMax,185,22,163
2025-09-09,13,Primaria 5°,SuperSchool,135,19,116
2025-09-09,13,Primaria 5°,EduMax,122,3,119
2025-09-09,13,Primaria 6°,EduMax,83,7,76
2025-09-09,13,Primaria 6°,EduMax,226,17,209
2025-09-09,13,Primaria 6°,SuperSchool,76,1,75
2025-09-09,13,Primaria 6°,SuperSchool,121,17,104
2025-09-09,13,Primaria 6°,TopKids,209,8,201
2025-09-09,13,Primaria 6°,TopKids,277,18,259
2025-09-09,13,Primaria 6°,SuperSchool,71,7,64
2025-09-09,13,Primaria 6°,EduMax,116,14,102
2025-09-09,13,Primaria 6°,SuperSchool,212,7,205
2025-09-09,13,Primaria 6°,TopKids,181,5,176
2025-09-09,14,Preescolar,SuperSchool,84,16,68
2025-09-09,14,Preescolar,TopKids,202,9,193
2025-09-09,14,Preescolar,SuperSchool,101,1,100
2025-09-09,14,Preescolar,SuperSchool,253,9,244
2025-09-09,14,Preescolar,EduMax,182,15,167
2025-09-09,14,Preescolar,EduMax,158,19,139
2025-09-09,14,Preescolar,TopKids,115,13,102
2025-09-09,14,Preescolar,TopKids,250,22,228
2025-09-09,14,Preescolar,EduMax,82,22,60
2025-09-09,14,Preescolar,TopKids,137,8,129
2025-09-09,14,Preescolar,EduMax,203,13,190
2025-09-09,14,Preescolar,TopKids,286,17,269
2025-09-09,14,Preescolar,SuperSchool,151,10,141
2025-09-09,14,Preescolar,SuperSchool,163,17,146
2025-09-09,14,Preescolar,TopKids,120,2,118
2025-09-09,14,Preescolar,TopKids,112,18,94
2025-09-09,14,Kínder,EduMax,69,13,56
2025-09-09,14,Kínder,TopKids,66,22,44
2025-09-09,14,Kínder,TopKids,280,3,277
2025-09-09,14,Kínder,TopKids,147,21,126
2025-09-09,14,Kínder,TopKids,188,14,174
2025-09-09,14,Kínder,TopKids,120,8,112
2025-09-09,14,Kínder,SuperSchool,292,11,281
2025-09-09,14,Primaria 1°,TopKids,94,22,72
2025-09-09,14,Primaria 1°,SuperSchool,282,19,263
2025-09-09,14,Primaria 1°,TopKids,173,23,150
2025-09-09,14,Primaria 1°,TopKids,78,6,72
2025-09-09,14,Primaria 1°,TopKids,182,8,174
2025-09-09,14,Primaria 2°,EduMax,131,21,110
2025-09-09,14,Primaria 2°,TopKids,266,20,246
2025-09-09,14,Primaria 2°,TopKids,135,8,127
2025-09-09,14,Primaria 2°,EduMax,106,14,92
2025-09-09,14,Primaria 2°,SuperSchool,120,6,114
2025-09-09,14,Primaria 2°,TopKids,119,12,107
2025-09-09,14,Primaria 2°,TopKids,263,15,248
2025-09-09,14,Primaria 2°,EduMax,138,19,119
2025-09-09,14,Primaria 2°,TopKids,190,16,174
2025-09-09,14,Primaria 2°,SuperSchool,209,21,188
2025-09-09,14,Primaria 2°,EduMax,219,13,206
2025-09-09,14,Primaria 2°,SuperSchool,219,7,212
2025-09-09,14,Primaria 2°,TopKids,86,3,83
2025-09-09,14,Primaria 2°,EduMax,292,10,282
2025-09-09,14,Primaria 3°,SuperSchool,201,7,194
2025-09-09,14,Primaria 3°,SuperSchool,266,10,256
2025-09-09,14,Primaria 3°,EduMax,151,21,130
2025-09-09,14,Primaria 3°,EduMax,105,8,97
2025-09-09,14,Primaria 3°,EduMax,195,7,188
2025-09-09,14,Primaria 3°,EduMax,210,24,186
2025-09-09,14,Primaria 3°,SuperSchool,191,23,168
2025-09-09,14,Primaria 3°,TopKids,261,7,254
2025-09-09,14,Primaria 3°,TopKids,207,5,202
2025-09-09,14,Primaria 3°,TopKids,297,21,276
2025-09-09,14,Primaria 3°,SuperSchool,101,3,98
2025-09-09,14,Primaria 3°,SuperSchool,184,6,178
2025-09-09,14,Primaria 3°,TopKids,119,2,117
2025-09-09,14,Primaria 4°,SuperSchool,170,11,159
2025-09-09,14,Primaria 4°,EduMax,136,6,130
2025-09-09,14,Primaria 4°,EduMax,192,11,181
2025-09-09,14,Primaria 4°,TopKids,256,13,243
2025-09-09,14,Primaria 4°,EduMax,53,14,39
2025-09-09,14,Primaria 4°,SuperSchool,187,22,165
2025-09-09,14,Primaria 4°,SuperSchool,189,24,165
2025-09-09,14,Primaria 4°,SuperSchool,243,20,223
2025-09-09,14,Primaria 4°,EduMax,207,15,192
2025-09-09,14,Primaria 4°,EduMax,291,10,281
2025-09-09,14,Primaria 5°,EduMax,54,16,38
2025-09-09,14,Primaria 5°,SuperSchool,164,3,161
2025-09-09,14,Primaria 5°,TopKids,228,12,216
2025-09-09,14,Primaria 5°,EduMax,86,2,84
2025-09-09,14,Primaria 5°,TopKids,63,15,48
2025-09-09,14,Primaria 5°,SuperSchool,162,20,142
2025-09-09,14,Primaria 5°,TopKids,75,15,60
2025-09-09,14,Primaria 5°,TopKids,122,3,119
2025-09-09,14,Primaria 5°,EduMax,280,9,271
2025-09-09,14,Primaria 5°,EduMax,79,5,74
2025-09-09,14,Primaria 5°,SuperSchool,52,9,43
2025-09-09,14,Primaria 6°,SuperSchool,169,17,152
2025-09-09,14,Primaria 6°,SuperSchool,191,22,169
2025-09-09,14,Primaria 6°,EduMax,290,24,266
2025-09-09,14,Primaria 6°,TopKids,165,15,150
2025-09-09,14,Primaria 6°,TopKids,141,7,134
2025-09-09,14,Primaria 6°,EduMax,268,2,266
2025-09-09,14,Primaria 6°,TopKids,196,6,190
2025-09-09,14,Primaria 6°,EduMax,141,12,129
2025-09-09,14,Primaria 6°,TopKids,158,7,151
2025-09-09,14,Primaria 6°,TopKids,113,15,98
2025-09-09,14,Primaria 6°,EduMax,149,3,146
2025-09-09,14,Primaria 6°,SuperSchool,56,9,47
2025-09-09,15,Preescolar,SuperSchool,96,4,92
2025-09-09,15,Preescolar,EduMax,51,23,28
2025-09-09,15,Preescolar,TopKids,270,24,246
2025-09-09,15,Preescolar,TopKids,215,15,200
2025-09-09,15,Preescolar,TopKids,276,20,256
2025-09-09,15,Kínder,SuperSchool,248,23,225
2025-09-09,15,Kínder,TopKids,99,17,82
2025-09-09,15,Kínder,SuperSchool,51,5,46
2025-09-09,15,Kínder,EduMax,134,13,121
2025-09-09,15,Kínder,SuperSchool,60,24,36
2025-09-09,15,Kínder,SuperSchool,76,23,53
2025-09-09,15,Kínder,TopKids,67,21,46
2025-09-09,15,Kínder,SuperSchool,90,11,79
2025-09-09,15,Kínder,SuperSchool,188,3,185
2025-09-09,15,Kínder,TopKids,101,23,78
2025-09-09,15,Kínder,SuperSchool,220,14,206
2025-09-09,15,Kínder,EduMax,292,21,271
2025-09-09,15,Kínder,SuperSchool,208,15,193
2025-09-09,15,Kínder,TopKids,227,4,223
2025-09-09,15,Kínder,TopKids,244,12,232
2025-09-09,15,Kínder,SuperSchool,141,16,125
2025-09-09,15,Primaria 1°,EduMax,147,22,125
2025-09-09,15,Primaria 1°,TopKids,272,16,256
2025-09-09,15,Primaria 1°,EduMax,219,9,210
2025-09-09,15,Primaria 1°,EduMax,170,8,162
2025-09-09,15,Primaria 1°,EduMax,252,2,250
2025-09-09,15,Primaria 1°,TopKids,160,18,142
2025-09-09,15,Primaria 1°,SuperSchool,171,7,164
2025-09-09,15,Primaria 1°,TopKids,68,19,49
2025-09-09,15,Primaria 1°,EduMax,161,19,142
2025-09-09,15,Primaria 2°,SuperSchool,281,11,270
2025-09-09,15,Primaria 2°,EduMax,188,23,165
2025-09-09,15,Primaria 2°,SuperSchool,191,2,189
2025-09-09,15,Primaria 2°,SuperSchool,162,21,141
2025-09-09,15,Primaria 2°,EduMax,246,1,245
2025-09-09,15,Primaria 3°,TopKids,255,18,237
2025-09-09,15,Primaria 3°,TopKids,255,16,239
2025-09-09,15,Primaria 3°,SuperSchool,197,20,177
2025-09-09,15,Primaria 3°,TopKids,282,17,265
2025-09-09,15,Primaria 3°,SuperSchool,219,7,212
2025-09-09,15,Primaria 3°,TopKids,233,21,212
2025-09-09,15,Primaria 3°,TopKids,249,24,225
2025-09-09,15,Primaria 3°,TopKids,74,21,53
2025-09-09,15,Primaria 3°,EduMax,167,1,166
2025-09-09,15,Primaria 3°,EduMax,263,19,244
2025-09-09,15,Primaria 3°,SuperSchool,52,7,45
2025-09-09,15,Primaria 3°,SuperSchool,144,6,138
2025-09-09,15,Primaria 3°,EduMax,61,14,47
2025-09-09,15,Primaria 4°,EduMax,180,1,179
2025-09-09,15,Primaria 4°,TopKids,201,15,186
2025-09-09,15,Primaria 4°,EduMax,133,16,117
2025-09-09,15,Primaria 4°,EduMax,160,7,153
2025-09-09,15,Primaria 4°,SuperSchool,246,5,241
2025-09-09,15,Primaria 4°,SuperSchool,235,9,226
2025-09-09,15,Primaria 4°,TopKids,273,14,259
2025-09-09,15,Primaria 4°,TopKids,175,18,157
2025-09-09,15,Primaria 4°,SuperSchool,148,11,137
2025-09-09,15,Primaria 4°,TopKids,77,4,73
2025-09-09,15,Primaria 5°,SuperSchool,203,18,185
2025-09-09,15,Primaria 5°,EduMax,264,12,252
2025-09-09,15,Primaria 5°,SuperSchool,203,22,181
2025-09-09,15,Primaria 5°,EduMax,90,22,68
2025-09-09,15,Primaria 5°,SuperSchool,195,5,190
2025-09-09,15,Primaria 5°,EduMax,273,14,259
2025-09-09,15,Primaria 5°,TopKids,198,22,176
2025-09-09,15,Primaria 5°,TopKids,58,2,56
2025-09-09,15,Primaria 5°,EduMax,77,2,75
2025-09-09,15,Primaria 6°,TopKids,59,19,40
2025-09-09,15,Primaria 6°,SuperSchool,51,16,35
2025-09-09,15,Primaria 6°,EduMax,93,22,71
2025-09-09,15,Primaria 6°,TopKids,85,8,77
2025-09-09,15,Primaria 6°,TopKids,59,1,58
2025-09-09,15,Primaria 6°,SuperSchool,151,19,132
2025-09-09,15,Primaria 6°,EduMax,164,19,145
2025-09-09,15,Primaria 6°,TopKids,178,20,158
2025-09-09,15,Primaria 6°,TopKids,180,10,170
2025-09-09,16,Preescolar,TopKids,98,24,74
2025-09-09,16,Preescolar,EduMax,193,7,186
2025-09-09,16,Preescolar,SuperSchool,145,12,133
2025-09-09,16,Preescolar,SuperSchool,188,1,187
2025-09-09,16,Preescolar,SuperSchool,66,19,47
2025-09-09,16,Preescolar,SuperSchool,232,15,217
2025-09-09,16,Preescolar,SuperSchool,105,12,93
2025-09-09,16,Preescolar,SuperSchool,290,3,287
2025-09-09,16,Preescolar,TopKids,179,2,177
2025-09-09,16,Preescolar,SuperSchool,215,4,211
2025-09-09,16,Preescolar,TopKids,283,14,269
2025-09-09,16,Preescolar,SuperSchool,128,7,121
2025-09-09,16,Preescolar,TopKids,249,19,230
2025-09-09,16,Preescolar,EduMax,66,18,48
2025-09-09,16,Preescolar,TopKids,166,8,158
2025-09-09,16,Kínder,TopKids,60,19,41
2025-09-09,16,Kínder,TopKids,204,5,199
2025-09-09,16,Kínder,SuperSchool,111,8,103
2025-09-09,16,Kínder,EduMax,278,15,263
2025-09-09,16,Kínder,TopKids,193,10,183
2025-09-09,16,Kínder,TopKids,245,14,231
2025-09-09,16,Kínder,SuperSchool,153,21,132
2025-09-09,16,Kínder,EduMax,285,1,284
2025-09-09,16,Kínder,TopKids,292,18,274
2025-09-09,16,Kínder,EduMax,70,1,69
2025-09-09,16,Kínder,EduMax,250,15,235
2025-09-09,16,Kínder,SuperSchool,199,23,176
2025-09-09,16,Kínder,EduMax,90,11,79
2025-09-09,16,Kínder,SuperSchool,93,16,77
2025-09-09,16,Kínder,TopKids,54,19,35
2025-09-09,16,Kínder,SuperSchool,233,18,215
2025-09-09,16,Kínder,SuperSchool,85,24,61
2025-09-09,16,Primaria 1°,EduMax,118,8,110
2025-09-09,16,Primaria 1°,EduMax,82,5,77
2025-09-09,16,Primaria 1°,EduMax,145,18,127
2025-09-09,16,Primaria 1°,TopKids,187,4,183
2025-09-09,16,Primaria 1°,EduMax,66,21,45
2025-09-09,16,Primaria 1°,TopKids,299,13,286
2025-09-09,16,Primaria 1°,SuperSchool,171,18,153
2025-09-09,16,Primaria 1°,EduMax,120,17,103
2025-09-09,16,Primaria 1°,SuperSchool,103,23,80
2025-09-09,16,Primaria 1°,TopKids,234,19,215
2025-09-09,16,Primaria 1°,EduMax,196,8,188
2025-09-09,16,Primaria 1°,SuperSchool,198,19,179
2025-09-09,16,Primaria 1°,TopKids,84,6,78
2025-09-09,16,Primaria 1°,EduMax,192,24,168
2025-09-09,16,Primaria 1°,SuperSchool,117,7,110
2025-09-09,16,Primaria 1°,EduMax,177,17,160
2025-09-09,16,Primaria 1°,EduMax,299,6,293
2025-09-09,16,Primaria 1°,EduMax,94,7,87
2025-09-09,16,Primaria 1°,SuperSchool,104,19,85
2025-09-09,16,Primaria 2°,SuperSchool,160,17,143
2025-09-09,16,Primaria 2°,SuperSchool,232,19,213
2025-09-09,16,Primaria 2°,EduMax,253,15,238
2025-09-09,16,Primaria 2°,TopKids,180,4,176
2025-09-09,16,Primaria 2°,SuperSchool,87,6,81
2025-09-09,16,Primaria 2°,SuperSchool,141,8,133
2025-09-09,16,Primaria 2°,TopKids,165,24,141
2025-09-09,16,Primaria 2°,TopKids,262,22,240
2025-09-09,16,Primaria 3°,SuperSchool,128,17,111
2025-09-09,16,Primaria 3°,SuperSchool,162,23,139
2025-09-09,16,Primaria 3°,TopKids,275,22,253
2025-09-09,16,Primaria 3°,EduMax,116,22,94
2025-09-09,16,Primaria 3°,SuperSchool,55,1,54
2025-09-09,16,Primaria 3°,EduMax,228,4,224
2025-09-09,16,Primaria 3°,SuperSchool,165,8,157
2025-09-09,16,Primaria 3°,TopKids,278,10,268
2025-09-09,16,Primaria 3°,TopKids,229,19,210
2025-09-09,16,Primaria 3°,SuperSchool,218,24,194
2025-09-09,16,Primaria 3°,SuperSchool,209,18,191
2025-09-09,16,Primaria 3°,EduMax,66,1,65
2025-09-09,16,Primaria 3°,EduMax,170,21,149
2025-09-09,16,Primaria 3°,TopKids,228,2,226
2025-09-09,16,Primaria 3°,EduMax,201,24,177
2025-09-09,16,Primaria 3°,TopKids,240,14,226
2025-09-09,16,Primaria 3°,EduMax,83,15,68
2025-09-09,16,Primaria 4°,EduMax,210,12,198
2025-09-09,16,Primaria 4°,EduMax,160,18,142
2025-09-09,16,Primaria 4°,TopKids,152,12,140
2025-09-09,16,Primaria 4°,EduMax,243,2,241
2025-09-09,16,Primaria 4°,EduMax,261,6,255
2025-09-09,16,Primaria 5°,TopKids,91,3,88
2025-09-09,16,Primaria 5°,SuperSchool,278,10,268
2025-09-09,16,Primaria 5°,SuperSchool,136,13,123
2025-09-09,16,Primaria 5°,SuperSchool,265,3,262
2025-09-09,16,Primaria 5°,EduMax,240,19,221
2025-09-09,16,Primaria 5°,EduMax,108,20,88
2025-09-09,16,Primaria 5°,TopKids,114,10,104
2025-09-09,16,Primaria 5°,EduMax,110,22,88
2025-09-09,16,Primaria 5°,SuperSchool,209,19,190
2025-09-09,16,Primaria 5°,TopKids,204,13,191
2025-09-09,16,Primaria 5°,SuperSchool,205,20,185
2025-09-09,16,Primaria 5°,EduMax,213,15,198
2025-09-09,16,Primaria 5°,EduMax,209,6,203
2025-09-09,16,Primaria 5°,EduMax,144,23,121
2025-09-09,16,Primaria 5°,SuperSchool,156,20,136
2025-09-09,16,Primaria 5°,SuperSchool,89,17,72
2025-09-09,16,Primaria 6°,TopKids,136,4,132
2025-09-09,16,Primaria 6°,TopKids,156,11,145
2025-09-09,16,Primaria 6°,TopKids,299,21,278
2025-09-09,16,Primaria 6°,SuperSchool,128,5,123
2025-09-09,16,Primaria 6°,EduMax,72,5,67
2025-09-09,16,Primaria 6°,SuperSchool,237,11,226
2025-09-09,16,Primaria 6°,SuperSchool,271,23,248
2025-09-09,16,Primaria 6°,EduMax,244,20,224
2025-09-09,16,Primaria 6°,TopKids,224,18,206
2025-09-09,16,Primaria 6°,TopKids,278,11,267
2025-09-09,16,Primaria 6°,TopKids,277,16,261
2025-09-09,16,Primaria 6°,EduMax,156,1,155
2025-09-09,16,Primaria 6°,TopKids,267,13,254
2025-09-09,16,Primaria 6°,EduMax,292,6,286
2025-09-09,16,Primaria 6°,TopKids,101,19,82
2025-09-09,16,Primaria 6°,EduMax,286,11,275
2025-09-09,16,Primaria 6°,TopKids,88,12,76
2025-09-09,16,Primaria 6°,SuperSchool,266,15,251
2025-09-09,16,Primaria 6°,SuperSchool,123,18,105
2025-09-10,9,Preescolar,EduMax,247,8,239
2025-09-10,9,Preescolar,EduMax,58,23,35
2025-09-10,9,Preescolar,SuperSchool,281,24,257
2025-09-10,9,Preescolar,EduMax,216,19,197
2025-09-10,9,Preescolar,TopKids,163,1,162
2025-09-10,9,Preescolar,TopKids,154,10,144
2025-09-10,9,Preescolar,EduMax,50,17,33
2025-09-10,9,Preescolar,TopKids,285,12,273
2025-09-10,9,Kínder,SuperSchool,152,23,129
2025-09-10,9,Kínder,TopKids,169,2,167
2025-09-10,9,Kínder,TopKids,218,10,208
2025-09-10,9,Kínder,SuperSchool,155,3,152
2025-09-10,9,Kínder,SuperSchool,194,14,180
2025-09-10,9,Kínder,TopKids,259,18,241
2025-09-10,9,Kínder,EduMax,84,10,74
2025-09-10,9,Primaria 1°,SuperSchool,263,12,251
2025-09-10,9,Primaria 1°,SuperSchool,209,10,199
2025-09-10,9,Primaria 1°,EduMax,196,16,180
2025-09-10,9,Primaria 1°,SuperSchool,166,3,163
2025-09-10,9,Primaria 1°,SuperSchool,268,15,253
2025-09-10,9,Primaria 1°,TopKids,296,13,283
2025-09-10,9,Primaria 1°,EduMax,62,11,51
2025-09-10,9,Primaria 1°,EduMax,247,5,242
2025-09-10,9,Primaria 1°,TopKids,104,23,81
2025-09-10,9,Primaria 1°,TopKids,156,6,150
2025-09-10,9,Primaria 1°,SuperSchool,58,20,38
2025-09-10,9,Primaria 2°,EduMax,121,18,103
2025-09-10,9,Primaria 2°,SuperSchool,215,2,213
2025-09-10,9,Primaria 2°,SuperSchool,71,24,47
2025-09-10,9,Primaria 2°,TopKids,117,16,101
2025-09-10,9,Primaria 2°,SuperSchool,97,1,96
2025-09-10,9,Primaria 2°,SuperSchool,246,16,230
2025-09-10,9,Primaria 2°,SuperSchool,241,3,238
2025-09-10,9,Primaria 2°,EduMax,291,21,270
2025-09-10,9,Primaria 2°,EduMax,163,17,146
2025-09-10,9,Primaria 2°,TopKids,218,11,207
2025-09-10,9,Primaria 2°,EduMax,236,9,227
2025-09-10,9,Primaria 2°,SuperSchool,293,5,288
2025-09-10,9,Primaria 2°,EduMax,234,16,218
2025-09-10,9,Primaria 3°,EduMax,162,14,148
2025-09-10,9,Primaria 3°,EduMax,134,24,110
2025-09-10,9,Primaria 3°,EduMax,245,8,237
2025-09-10,9,Primaria 3°,EduMax,290,1,289
2025-09-10,9,Primaria 3°,TopKids,162,20,142
2025-09-10,9,Primaria 3°,TopKids,88,11,77
2025-09-10,9,Primaria 3°,SuperSchool,224,7,217
2025-09-10,9,Primaria 3°,TopKids,54,17,37
2025-09-10,9,Primaria 3°,SuperSchool,50,22,28
2025-09-10,9,Primaria 3°,SuperSchool,233,7,226
2025-09-10,9,Primaria 3°,SuperSchool,241,8,233
2025-09-10,9,Primaria 3°,EduMax,175,2,173
2025-09-10,9,Primaria 3°,SuperSchool,145,22,123
2025-09-10,9,Primaria 4°,EduMax,200,3,197
2025-09-10,9,Primaria 4°,TopKids,127,8,119
2025-09-10,9,Primaria 4°,TopKids,214,3,211
2025-09-10,9,Primaria 4°,SuperSchool,68,15,53
2025-09-10,9,Primaria 4°,SuperSchool,50,5,45
2025-09-10,9,Primaria 4°,TopKids,223,22,201
2025-09-10,9,Primaria 4°,EduMax,69,9,60
2025-09-10,9,Primaria 4°,EduMax,288,11,277
2025-09-10,9,Primaria 4°,SuperSchool,256,24,232
2025-09-10,9,Primaria 4°,EduMax,189,23,166
2025-09-10,9,Primaria 4°,TopKids,115,8,107
2025-09-10,9,Primaria 4°,SuperSchool,299,5,294
2025-09-10,9,Primaria 4°,TopKids,68,19,49
2025-09-10,9,Primaria 4°,SuperSchool,94,6,88
2025-09-10,9,Primaria 4°,EduMax,178,10,168
2025-09-10,9,Primaria 4°,TopKids,170,6,164
2025-09-10,9,Primaria 5°,TopKids,203,13,190
2025-09-10,9,Primaria 5°,TopKids,187,13,174
2025-09-10,9,Primaria 5°,TopKids,64,23,41
2025-09-10,9,Primaria 5°,TopKids,208,8,200
2025-09-10,9,Primaria 5°,TopKids,79,2,77
2025-09-10,9,Primaria 5°,SuperSchool,50,16,34
2025-09-10,9,Primaria 5°,EduMax,60,22,38
2025-09-10,9,Primaria 5°,TopKids,221,6,215
2025-09-10,9,Primaria 5°,SuperSchool,225,8,217
2025-09-10,9,Primaria 5°,TopKids,261,3,258
2025-09-10,9,Primaria 5°,TopKids,50,23,27
2025-09-10,9,Primaria 5°,EduMax,244,19,225
2025-09-10,9,Primaria 5°,EduMax,194,16,178
2025-09-10,9,Primaria 6°,SuperSchool,110,7,103
2025-09-10,9,Primaria 6°,TopKids,151,11,140
2025-09-10,9,Primaria 6°,TopKids,139,22,117
2025-09-10,9,Primaria 6°,TopKids,184,15,169
2025-09-10,9,Primaria 6°,SuperSchool,258,23,235
2025-09-10,9,Primaria 6°,EduMax,140,21,119
2025-09-10,9,Primaria 6°,TopKids,168,21,147
2025-09-10,9,Primaria 6°,EduMax,139,12,127
2025-09-10,9,Primaria 6°,TopKids,231,17,214
2025-09-10,9,Primaria 6°,EduMax,168,16,152
2025-09-10,9,Primaria 6°,TopKids,235,15,220
2025-09-10,9,Primaria 6°,TopKids,133,4,129
2025-09-10,9,Primaria 6°,TopKids,71,3,68
2025-09-10,9,Primaria 6°,EduMax,143,10,133
2025-09-10,9,Primaria 6°,EduMax,140,11,129
2025-09-10,10,Preescolar,EduMax,129,24,105
2025-09-10,10,Preescolar,SuperSchool,217,9,208
2025-09-10,10,Preescolar,SuperSchool,91,23,68
2025-09-10,10,Preescolar,SuperSchool,264,21,243
2025-09-10,10,Preescolar,SuperSchool,258,19,239
2025-09-10,10,Preescolar,SuperSchool,104,21,83
2025-09-10,10,Preescolar,EduMax,136,6,130
2025-09-10,10,Preescolar,EduMax,90,6,84
2025-09-10,10,Kínder,SuperSchool,215,9,206
2025-09-10,10,Kínder,SuperSchool,257,16,241
2025-09-10,10,Kínder,TopKids,86,11,75
2025-09-10,10,Kínder,SuperSchool,256,8,248
2025-09-10,10,Kínder,TopKids,241,11,230
2025-09-10,10,Kínder,SuperSchool,190,23,167
2025-09-10,10,Kínder,EduMax,172,2,170
2025-09-10,10,Kínder,TopKids,299,12,287
2025-09-10,10,Kínder,EduMax,197,22,175
2025-09-10,10,Kínder,SuperSchool,235,20,215
2025-09-10,10,Kínder,TopKids,88,14,74
2025-09-10,10,Kínder,SuperSchool,267,2,265
2025-09-10,10,Kínder,SuperSchool,209,9,200
2025-09-10,10,Kínder,SuperSchool,118,4,114
2025-09-10,10,Primaria 1°,SuperSchool,274,9,265
2025-09-10,10,Primaria 1°,TopKids,203,3,200
2025-09-10,10,Primaria 1°,TopKids,280,18,262
2025-09-10,10,Primaria 1°,SuperSchool,165,7,158
2025-09-10,10,Primaria 1°,SuperSchool,265,4,261
2025-09-10,10,Primaria 1°,SuperSchool,81,10,71
2025-09-10,10,Primaria 1°,EduMax,132,14,118
2025-09-10,10,Primaria 1°,EduMax,107,13,94
2025-09-10,10,Primaria 1°,EduMax,272,12,260
2025-09-10,10,Primaria 1°,EduMax,200,12,188
2025-09-10,10,Primaria 1°,TopKids,63,4,59
2025-09-10,10,Primaria 2°,TopKids,168,3,165
2025-09-10,10,Primaria 2°,EduMax,228,18,210
2025-09-10,10,Primaria 2°,TopKids,286,23,263
2025-09-10,10,Primaria 2°,EduMax,87,23,64
2025-09-10,10,Primaria 2°,EduMax,69,1,68
2025-09-10,10,Primaria 2°,EduMax,280,5,275
2025-09-10,10,Primaria 2°,EduMax,292,2,290
2025-09-10,10,Primaria 2°,TopKids,261,10,251
2025-09-10,10,Primaria 2°,EduMax,262,8,254
2025-09-10,10,Primaria 2°,SuperSchool,179,3,176
2025-09-10,10,Primaria 2°,TopKids,271,6,265
2025-09-10,10,Primaria 2°,SuperSchool,183,10,173
2025-09-10,10,Primaria 2°,TopKids,258,8,250
2025-09-10,10,Primaria 2°,SuperSchool,147,17,130
2025-09-10,10,Primaria 2°,TopKids,163,22,141
2025-09-10,10,Primaria 2°,TopKids,90,8,82
2025-09-10,10,Primaria 2°,SuperSchool,152,7,145
2025-09-10,10,Primaria 3°,SuperSchool,89,20,69
2025-09-10,10,Primaria 3°,SuperSchool,116,19,97
2025-09-10,10,Primaria 3°,EduMax,255,21,234
2025-09-10,10,Primaria 3°,EduMax,187,20,167
2025-09-10,10,Primaria 3°,EduMax,237,17,220
2025-09-10,10,Primaria 3°,EduMax,268,1,267
2025-09-10,10,Primaria 3°,EduMax,213,1,212
2025-09-10,10,Primaria 3°,EduMax,162,3,159
2025-09-10,10,Primaria 3°,EduMax,131,4,127
2025-09-10,10,Primaria 3°,SuperSchool,52,12,40
2025-09-10,10,Primaria 3°,EduMax,193,11,182
2025-09-10,10,Primaria 4°,TopKids,219,21,198
2025-09-10,10,Primaria 4°,SuperSchool,276,24,252
2025-09-10,10,Primaria 4°,EduMax,159,12,147
2025-09-10,10,Primaria 4°,EduMax,90,14,76
2025-09-10,10,Primaria 4°,SuperSchool,180,20,160
2025-09-10,10,Primaria 4°,EduMax,268,20,248
2025-09-10,10,Primaria 4°,SuperSchool,220,15,205
2025-09-10,10,Primaria 4°,EduMax,132,19,113
2025-09-10,10,Primaria 4°,EduMax,96,21,75
2025-09-10,10,Primaria 4°,EduMax,54,11,43
2025-09-10,10,Primaria 4°,SuperSchool,241,13,228
2025-09-10,10,Primaria 4°,SuperSchool,200,13,187
2025-09-10,10,Primaria 4°,TopKids,196,1,195
2025-09-10,10,Primaria 4°,SuperSchool,106,2,104
2025-09-10,10,Primaria 5°,SuperSchool,53,1,52
2025-09-10,10,Primaria 5°,EduMax,287,13,274
2025-09-10,10,Primaria 5°,EduMax,226,23,203
2025-09-10,10,Primaria 5°,TopKids,224,7,217
2025-09-10,10,Primaria 5°,EduMax,79,8,71
2025-09-10,10,Primaria 5°,TopKids,205,21,184
2025-09-10,10,Primaria 5°,EduMax,69,11,58
2025-09-10,10,Primaria 5°,EduMax,201,13,188
2025-09-10,10,Primaria 6°,SuperSchool,199,9,190
2025-09-10,10,Primaria 6°,EduMax,235,10,225
2025-09-10,10,Primaria 6°,TopKids,60,16,44
2025-09-10,10,Primaria 6°,EduMax,230,9,221
2025-09-10,10,Primaria 6°,TopKids,295,4,291
2025-09-10,10,Primaria 6°,TopKids,283,13,270
2025-09-10,10,Primaria 6°,SuperSchool,221,11,210
2025-09-10,10,Primaria 6°,SuperSchool,243,17,226
2025-09-10,10,Primaria 6°,SuperSchool,197,15,182
2025-09-10,10,Primaria 6°,EduMax,60,23,37
2025-09-10,10,Primaria 6°,SuperSchool,219,18,201
2025-09-10,10,Primaria 6°,TopKids,164,4,160
2025-09-10,11,Preescolar,EduMax,94,2,92
2025-09-10,11,Preescolar,SuperSchool,288,18,270
2025-09-10,11,Preescolar,TopKids,246,14,232
2025-09-10,11,Preescolar,EduMax,225,14,211
2025-09-10,11,Preescolar,SuperSchool,279,9,270
2025-09-10,11,Preescolar,SuperSchool,150,11,139
2025-09-10,11,Preescolar,SuperSchool,55,20,35
2025-09-10,11,Preescolar,SuperSchool,55,15,40
2025-09-10,11,Preescolar,TopKids,226,22,204
2025-09-10,11,Preescolar,TopKids,196,23,173
2025-09-10,11,Kínder,SuperSchool,154,7,147
2025-09-10,11,Kínder,SuperSchool,65,6,59
2025-09-10,11,Kínder,SuperSchool,299,13,286
2025-09-10,11,Kínder,EduMax,95,5,90
2025-09-10,11,Kínder,TopKids,96,6,90
2025-09-10,11,Kínder,EduMax,161,20,141
2025-09-10,11,Primaria 1°,SuperSchool,119,13,106
2025-09-10,11,Primaria 1°,EduMax,137,13,124
2025-09-10,11,Primaria 1°,EduMax,290,24,266
2025-09-10,11,Primaria 1°,EduMax,236,7,229
2025-09-10,11,Primaria 1°,TopKids,265,22,243
2025-09-10,11,Primaria 1°,SuperSchool,97,10,87
2025-09-10,11,Primaria 1°,EduMax,79,21,58
2025-09-10,11,Primaria 1°,EduMax,100,3,97
2025-09-10,11,Primaria 1°,EduMax,100,23,77
2025-09-10,11,Primaria 1°,SuperSchool,281,18,263
2025-09-10,11,Primaria 1°,EduMax,196,18,178
2025-09-10,11,Primaria 1°,EduMax,132,22,110
2025-09-10,11,Primaria 1°,SuperSchool,61,15,46
2025-09-10,11,Primaria 1°,EduMax,192,10,182
2025-09-10,11,Primaria 1°,EduMax,110,19,91
2025-09-10,11,Primaria 1°,SuperSchool,249,19,230
2025-09-10,11,Primaria 1°,SuperSchool,272,9,263
2025-09-10,11,Primaria 2°,TopKids,249,9,240
2025-09-10,11,Primaria 2°,SuperSchool,128,16,112
2025-09-10,11,Primaria 2°,TopKids,155,19,136
2025-09-10,11,Primaria 2°,EduMax,138,12,126
2025-09-10,11,Primaria 2°,TopKids,59,24,35
2025-09-10,11,Primaria 2°,EduMax,245,11,234
2025-09-10,11,Primaria 2°,SuperSchool,222,10,212
2025-09-10,11,Primaria 2°,EduMax,280,11,269
2025-09-10,11,Primaria 2°,SuperSchool,266,9,257
2025-09-10,11,Primaria 2°,EduMax,177,1,176
2025-09-10,11,Primaria 2°,SuperSchool,65,5,60
2025-09-10,11,Primaria 2°,SuperSchool,184,8,176
2025-09-10,11,Primaria 2°,TopKids,113,1,112
2025-09-10,11,Primaria 2°,EduMax,71,11,60
2025-09-10,11,Primaria 2°,EduMax,231,16,215
2025-09-10,11,Primaria 2°,SuperSchool,188,21,167
2025-09-10,11,Primaria 2°,SuperSchool,76,7,69
2025-09-10,11,Primaria 3°,TopKids,156,23,133
2025-09-10,11,Primaria 3°,TopKids,270,7,263
2025-09-10,11,Primaria 3°,TopKids,193,8,185
2025-09-10,11,Primaria 3°,EduMax,219,9,210
2025-09-10,11,Primaria 3°,TopKids,248,8,240
2025-09-10,11,Primaria 3°,TopKids,97,22,75
2025-09-10,11,Primaria 3°,SuperSchool,287,7,280
2025-09-10,11,Primaria 3°,EduMax,248,12,236
2025-09-10,11,Primaria 3°,TopKids,236,1,235
2025-09-10,11,Primaria 3°,EduMax,220,11,209
2025-09-10,11,Primaria 4°,SuperSchool,253,23,230
2025-09-10,11,Primaria 4°,TopKids,136,19,117
2025-09-10,11,Primaria 4°,SuperSchool,227,21,206
2025-09-10,11,Primaria 4°,SuperSchool,219,19,200
2025-09-10,11,Primaria 4°,TopKids,227,1,226
2025-09-10,11,Primaria 5°,EduMax,91,18,73
2025-09-10,11,Primaria 5°,SuperSchool,142,22,120
2025-09-10,11,Primaria 5°,EduMax,235,21,214
2025-09-10,11,Primaria 5°,TopKids,70,18,52
2025-09-10,11,Primaria 5°,TopKids,117,15,102
2025-09-10,11,Primaria 5°,EduMax,67,9,58
2025-09-10,11,Primaria 5°,SuperSchool,241,17,224
2025-09-10,11,Primaria 6°,TopKids,286,7,279
2025-09-10,11,Primaria 6°,EduMax,235,6,229
2025-09-10,11,Primaria 6°,EduMax,287,14,273
2025-09-10,11,Primaria 6°,EduMax,58,12,46
2025-09-10,11,Primaria 6°,EduMax,169,23,146
2025-09-10,11,Primaria 6°,EduMax,129,18,111
2025-09-10,11,Primaria 6°,SuperSchool,170,8,162
2025-09-10,11,Primaria 6°,SuperSchool,246,7,239
2025-09-10,11,Primaria 6°,EduMax,135,11,124
2025-09-10,11,Primaria 6°,SuperSchool,171,6,165
2025-09-10,11,Primaria 6°,TopKids,181,24,157
2025-09-10,11,Primaria 6°,TopKids,279,5,274
2025-09-10,11,Primaria 6°,TopKids,154,4,150
2025-09-10,11,Primaria 6°,EduMax,224,4,220
2025-09-10,11,Primaria 6°,EduMax,223,10,213
2025-09-10,11,Primaria 6°,TopKids,56,18,38
2025-09-10,11,Primaria 6°,TopKids,270,8,262
2025-09-10,11,Primaria 6°,SuperSchool,54,6,48
2025-09-10,12,Preescolar,TopKids,280,15,265
2025-09-10,12,Preescolar,TopKids,126,18,108
2025-09-10,12,Preescolar,EduMax,217,11,206
2025-09-10,12,Preescolar,TopKids,179,20,159
2025-09-10,12,Preescolar,EduMax,169,13,156
2025-09-10,12,Preescolar,EduMax,285,8,277
2025-09-10,12,Preescolar,SuperSchool,236,6,230
2025-09-10,12,Preescolar,TopKids,264,23,241
2025-09-10,12,Preescolar,EduMax,76,10,66
2025-09-10,12,Preescolar,TopKids,205,2,203
2025-09-10,12,Preescolar,SuperSchool,210,18,192
2025-09-10,12,Preescolar,EduMax,223,3,220
2025-09-10,12,Preescolar,TopKids,90,13,77
2025-09-10,12,Preescolar,TopKids,182,5,177
2025-09-10,12,Kínder,EduMax,242,17,225
2025-09-10,12,Kínder,TopKids,226,9,217
2025-09-10,12,Kínder,EduMax,174,15,159
2025-09-10,12,Kínder,SuperSchool,206,21,185
2025-09-10,12,Kínder,SuperSchool,134,17,117
2025-09-10,12,Kínder,TopKids,77,23,54
2025-09-10,12,Kínder,TopKids,149,3,146
2025-09-10,12,Kínder,SuperSchool,248,5,243
2025-09-10,12,Kínder,EduMax,66,17,49
2025-09-10,12,Kínder,TopKids,116,3,113
2025-09-10,12,Primaria 1°,SuperSchool,109,24,85
2025-09-10,12,Primaria 1°,EduMax,150,13,137
2025-09-10,12,Primaria 1°,EduMax,199,1,198
2025-09-10,12,Primaria 1°,EduMax,248,17,231
2025-09-10,12,Primaria 1°,TopKids,161,14,147
2025-09-10,12,Primaria 1°,TopKids,123,23,100
2025-09-10,12,Primaria 2°,SuperSchool,201,16,185
2025-09-10,12,Primaria 2°,SuperSchool,62,5,57
2025-09-10,12,Primaria 2°,EduMax,165,11,154
2025-09-10,12,Primaria 2°,SuperSchool,103,22,81
2025-09-10,12,Primaria 2°,SuperSchool,77,1,76
2025-09-10,12,Primaria 2°,EduMax,252,10,242
2025-09-10,12,Primaria 3°,SuperSchool,198,16,182
2025-09-10,12,Primaria 3°,TopKids,216,14,202
2025-09-10,12,Primaria 3°,EduMax,265,11,254
2025-09-10,12,Primaria 3°,TopKids,158,5,153
2025-09-10,12,Primaria 3°,EduMax,52,12,40
2025-09-10,12,Primaria 4°,EduMax,69,15,54
2025-09-10,12,Primaria 4°,SuperSchool,164,10,154
2025-09-10,12,Primaria 4°,EduMax,256,2,254
2025-09-10,12,Primaria 4°,SuperSchool,98,10,88
2025-09-10,12,Primaria 4°,SuperSchool,183,6,177
2025-09-10,12,Primaria 4°,EduMax,170,14,156
2025-09-10,12,Primaria 4°,SuperSchool,62,10,52
2025-09-10,12,Primaria 4°,TopKids,148,15,133
2025-09-10,12,Primaria 4°,TopKids,86,8,78
2025-09-10,12,Primaria 4°,EduMax,237,22,215
2025-09-10,12,Primaria 4°,SuperSchool,171,2,169
2025-09-10,12,Primaria 5°,TopKids,220,11,209
2025-09-10,12,Primaria 5°,TopKids,286,20,266
2025-09-10,12,Primaria 5°,TopKids,104,15,89
2025-09-10,12,Primaria 5°,EduMax,126,24,102
2025-09-10,12,Primaria 5°,EduMax,195,1,194
2025-09-10,12,Primaria 5°,SuperSchool,296,21,275
2025-09-10,12,Primaria 5°,TopKids,188,16,172
2025-09-10,12,Primaria 5°,SuperSchool,260,8,252
2025-09-10,12,Primaria 5°,TopKids,232,16,216
2025-09-10,12,Primaria 5°,EduMax,276,2,274
2025-09-10,12,Primaria 5°,SuperSchool,123,22,101
2025-09-10,12,Primaria 5°,EduMax,235,21,214
2025-09-10,12,Primaria 5°,SuperSchool,54,6,48
2025-09-10,12,Primaria 5°,TopKids,59,5,54
2025-09-10,12,Primaria 5°,EduMax,86,15,71
2025-09-10,12,Primaria 6°,SuperSchool,73,18,55
2025-09-10,12,Primaria 6°,EduMax,155,23,132
2025-09-10,12,Primaria 6°,TopKids,284,14,270
2025-09-10,12,Primaria 6°,SuperSchool,290,2,288
2025-09-10,12,Primaria 6°,EduMax,290,17,273
2025-09-10,13,Preescolar,EduMax,73,12,61
2025-09-10,13,Preescolar,TopKids,64,9,55
2025-09-10,13,Preescolar,EduMax,225,7,218
2025-09-10,13,Preescolar,EduMax,277,3,274
2025-09-10,13,Preescolar,TopKids,58,24,34
2025-09-10,13,Preescolar,EduMax,61,10,51
2025-09-10,13,Preescolar,EduMax,93,12,81
2025-09-10,13,Preescolar,EduMax,196,13,183
2025-09-10,13,Preescolar,EduMax,232,21,211
2025-09-10,13,Preescolar,SuperSchool,114,8,106
2025-09-10,13,Preescolar,EduMax,165,3,162
2025-09-10,13,Preescolar,SuperSchool,202,12,190
2025-09-10,13,Preescolar,TopKids,105,4,101
2025-09-10,13,Preescolar,TopKids,257,12,245
2025-09-10,13,Preescolar,EduMax,200,6,194
2025-09-10,13,Kínder,EduMax,129,23,106
2025-09-10,13,Kínder,SuperSchool,58,18,40
2025-09-10,13,Kínder,SuperSchool,289,21,268
2025-09-10,13,Kínder,EduMax,242,23,219
2025-09-10,13,Kínder,SuperSchool,196,3,193
2025-09-10,13,Kínder,SuperSchool,232,14,218
2025-09-10,13,Kínder,EduMax,89,14,75
2025-09-10,13,Kínder,SuperSchool,102,16,86
2025-09-10,13,Kínder,SuperSchool,144,7,137
2025-09-10,13,Kínder,TopKids,133,1,132
2025-09-10,13,Kínder,EduMax,254,7,247
2025-09-10,13,Kínder,SuperSchool,71,7,64
2025-09-10,13,Kínder,EduMax,261,20,241
2025-09-10,13,Kínder,SuperSchool,149,4,145
2025-09-10,13,Kínder,SuperSchool,247,14,233
2025-09-10,13,Primaria 1°,TopKids,107,24,83
2025-09-10,13,Primaria 1°,TopKids,149,22,127
2025-09-10,13,Primaria 1°,SuperSchool,231,16,215
2025-09-10,13,Primaria 1°,TopKids,65,12,53
2025-09-10,13,Primaria 1°,EduMax,197,21,176
2025-09-10,13,Primaria 1°,TopKids,271,21,250
2025-09-10,13,Primaria 1°,TopKids,70,5,65
2025-09-10,13,Primaria 2°,SuperSchool,246,9,237
2025-09-10,13,Primaria 2°,TopKids,262,20,242
2025-09-10,13,Primaria 2°,EduMax,281,20,261
2025-09-10,13,Primaria 2°,SuperSchool,107,17,90
2025-09-10,13,Primaria 2°,EduMax,269,1,268
2025-09-10,13,Primaria 2°,EduMax,145,16,129
2025-09-10,13,Primaria 2°,TopKids,198,1,197
2025-09-10,13,Primaria 2°,TopKids,244,6,238
2025-09-10,13,Primaria 2°,SuperSchool,141,22,119
2025-09-10,13,Primaria 2°,EduMax,81,5,76
2025-09-10,13,Primaria 2°,TopKids,177,10,167
2025-09-10,13,Primaria 3°,EduMax,226,14,212
2025-09-10,13,Primaria 3°,EduMax,239,13,226
2025-09-10,13,Primaria 3°,EduMax,138,12,126
2025-09-10,13,Primaria 3°,TopKids,156,19,137
2025-09-10,13,Primaria 3°,SuperSchool,245,10,235
2025-09-10,13,Primaria 3°,TopKids,232,6,226
2025-09-10,13,Primaria 3°,TopKids,273,11,262
2025-09-10,13,Primaria 3°,EduMax,298,21,277
2025-09-10,13,Primaria 3°,TopKids,276,21,255
2025-09-10,13,Primaria 3°,TopKids,210,24,186
2025-09-10,13,Primaria 3°,TopKids,245,19,226
2025-09-10,13,Primaria 3°,SuperSchool,205,22,183
2025-09-10,13,Primaria 3°,TopKids,137,14,123
2025-09-10,13,Primaria 3°,TopKids,111,10,101
2025-09-10,13,Primaria 3°,SuperSchool,81,9,72
2025-09-10,13,Primaria 3°,SuperSchool,193,15,178
2025-09-10,13,Primaria 3°,TopKids,97,18,79
2025-09-10,13,Primaria 3°,SuperSchool,72,23,49
2025-09-10,13,Primaria 3°,EduMax,180,7,173
2025-09-10,13,Primaria 4°,TopKids,104,24,80
2025-09-10,13,Primaria 4°,TopKids,163,12,151
2025-09-10,13,Primaria 4°,TopKids,130,9,121
2025-09-10,13,Primaria 4°,SuperSchool,259,23,236
2025-09-10,13,Primaria 4°,SuperSchool,286,3,283
2025-09-10,13,Primaria 4°,SuperSchool,112,18,94
2025-09-10,13,Primaria 4°,SuperSchool,96,20,76
2025-09-10,13,Primaria 4°,TopKids,55,9,46
2025-09-10,13,Primaria 4°,TopKids,142,13,129
2025-09-10,13,Primaria 4°,TopKids,160,17,143
2025-09-10,13,Primaria 4°,EduMax,88,17,71
2025-09-10,13,Primaria 5°,SuperSchool,114,18,96
2025-09-10,13,Primaria 5°,EduMax,100,11,89
2025-09-10,13,Primaria 5°,TopKids,79,22,57
2025-09-10,13,Primaria 5°,EduMax,270,10,260
2025-09-10,13,Primaria 5°,EduMax,136,22,114
2025-09-10,13,Primaria 5°,EduMax,118,10,108
2025-09-10,13,Primaria 5°,TopKids,238,14,224
2025-09-10,13,Primaria 5°,EduMax,255,24,231
2025-09-10,13,Primaria 5°,SuperSchool,134,14,120
2025-09-10,13,Primaria 5°,TopKids,117,12,105
2025-09-10,13,Primaria 5°,SuperSchool,258,19,239
2025-09-10,13,Primaria 5°,EduMax,215,9,206
2025-09-10,13,Primaria 5°,EduMax,292,12,280
2025-09-10,13,Primaria 5°,TopKids,273,16,257
2025-09-10,13,Primaria 5°,EduMax,227,6,221
2025-09-10,13,Primaria 6°,EduMax,182,9,173
2025-09-10,13,Primaria 6°,SuperSchool,88,23,65
2025-09-10,13,Primaria 6°,TopKids,209,1,208
2025-09-10,13,Primaria 6°,EduMax,139,18,121
2025-09-10,13,Primaria 6°,TopKids,54,14,40
2025-09-10,13,Primaria 6°,TopKids,288,12,276
2025-09-10,13,Primaria 6°,TopKids,149,6,143
2025-09-10,13,Primaria 6°,SuperSchool,225,2,223
2025-09-10,13,Primaria 6°,SuperSchool,185,12,173
2025-09-10,13,Primaria 6°,SuperSchool,75,6,69
2025-09-10,13,Primaria 6°,TopKids,192,8,184
2025-09-10,13,Primaria 6°,EduMax,115,16,99
2025-09-10,13,Primaria 6°,SuperSchool,50,11,39
2025-09-10,13,Primaria 6°,SuperSchool,217,2,215
2025-09-10,14,Preescolar,SuperSchool,166,2,164
2025-09-10,14,Preescolar,TopKids,53,2,51
2025-09-10,14,Preescolar,SuperSchool,85,21,64
2025-09-10,14,Preescolar,EduMax,192,21,171
2025-09-10,14,Preescolar,SuperSchool,238,10,228
2025-09-10,14,Preescolar,EduMax,209,2,207
2025-09-10,14,Preescolar,TopKids,278,22,256
2025-09-10,14,Preescolar,SuperSchool,78,13,65
2025-09-10,14,Preescolar,EduMax,112,23,89
2025-09-10,14,Preescolar,TopKids,256,24,232
2025-09-10,14,Preescolar,EduMax,284,23,261
2025-09-10,14,Preescolar,EduMax,87,5,82
2025-09-10,14,Preescolar,SuperSchool,272,8,264
2025-09-10,14,Preescolar,SuperSchool,179,17,162
2025-09-10,14,Preescolar,SuperSchool,171,7,164
2025-09-10,14,Preescolar,SuperSchool,234,23,211
2025-09-10,14,Preescolar,SuperSchool,213,7,206
2025-09-10,14,Kínder,EduMax,129,10,119
2025-09-10,14,Kínder,TopKids,107,2,105
2025-09-10,14,Kínder,EduMax,89,14,75
2025-09-10,14,Kínder,EduMax,178,17,161
2025-09-10,14,Kínder,SuperSchool,135,5,130
2025-09-10,14,Kínder,TopKids,192,19,173
2025-09-10,14,Kínder,SuperSchool,115,16,99
2025-09-10,14,Kínder,SuperSchool,250,20,230
2025-09-10,14,Kínder,EduMax,187,24,163
2025-09-10,14,Kínder,SuperSchool,245,2,243
2025-09-10,14,Kínder,EduMax,255,22,233
2025-09-10,14,Kínder,SuperSchool,109,8,101
2025-09-10,14,Kínder,TopKids,242,5,237
2025-09-10,14,Kínder,SuperSchool,94,17,77
2025-09-10,14,Kínder,EduMax,296,7,289
2025-09-10,14,Kínder,SuperSchool,198,4,194
2025-09-10,14,Primaria 1°,SuperSchool,222,1,221
2025-09-10,14,Primaria 1°,SuperSchool,284,21,263
2025-09-10,14,Primaria 1°,SuperSchool,286,11,275
2025-09-10,14,Primaria 1°,TopKids,153,7,146
2025-09-10,14,Primaria 1°,SuperSchool,204,22,182
2025-09-10,14,Primaria 1°,SuperSchool,144,20,124
2025-09-10,14,Primaria 1°,TopKids,192,21,171
2025-09-10,14,Primaria 1°,SuperSchool,72,6,66
2025-09-10,14,Primaria 1°,SuperSchool,193,23,170
2025-09-10,14,Primaria 1°,SuperSchool,222,7,215
2025-09-10,14,Primaria 1°,SuperSchool,88,8,80
2025-09-10,14,Primaria 1°,EduMax,226,16,210
2025-09-10,14,Primaria 1°,SuperSchool,217,7,210
2025-09-10,14,Primaria 2°,EduMax,112,4,108
2025-09-10,14,Primaria 2°,EduMax,179,16,163
2025-09-10,14,Primaria 2°,EduMax,291,23,268
2025-09-10,14,Primaria 2°,SuperSchool,281,14,267
2025-09-10,14,Primaria 2°,EduMax,260,24,236
2025-09-10,14,Primaria 2°,EduMax,109,14,95
2025-09-10,14,Primaria 2°,EduMax,143,17,126
2025-09-10,14,Primaria 2°,EduMax,208,8,200
2025-09-10,14,Primaria 2°,SuperSchool,129,21,108
2025-09-10,14,Primaria 2°,SuperSchool,107,18,89
2025-09-10,14,Primaria 2°,TopKids,174,18,156
2025-09-10,14,Primaria 2°,SuperSchool,187,2,185
2025-09-10,14,Primaria 2°,TopKids,271,11,260
2025-09-10,14,Primaria 3°,TopKids,239,3,236
2025-09-10,14,Primaria 3°,EduMax,241,16,225
2025-09-10,14,Primaria 3°,EduMax,175,3,172
2025-09-10,14,Primaria 3°,TopKids,69,21,48
2025-09-10,14,Primaria 3°,TopKids,226,8,218
2025-09-10,14,Primaria 3°,TopKids,280,10,270
2025-09-10,14,Primaria 3°,TopKids,100,15,85
2025-09-10,14,Primaria 4°,TopKids,214,3,211
2025-09-10,14,Primaria 4°,TopKids,206,4,202
2025-09-10,14,Primaria 4°,TopKids,129,5,124
2025-09-10,14,Primaria 4°,SuperSchool,281,10,271
2025-09-10,14,Primaria 4°,EduMax,70,2,68
2025-09-10,14,Primaria 4°,EduMax,246,7,239
2025-09-10,14,Primaria 4°,TopKids,84,12,72
2025-09-10,14,Primaria 4°,EduMax,104,1,103
2025-09-10,14,Primaria 4°,SuperSchool,231,16,215
2025-09-10,14,Primaria 4°,TopKids,178,23,155
2025-09-10,14,Primaria 4°,EduMax,126,15,111
2025-09-10,14,Primaria 4°,TopKids,258,9,249
2025-09-10,14,Primaria 4°,SuperSchool,108,23,85
2025-09-10,14,Primaria 4°,SuperSchool,156,11,145
2025-09-10,14,Primaria 5°,TopKids,298,2,296
2025-09-10,14,Primaria 5°,EduMax,155,21,134
2025-09-10,14,Primaria 5°,TopKids,199,14,185
2025-09-10,14,Primaria 5°,SuperSchool,176,17,159
2025-09-10,14,Primaria 5°,EduMax,260,7,253
2025-09-10,14,Primaria 5°,EduMax,266,18,248
2025-09-10,14,Primaria 5°,TopKids,142,14,128
2025-09-10,14,Primaria 5°,EduMax,226,1,225
2025-09-10,14,Primaria 5°,SuperSchool,85,19,66
2025-09-10,14,Primaria 5°,EduMax,209,24,185
2025-09-10,14,Primaria 5°,SuperSchool,278,18,260
2025-09-10,14,Primaria 5°,TopKids,69,8,61
2025-09-10,14,Primaria 6°,SuperSchool,190,13,177
2025-09-10,14,Primaria 6°,EduMax,205,14,191
2025-09-10,14,Primaria 6°,TopKids,142,21,121
2025-09-10,14,Primaria 6°,TopKids,72,5,67
2025-09-10,14,Primaria 6°,TopKids,163,3,160
2025-09-10,14,Primaria 6°,EduMax,115,18,97
2025-09-10,15,Preescolar,EduMax,253,2,251
2025-09-10,15,Preescolar,SuperSchool,118,11,107
2025-09-10,15,Preescolar,SuperSchool,240,21,219
2025-09-10,15,Preescolar,SuperSchool,105,16,89
2025-09-10,15,Preescolar,TopKids,203,15,188
2025-09-10,15,Preescolar,EduMax,183,4,179
2025-09-10,15,Preescolar,EduMax,126,9,117
2025-09-10,15,Preescolar,EduMax,63,8,55
2025-09-10,15,Preescolar,TopKids,218,1,217
2025-09-10,15,Preescolar,TopKids,288,7,281
2025-09-10,15,Preescolar,TopKids,184,13,171
2025-09-10,15,Preescolar,EduMax,88,7,81
2025-09-10,15,Preescolar,TopKids,154,6,148
2025-09-10,15,Preescolar,EduMax,107,9,98
2025-09-10,15,Preescolar,TopKids,265,20,245
2025-09-10,15,Preescolar,EduMax,193,16,177
2025-09-10,15,Preescolar,TopKids,210,23,187
2025-09-10,15,Kínder,TopKids,149,19,130
2025-09-10,15,Kínder,EduMax,91,13,78
2025-09-10,15,Kínder,SuperSchool,158,10,148
2025-09-10,15,Kínder,TopKids,145,15,130
2025-09-10,15,Kínder,TopKids,171,14,157
2025-09-10,15,Kínder,TopKids,74,18,56
2025-09-10,15,Kínder,TopKids,107,9,98
2025-09-10,15,Kínder,SuperSchool,71,14,57
2025-09-10,15,Kínder,EduMax,86,22,64
2025-09-10,15,Kínder,SuperSchool,191,4,187
2025-09-10,15,Kínder,EduMax,240,1,239
2025-09-10,15,Kínder,EduMax,62,20,42
2025-09-10,15,Kínder,SuperSchool,170,13,157
2025-09-10,15,Kínder,SuperSchool,118,24,94
2025-09-10,15,Kínder,SuperSchool,106,8,98
2025-09-10,15,Kínder,EduMax,295,12,283
2025-09-10,15,Kínder,SuperSchool,67,16,51
2025-09-10,15,Primaria 1°,EduMax,89,7,82
2025-09-10,15,Primaria 1°,SuperSchool,282,22,260
2025-09-10,15,Primaria 1°,EduMax,209,10,199
2025-09-10,15,Primaria 1°,SuperSchool,243,6,237
2025-09-10,15,Primaria 1°,TopKids,53,5,48
2025-09-10,15,Primaria 1°,SuperSchool,162,5,157
2025-09-10,15,Primaria 1°,EduMax,284,9,275
2025-09-10,15,Primaria 2°,TopKids,289,9,280
2025-09-10,15,Primaria 2°,SuperSchool,203,23,180
2025-09-10,15,Primaria 2°,EduMax,154,22,132
2025-09-10,15,Primaria 2°,TopKids,208,6,202
2025-09-10,15,Primaria 2°,TopKids,81,2,79
2025-09-10,15,Primaria 2°,EduMax,77,7,70
2025-09-10,15,Primaria 2°,TopKids,166,4,162
2025-09-10,15,Primaria 2°,SuperSchool,88,17,71
2025-09-10,15,Primaria 2°,SuperSchool,101,19,82
2025-09-10,15,Primaria 2°,SuperSchool,62,1,61
2025-09-10,15,Primaria 2°,TopKids,275,7,268
2025-09-10,15,Primaria 2°,EduMax,202,23,179
2025-09-10,15,Primaria 2°,EduMax,162,7,155
2025-09-10,15,Primaria 2°,EduMax,158,17,141
2025-09-10,15,Primaria 2°,SuperSchool,109,2,107
2025-09-10,15,Primaria 2°,EduMax,285,13,272
2025-09-10,15,Primaria 2°,EduMax,58,17,41
2025-09-10,15,Primaria 2°,EduMax,131,8,123
2025-09-10,15,Primaria 2°,TopKids,252,22,230
2025-09-10,15,Primaria 3°,EduMax,67,13,54
2025-09-10,15,Primaria 3°,SuperSchool,192,22,170
2025-09-10,15,Primaria 3°,TopKids,215,6,209
2025-09-10,15,Primaria 3°,SuperSchool,236,2,234
2025-09-10,15,Primaria 3°,TopKids,260,17,243
2025-09-10,15,Primaria 3°,SuperSchool,127,16,111
2025-09-10,15,Primaria 3°,TopKids,218,19,199
2025-09-10,15,Primaria 3°,TopKids,123,23,100
2025-09-10,15,Primaria 3°,SuperSchool,51,18,33
2025-09-10,15,Primaria 3°,EduMax,262,12,250
2025-09-10,15,Primaria 4°,TopKids,51,1,50
2025-09-10,15,Primaria 4°,EduMax,264,21,243
2025-09-10,15,Primaria 4°,SuperSchool,229,8,221
2025-09-10,15,Primaria 4°,SuperSchool,93,2,91
2025-09-10,15,Primaria 4°,SuperSchool,258,17,241
2025-09-10,15,Primaria 4°,EduMax,222,5,217
2025-09-10,15,Primaria 4°,EduMax,159,15,144
2025-09-10,15,Primaria 4°,SuperSchool,263,5,258
2025-09-10,15,Primaria 4°,EduMax,87,9,78
2025-09-10,15,Primaria 4°,SuperSchool,144,9,135
2025-09-10,15,Primaria 4°,SuperSchool,85,1,84
2025-09-10,15,Primaria 4°,EduMax,264,23,241
2025-09-10,15,Primaria 4°,TopKids,95,1,94
2025-09-10,15,Primaria 4°,EduMax,217,3,214
2025-09-10,15,Primaria 5°,SuperSchool,200,20,180
2025-09-10,15,Primaria 5°,SuperSchool,259,7,252
2025-09-10,15,Primaria 5°,EduMax,98,15,83
2025-09-10,15,Primaria 5°,SuperSchool,141,7,134
2025-09-10,15,Primaria 5°,TopKids,136,23,113
2025-09-10,15,Primaria 6°,TopKids,118,12,106
2025-09-10,15,Primaria 6°,EduMax,100,10,90
2025-09-10,15,Primaria 6°,SuperSchool,248,24,224
2025-09-10,15,Primaria 6°,TopKids,231,15,216
2025-09-10,15,Primaria 6°,SuperSchool,270,6,264
2025-09-10,15,Primaria 6°,SuperSchool,156,6,150
2025-09-10,15,Primaria 6°,EduMax,261,15,246
2025-09-10,15,Primaria 6°,SuperSchool,151,20,131
2025-09-10,15,Primaria 6°,SuperSchool,192,6,186
2025-09-10,15,Primaria 6°,SuperSchool,239,6,233
2025-09-10,15,Primaria 6°,EduMax,146,7,139
2025-09-10,15,Primaria 6°,EduMax,102,8,94
2025-09-10,15,Primaria 6°,EduMax,134,5,129
2025-09-10,15,Primaria 6°,EduMax,181,20,161
2025-09-10,15,Primaria 6°,EduMax,299,16,283
2025-09-10,15,Primaria 6°,TopKids,274,23,251
2025-09-10,16,Preescolar,EduMax,94,13,81
2025-09-10,16,Preescolar,EduMax,95,2,93
2025-09-10,16,Preescolar,SuperSchool,167,16,151
2025-09-10,16,Preescolar,EduMax,222,16,206
2025-09-10,16,Preescolar,TopKids,242,17,225
2025-09-10,16,Preescolar,SuperSchool,155,5,150
2025-09-10,16,Preescolar,TopKids,181,1,180
2025-09-10,16,Preescolar,SuperSchool,251,3,248
2025-09-10,16,Preescolar,SuperSchool,94,21,73
2025-09-10,16,Preescolar,SuperSchool,241,9,232
2025-09-10,16,Preescolar,SuperSchool,217,11,206
2025-09-10,16,Preescolar,SuperSchool,265,14,251
2025-09-10,16,Preescolar,SuperSchool,187,3,184
2025-09-10,16,Kínder,SuperSchool,296,12,284
2025-09-10,16,Kínder,SuperSchool,124,11,113
2025-09-10,16,Kínder,SuperSchool,204,14,190
2025-09-10,16,Kínder,TopKids,189,24,165
2025-09-10,16,Kínder,TopKids,153,4,149
2025-09-10,16,Kínder,EduMax,290,2,288
2025-09-10,16,Kínder,TopKids,167,13,154
2025-09-10,16,Kínder,EduMax,173,21,152
2025-09-10,16,Primaria 1°,EduMax,219,4,215
2025-09-10,16,Primaria 1°,SuperSchool,185,22,163
2025-09-10,16,Primaria 1°,EduMax,294,13,281
2025-09-10,16,Primaria 1°,TopKids,223,21,202
2025-09-10,16,Primaria 1°,SuperSchool,221,4,217
2025-09-10,16,Primaria 1°,SuperSchool,160,15,145
2025-09-10,16,Primaria 1°,EduMax,204,6,198
2025-09-10,16,Primaria 1°,EduMax,218,5,213
2025-09-10,16,Primaria 1°,SuperSchool,253,5,248
2025-09-10,16,Primaria 1°,SuperSchool,288,2,286
2025-09-10,16,Primaria 1°,TopKids,264,24,240
2025-09-10,16,Primaria 2°,SuperSchool,259,10,249
2025-09-10,16,Primaria 2°,SuperSchool,272,21,251
2025-09-10,16,Primaria 2°,SuperSchool,77,1,76
2025-09-10,16,Primaria 2°,SuperSchool,243,17,226
2025-09-10,16,Primaria 2°,TopKids,217,2,215
2025-09-10,16,Primaria 2°,TopKids,185,5,180
2025-09-10,16,Primaria 2°,SuperSchool,245,12,233
2025-09-10,16,Primaria 3°,EduMax,80,5,75
2025-09-10,16,Primaria 3°,SuperSchool,269,19,250
2025-09-10,16,Primaria 3°,SuperSchool,91,23,68
2025-09-10,16,Primaria 3°,SuperSchool,292,4,288
2025-09-10,16,Primaria 3°,SuperSchool,126,17,109
2025-09-10,16,Primaria 3°,EduMax,292,23,269
2025-09-10,16,Primaria 4°,SuperSchool,298,3,295
2025-09-10,16,Primaria 4°,SuperSchool,145,13,132
2025-09-10,16,Primaria 4°,TopKids,51,15,36
2025-09-10,16,Primaria 4°,TopKids,295,16,279
2025-09-10,16,Primaria 4°,SuperSchool,177,10,167
2025-09-10,16,Primaria 4°,EduMax,256,8,248
2025-09-10,16,Primaria 4°,SuperSchool,114,24,90
2025-09-10,16,Primaria 4°,EduMax,145,9,136
2025-09-10,16,Primaria 4°,SuperSchool,165,20,145
2025-09-10,16,Primaria 4°,TopKids,100,12,88
2025-09-10,16,Primaria 4°,EduMax,132,20,112
2025-09-10,16,Primaria 5°,TopKids,139,24,115
2025-09-10,16,Primaria 5°,SuperSchool,206,5,201
2025-09-10,16,Primaria 5°,SuperSchool,174,3,171
2025-09-10,16,Primaria 5°,TopKids,164,22,142
2025-09-10,16,Primaria 5°,TopKids,181,23,158
2025-09-10,16,Primaria 5°,EduMax,151,13,138
2025-09-10,16,Primaria 5°,TopKids,216,12,204
2025-09-10,16,Primaria 5°,EduMax,126,11,115
2025-09-10,16,Primaria 5°,EduMax,235,7,228
2025-09-10,16,Primaria 5°,EduMax,297,15,282
2025-09-10,16,Primaria 5°,SuperSchool,180,5,175
2025-09-10,16,Primaria 5°,EduMax,192,3,189
2025-09-10,16,Primaria 5°,SuperSchool,291,3,288
2025-09-10,16,Primaria 5°,TopKids,143,24,119
2025-09-10,16,Primaria 6°,TopKids,127,16,111
2025-09-10,16,Primaria 6°,TopKids,53,3,50
2025-09-10,16,Primaria 6°,TopKids,177,9,168
2025-09-10,16,Primaria 6°,EduMax,260,24,236
2025-09-10,16,Primaria 6°,TopKids,256,4,252
2025-09-10,16,Primaria 6°,SuperSchool,272,8,264
2025-09-10,16,Primaria 6°,EduMax,298,18,280
2025-09-10,16,Primaria 6°,TopKids,116,21,95
2025-09-10,16,Primaria 6°,TopKids,111,12,99
2025-09-11,9,Preescolar,EduMax,171,23,148
2025-09-11,9,Preescolar,TopKids,126,16,110
2025-09-11,9,Preescolar,SuperSchool,295,18,277
2025-09-11,9,Preescolar,SuperSchool,174,24,150
2025-09-11,9,Preescolar,EduMax,222,8,214
2025-09-11,9,Preescolar,TopKids,208,8,200
2025-09-11,9,Preescolar,SuperSchool,81,24,57
2025-09-11,9,Preescolar,SuperSchool,84,4,80
2025-09-11,9,Preescolar,TopKids,141,2,139
2025-09-11,9,Preescolar,SuperSchool,220,11,209
2025-09-11,9,Preescolar,TopKids,170,2,168
2025-09-11,9,Preescolar,TopKids,150,19,131
2025-09-11,9,Kínder,SuperSchool,184,12,172
2025-09-11,9,Kínder,TopKids,272,18,254
2025-09-11,9,Kínder,EduMax,198,9,189
2025-09-11,9,Kínder,EduMax,83,15,68
2025-09-11,9,Kínder,EduMax,100,15,85
2025-09-11,9,Kínder,TopKids,55,6,49
2025-09-11,9,Kínder,TopKids,167,21,146
2025-09-11,9,Kínder,SuperSchool,60,4,56
2025-09-11,9,Kínder,EduMax,190,15,175
2025-09-11,9,Kínder,SuperSchool,57,11,46
2025-09-11,9,Kínder,TopKids,161,3,158
2025-09-11,9,Kínder,SuperSchool,72,15,57
2025-09-11,9,Kínder,SuperSchool,56,5,51
2025-09-11,9,Kínder,TopKids,143,12,131
2025-09-11,9,Kínder,SuperSchool,100,19,81
2025-09-11,9,Kínder,SuperSchool,69,12,57
2025-09-11,9,Kínder,EduMax,135,6,129
2025-09-11,9,Primaria 1°,SuperSchool,259,21,238
2025-09-11,9,Primaria 1°,TopKids,59,3,56
2025-09-11,9,Primaria 1°,EduMax,172,18,154
2025-09-11,9,Primaria 1°,EduMax,181,10,171
2025-09-11,9,Primaria 1°,SuperSchool,88,16,72
2025-09-11,9,Primaria 1°,EduMax,218,3,215
2025-09-11,9,Primaria 1°,EduMax,138,6,132
2025-09-11,9,Primaria 1°,EduMax,85,4,81
2025-09-11,9,Primaria 1°,EduMax,123,13,110
2025-09-11,9,Primaria 1°,EduMax,56,5,51
2025-09-11,9,Primaria 1°,TopKids,79,8,71
2025-09-11,9,Primaria 1°,EduMax,61,17,44
2025-09-11,9,Primaria 1°,EduMax,178,4,174
2025-09-11,9,Primaria 1°,TopKids,137,6,131
2025-09-11,9,Primaria 1°,SuperSchool,155,18,137
2025-09-11,9,Primaria 1°,SuperSchool,214,12,202
2025-09-11,9,Primaria 1°,SuperSchool,195,8,187
2025-09-11,9,Primaria 2°,TopKids,203,5,198
2025-09-11,9,Primaria 2°,SuperSchool,80,17,63
2025-09-11,9,Primaria 2°,SuperSchool,290,11,279
2025-09-11,9,Primaria 2°,TopKids,242,24,218
2025-09-11,9,Primaria 2°,SuperSchool,171,18,153
2025-09-11,9,Primaria 2°,SuperSchool,205,6,199
2025-09-11,9,Primaria 2°,SuperSchool,166,22,144
2025-09-11,9,Primaria 2°,TopKids,100,20,80
2025-09-11,9,Primaria 2°,SuperSchool,62,15,47
2025-09-11,9,Primaria 2°,TopKids,201,16,185
2025-09-11,9,Primaria 2°,TopKids,194,5,189
2025-09-11,9,Primaria 2°,EduMax,271,14,257
2025-09-11,9,Primaria 2°,TopKids,250,14,236
2025-09-11,9,Primaria 2°,EduMax,299,22,277
2025-09-11,9,Primaria 2°,TopKids,62,17,45
2025-09-11,9,Primaria 2°,SuperSchool,191,12,179
2025-09-11,9,Primaria 2°,TopKids,212,23,189
2025-09-11,9,Primaria 2°,SuperSchool,242,24,218
2025-09-11,9,Primaria 3°,SuperSchool,71,2,69
2025-09-11,9,Primaria 3°,SuperSchool,99,22,77
2025-09-11,9,Primaria 3°,EduMax,149,16,133
2025-09-11,9,Primaria 3°,EduMax,215,20,195
2025-09-11,9,Primaria 3°,TopKids,174,3,171
2025-09-11,9,Primaria 3°,TopKids,60,24,36
2025-09-11,9,Primaria 3°,SuperSchool,246,1,245
2025-09-11,9,Primaria 3°,TopKids,117,9,108
2025-09-11,9,Primaria 3°,TopKids,271,5,266
2025-09-11,9,Primaria 3°,EduMax,244,16,228
2025-09-11,9,Primaria 3°,SuperSchool,182,6,176
2025-09-11,9,Primaria 3°,TopKids,276,8,268
2025-09-11,9,Primaria 3°,SuperSchool,102,17,85
2025-09-11,9,Primaria 3°,SuperSchool,121,21,100
2025-09-11,9,Primaria 3°,TopKids,223,9,214
2025-09-11,9,Primaria 3°,SuperSchool,72,8,64
2025-09-11,9,Primaria 3°,TopKids,103,15,88
2025-09-11,9,Primaria 4°,SuperSchool,228,4,224
2025-09-11,9,Primaria 4°,EduMax,150,24,126
2025-09-11,9,Primaria 4°,SuperSchool,179,7,172
2025-09-11,9,Primaria 4°,TopKids,125,4,121
2025-09-11,9,Primaria 4°,TopKids,281,18,263
2025-09-11,9,Primaria 4°,TopKids,171,24,147
2025-09-11,9,Primaria 4°,SuperSchool,257,23,234
2025-09-11,9,Primaria 4°,SuperSchool,281,5,276
2025-09-11,9,Primaria 5°,TopKids,64,22,42
2025-09-11,9,Primaria 5°,TopKids,229,13,216
2025-09-11,9,Primaria 5°,TopKids,272,13,259
2025-09-11,9,Primaria 5°,SuperSchool,130,21,109
2025-09-11,9,Primaria 5°,SuperSchool,225,22,203
2025-09-11,9,Primaria 5°,SuperSchool,196,22,174
2025-09-11,9,Primaria 5°,EduMax,176,23,153
2025-09-11,9,Primaria 5°,TopKids,136,9,127
2025-09-11,9,Primaria 6°,TopKids,296,6,290
2025-09-11,9,Primaria 6°,EduMax,146,7,139
2025-09-11,9,Primaria 6°,EduMax,245,23,222
2025-09-11,9,Primaria 6°,EduMax,287,11,276
2025-09-11,9,Primaria 6°,SuperSchool,150,3,147
2025-09-11,9,Primaria 6°,EduMax,133,2,131
2025-09-11,10,Preescolar,SuperSchool,142,10,132
2025-09-11,10,Preescolar,TopKids,288,5,283
2025-09-11,10,Preescolar,EduMax,197,6,191
2025-09-11,10,Preescolar,TopKids,60,8,52
2025-09-11,10,Preescolar,SuperSchool,85,7,78
2025-09-11,10,Preescolar,EduMax,160,9,151
2025-09-11,10,Preescolar,TopKids,198,19,179
2025-09-11,10,Preescolar,SuperSchool,136,19,117
2025-09-11,10,Preescolar,SuperSchool,176,19,157
2025-09-11,10,Preescolar,TopKids,61,7,54
2025-09-11,10,Preescolar,SuperSchool,54,12,42
2025-09-11,10,Preescolar,TopKids,53,20,33
2025-09-11,10,Preescolar,TopKids,222,15,207
2025-09-11,10,Preescolar,EduMax,205,1,204
2025-09-11,10,Kínder,EduMax,193,12,181
2025-09-11,10,Kínder,TopKids,92,23,69
2025-09-11,10,Kínder,EduMax,287,17,270
2025-09-11,10,Kínder,TopKids,252,4,248
2025-09-11,10,Kínder,EduMax,172,23,149
2025-09-11,10,Kínder,TopKids,213,11,202
2025-09-11,10,Kínder,TopKids,165,9,156
2025-09-11,10,Primaria 1°,TopKids,135,2,133
2025-09-11,10,Primaria 1°,TopKids,146,8,138
2025-09-11,10,Primaria 1°,TopKids,68,23,45
2025-09-11,10,Primaria 1°,EduMax,53,19,34
2025-09-11,10,Primaria 1°,EduMax,74,22,52
2025-09-11,10,Primaria 1°,EduMax,247,15,232
2025-09-11,10,Primaria 1°,SuperSchool,164,22,142
2025-09-11,10,Primaria 1°,EduMax,116,14,102
2025-09-11,10,Primaria 1°,EduMax,181,16,165
2025-09-11,10,Primaria 1°,TopKids,142,13,129
2025-09-11,10,Primaria 1°,SuperSchool,190,15,175
2025-09-11,10,Primaria 1°,TopKids,273,5,268
2025-09-11,10,Primaria 1°,TopKids,266,6,260
2025-09-11,10,Primaria 1°,EduMax,169,9,160
2025-09-11,10,Primaria 1°,EduMax,206,23,183
2025-09-11,10,Primaria 1°,EduMax,135,2,133
2025-09-11,10,Primaria 2°,SuperSchool,119,10,109
2025-09-11,10,Primaria 2°,SuperSchool,69,12,57
2025-09-11,10,Primaria 2°,EduMax,151,8,143
2025-09-11,10,Primaria 2°,EduMax,98,18,80
2025-09-11,10,Primaria 2°,TopKids,146,7,139
2025-09-11,10,Primaria 2°,TopKids,52,19,33
2025-09-11,10,Primaria 2°,TopKids,121,6,115
2025-09-11,10,Primaria 2°,EduMax,136,12,124
2025-09-11,10,Primaria 2°,TopKids,79,21,58
2025-09-11,10,Primaria 2°,EduMax,95,7,88
2025-09-11,10,Primaria 2°,SuperSchool,56,15,41
2025-09-11,10,Primaria 2°,TopKids,226,15,211
2025-09-11,10,Primaria 2°,TopKids,262,14,248
2025-09-11,10,Primaria 2°,TopKids,124,20,104
2025-09-11,10,Primaria 2°,SuperSchool,286,8,278
2025-09-11,10,Primaria 2°,TopKids,133,13,120
2025-09-11,10,Primaria 2°,TopKids,228,6,222
2025-09-11,10,Primaria 2°,TopKids,86,10,76
2025-09-11,10,Primaria 2°,SuperSchool,139,12,127
2025-09-11,10,Primaria 3°,TopKids,185,18,167
2025-09-11,10,Primaria 3°,TopKids,191,20,171
2025-09-11,10,Primaria 3°,EduMax,106,21,85
2025-09-11,10,Primaria 3°,TopKids,181,10,171
2025-09-11,10,Primaria 3°,TopKids,188,20,168
2025-09-11,10,Primaria 3°,TopKids,114,2,112
2025-09-11,10,Primaria 3°,SuperSchool,226,5,221
2025-09-11,10,Primaria 3°,EduMax,53,7,46
2025-09-11,10,Primaria 3°,SuperSchool,98,3,95
2025-09-11,10,Primaria 3°,EduMax,90,1,89
2025-09-11,10,Primaria 3°,EduMax,293,21,272
2025-09-11,10,Primaria 3°,EduMax,84,19,65
2025-09-11,10,Primaria 3°,SuperSchool,208,22,186
2025-09-11,10,Primaria 3°,SuperSchool,157,20,137
2025-09-11,10,Primaria 4°,EduMax,212,7,205
2025-09-11,10,Primaria 4°,TopKids,145,13,132
2025-09-11,10,Primaria 4°,EduMax,218,8,210
2025-09-11,10,Primaria 4°,TopKids,68,13,55
2025-09-11,10,Primaria 4°,EduMax,252,18,234
2025-09-11,10,Primaria 4°,TopKids,110,4,106
2025-09-11,10,Primaria 4°,TopKids,266,13,253
2025-09-11,10,Primaria 4°,SuperSchool,140,10,130
2025-09-11,10,Primaria 4°,EduMax,121,7,114
2025-09-11,10,Primaria 4°,SuperSchool,71,6,65
2025-09-11,10,Primaria 4°,TopKids,186,10,176
2025-09-11,10,Primaria 4°,TopKids,217,7,210
2025-09-11,10,Primaria 5°,TopKids,241,5,236
2025-09-11,10,Primaria 5°,EduMax,161,15,146
2025-09-11,10,Primaria 5°,EduMax,78,21,57
2025-09-11,10,Primaria 5°,SuperSchool,240,6,234
2025-09-11,10,Primaria 5°,TopKids,243,12,231
2025-09-11,10,Primaria 5°,SuperSchool,256,13,243
2025-09-11,10,Primaria 5°,SuperSchool,274,4,270
2025-09-11,10,Primaria 5°,EduMax,294,14,280
2025-09-11,10,Primaria 5°,SuperSchool,108,17,91
2025-09-11,10,Primaria 5°,SuperSchool,253,6,247
2025-09-11,10,Primaria 5°,TopKids,69,16,53
2025-09-11,10,Primaria 5°,SuperSchool,193,12,181
2025-09-11,10,Primaria 5°,SuperSchool,101,20,81
2025-09-11,10,Primaria 5°,EduMax,222,1,221
2025-09-11,10,Primaria 5°,EduMax,51,2,49
2025-09-11,10,Primaria 5°,EduMax,210,10,200
2025-09-11,10,Primaria 5°,EduMax,297,1,296
2025-09-11,10,Primaria 6°,SuperSchool,159,10,149
2025-09-11,10,Primaria 6°,TopKids,234,8,226
2025-09-11,10,Primaria 6°,EduMax,80,4,76
2025-09-11,10,Primaria 6°,SuperSchool,80,9,71
2025-09-11,10,Primaria 6°,TopKids,210,8,202
2025-09-11,10,Primaria 6°,EduMax,173,17,156
2025-09-11,10,Primaria 6°,TopKids,218,8,210
2025-09-11,10,Primaria 6°,EduMax,127,12,115
2025-09-11,10,Primaria 6°,TopKids,160,4,156
2025-09-11,10,Primaria 6°,EduMax,53,22,31
2025-09-11,10,Primaria 6°,TopKids,211,4,207
2025-09-11,10,Primaria 6°,EduMax,224,8,216
2025-09-11,10,Primaria 6°,EduMax,236,2,234
2025-09-11,10,Primaria 6°,SuperSchool,122,16,106
2025-09-11,10,Primaria 6°,EduMax,235,12,223
2025-09-11,10,Primaria 6°,SuperSchool,216,15,201
2025-09-11,10,Primaria 6°,SuperSchool,121,24,97
2025-09-11,10,Primaria 6°,TopKids,196,5,191
2025-09-11,11,Preescolar,EduMax,134,17,117
2025-09-11,11,Preescolar,TopKids,88,14,74
2025-09-11,11,Preescolar,TopKids,172,23,149
2025-09-11,11,Preescolar,SuperSchool,244,24,220
2025-09-11,11,Preescolar,SuperSchool,252,3,249
2025-09-11,11,Preescolar,EduMax,55,6,49
2025-09-11,11,Preescolar,TopKids,71,21,50
2025-09-11,11,Preescolar,EduMax,151,6,145
2025-09-11,11,Preescolar,SuperSchool,233,14,219
2025-09-11,11,Kínder,EduMax,109,19,90
2025-09-11,11,Kínder,TopKids,183,11,172
2025-09-11,11,Kínder,SuperSchool,277,1,276
2025-09-11,11,Kínder,EduMax,58,13,45
2025-09-11,11,Kínder,EduMax,257,19,238
2025-09-11,11,Kínder,TopKids,154,24,130
2025-09-11,11,Kínder,TopKids,219,1,218
2025-09-11,11,Kínder,TopKids,268,24,244
2025-09-11,11,Kínder,SuperSchool,269,23,246
2025-09-11,11,Kínder,TopKids,133,8,125
2025-09-11,11,Kínder,EduMax,299,16,283
2025-09-11,11,Kínder,SuperSchool,154,11,143
2025-09-11,11,Kínder,TopKids,144,9,135
2025-09-11,11,Kínder,EduMax,58,6,52
2025-09-11,11,Kínder,EduMax,101,3,98
2025-09-11,11,Primaria 1°,EduMax,85,9,76
2025-09-11,11,Primaria 1°,TopKids,84,24,60
2025-09-11,11,Primaria 1°,EduMax,222,14,208
2025-09-11,11,Primaria 1°,SuperSchool,282,1,281
2025-09-11,11,Primaria 1°,SuperSchool,154,7,147
2025-09-11,11,Primaria 1°,TopKids,149,7,142
2025-09-11,11,Primaria 1°,TopKids,74,15,59
2025-09-11,11,Primaria 2°,SuperSchool,151,22,129
2025-09-11,11,Primaria 2°,TopKids,214,11,203
2025-09-11,11,Primaria 2°,SuperSchool,244,12,232
2025-09-11,11,Primaria 2°,EduMax,251,7,244
2025-09-11,11,Primaria 2°,TopKids,177,21,156
2025-09-11,11,Primaria 2°,EduMax,81,19,62
2025-09-11,11,Primaria 2°,SuperSchool,143,1,142
2025-09-11,11,Primaria 2°,EduMax,199,13,186
2025-09-11,11,Primaria 2°,SuperSchool,265,4,261
2025-09-11,11,Primaria 2°,EduMax,253,4,249
2025-09-11,11,Primaria 2°,EduMax,181,5,176
2025-09-11,11,Primaria 2°,TopKids,282,7,275
2025-09-11,11,Primaria 3°,TopKids,56,12,44
2025-09-11,11,Primaria 3°,EduMax,206,20,186
2025-09-11,11,Primaria 3°,SuperSchool,190,23,167
2025-09-11,11,Primaria 3°,TopKids,247,9,238
2025-09-11,11,Primaria 3°,TopKids,137,16,121
2025-09-11,11,Primaria 3°,TopKids,235,11,224
2025-09-11,11,Primaria 3°,SuperSchool,50,21,29
2025-09-11,11,Primaria 3°,SuperSchool,55,14,41
2025-09-11,11,Primaria 3°,SuperSchool,178,8,170
2025-09-11,11,Primaria 3°,TopKids,93,19,74
2025-09-11,11,Primaria 3°,TopKids,152,9,143
2025-09-11,11,Primaria 3°,TopKids,204,23,181
2025-09-11,11,Primaria 3°,EduMax,197,10,187
2025-09-11,11,Primaria 4°,EduMax,149,20,129
2025-09-11,11,Primaria 4°,EduMax,84,3,81
2025-09-11,11,Primaria 4°,TopKids,181,12,169
2025-09-11,11,Primaria 4°,SuperSchool,111,18,93
2025-09-11,11,Primaria 4°,TopKids,220,18,202
2025-09-11,11,Primaria 4°,EduMax,284,14,270
2025-09-11,11,Primaria 4°,EduMax,206,3,203
2025-09-11,11,Primaria 4°,EduMax,250,8,242
2025-09-11,11,Primaria 4°,SuperSchool,270,9,261
2025-09-11,11,Primaria 4°,SuperSchool,166,13,153
2025-09-11,11,Primaria 4°,TopKids,220,20,200
2025-09-11,11,Primaria 4°,TopKids,62,9,53
2025-09-11,11,Primaria 5°,TopKids,272,5,267
2025-09-11,11,Primaria 5°,TopKids,141,8,133
2025-09-11,11,Primaria 5°,EduMax,265,10,255
2025-09-11,11,Primaria 5°,EduMax,54,15,39
2025-09-11,11,Primaria 5°,TopKids,275,15,260
2025-09-11,11,Primaria 5°,SuperSchool,137,22,115
2025-09-11,11,Primaria 5°,SuperSchool,162,15,147
2025-09-11,11,Primaria 5°,SuperSchool,159,19,140
2025-09-11,11,Primaria 6°,SuperSchool,269,7,262
2025-09-11,11,Primaria 6°,TopKids,248,19,229
2025-09-11,11,Primaria 6°,TopKids,224,7,217
2025-09-11,11,Primaria 6°,SuperSchool,166,18,148
2025-09-11,11,Primaria 6°,TopKids,106,3,103
2025-09-11,11,Primaria 6°,EduMax,184,21,163
2025-09-11,11,Primaria 6°,EduMax,269,7,262
2025-09-11,11,Primaria 6°,EduMax,284,3,281
2025-09-11,11,Primaria 6°,TopKids,108,21,87
2025-09-11,11,Primaria 6°,EduMax,186,4,182
2025-09-11,11,Primaria 6°,EduMax,271,24,247
2025-09-11,11,Primaria 6°,EduMax,176,22,154
2025-09-11,11,Primaria 6°,TopKids,217,15,202
2025-09-11,11,Primaria 6°,EduMax,118,17,101
2025-09-11,11,Primaria 6°,TopKids,199,15,184
2025-09-11,11,Primaria 6°,SuperSchool,62,4,58
2025-09-11,11,Primaria 6°,EduMax,222,13,209
2025-09-11,12,Preescolar,SuperSchool,170,14,156
2025-09-11,12,Preescolar,EduMax,244,18,226
2025-09-11,12,Preescolar,TopKids,209,6,203
2025-09-11,12,Preescolar,EduMax,217,24,193
2025-09-11,12,Preescolar,SuperSchool,98,1,97
2025-09-11,12,Preescolar,TopKids,291,4,287
2025-09-11,12,Preescolar,EduMax,278,8,270
2025-09-11,12,Preescolar,EduMax,138,13,125
2025-09-11,12,Preescolar,SuperSchool,170,21,149
2025-09-11,12,Preescolar,EduMax,166,8,158
2025-09-11,12,Preescolar,EduMax,222,12,210
2025-09-11,12,Preescolar,SuperSchool,158,10,148
2025-09-11,12,Preescolar,SuperSchool,178,9,169
2025-09-11,12,Preescolar,TopKids,162,21,141
2025-09-11,12,Preescolar,EduMax,196,6,190
2025-09-11,12,Kínder,TopKids,129,4,125
2025-09-11,12,Kínder,EduMax,273,18,255
2025-09-11,12,Kínder,TopKids,92,5,87
2025-09-11,12,Kínder,SuperSchool,205,18,187
2025-09-11,12,Kínder,TopKids,179,5,174
2025-09-11,12,Kínder,SuperSchool,164,2,162
2025-09-11,12,Kínder,TopKids,118,12,106
2025-09-11,12,Kínder,SuperSchool,199,20,179
2025-09-11,12,Kínder,TopKids,179,22,157
2025-09-11,12,Kínder,EduMax,138,5,133
2025-09-11,12,Kínder,EduMax,298,22,276
2025-09-11,12,Primaria 1°,TopKids,213,17,196
2025-09-11,12,Primaria 1°,SuperSchool,113,10,103
2025-09-11,12,Primaria 1°,TopKids,295,1,294
2025-09-11,12,Primaria 1°,EduMax,148,19,129
2025-09-11,12,Primaria 1°,TopKids,184,9,175
2025-09-11,12,Primaria 1°,EduMax,253,14,239
2025-09-11,12,Primaria 1°,SuperSchool,170,13,157
2025-09-11,12,Primaria 1°,SuperSchool,115,3,112
2025-09-11,12,Primaria 1°,TopKids,182,2,180
2025-09-11,12,Primaria 1°,EduMax,141,13,128
2025-09-11,12,Primaria 1°,EduMax,276,8,268
2025-09-11,12,Primaria 1°,SuperSchool,103,12,91
2025-09-11,12,Primaria 1°,EduMax,67,17,50
2025-09-11,12,Primaria 1°,TopKids,135,13,122
2025-09-11,12,Primaria 1°,SuperSchool,177,6,171
2025-09-11,12,Primaria 1°,SuperSchool,196,24,172
2025-09-11,12,Primaria 2°,SuperSchool,73,16,57
2025-09-11,12,Primaria 2°,TopKids,159,21,138
2025-09-11,12,Primaria 2°,TopKids,279,17,262
2025-09-11,12,Primaria 2°,EduMax,104,9,95
2025-09-11,12,Primaria 2°,SuperSchool,63,20,43
2025-09-11,12,Primaria 2°,SuperSchool,93,20,73
2025-09-11,12,Primaria 2°,TopKids,100,10,90
2025-09-11,12,Primaria 3°,EduMax,212,16,196
2025-09-11,12,Primaria 3°,TopKids,195,14,181
2025-09-11,12,Primaria 3°,SuperSchool,246,17,229
2025-09-11,12,Primaria 3°,SuperSchool,191,3,188
2025-09-11,12,Primaria 3°,TopKids,266,15,251
2025-09-11,12,Primaria 3°,SuperSchool,267,17,250
2025-09-11,12,Primaria 4°,TopKids,76,7,69
2025-09-11,12,Primaria 4°,EduMax,246,2,244
2025-09-11,12,Primaria 4°,EduMax,158,11,147
2025-09-11,12,Primaria 4°,TopKids,136,3,133
2025-09-11,12,Primaria 4°,EduMax,150,1,149
2025-09-11,12,Primaria 4°,SuperSchool,195,23,172
2025-09-11,12,Primaria 4°,TopKids,234,19,215
2025-09-11,12,Primaria 4°,EduMax,261,11,250
2025-09-11,12,Primaria 4°,TopKids,145,11,134
2025-09-11,12,Primaria 4°,SuperSchool,135,24,111
2025-09-11,12,Primaria 4°,SuperSchool,119,2,117
2025-09-11,12,Primaria 4°,SuperSchool,237,6,231
2025-09-11,12,Primaria 5°,EduMax,264,4,260
2025-09-11,12,Primaria 5°,TopKids,112,10,102
2025-09-11,12,Primaria 5°,SuperSchool,190,14,176
2025-09-11,12,Primaria 5°,TopKids,285,13,272
2025-09-11,12,Primaria 5°,SuperSchool,172,14,158
2025-09-11,12,Primaria 5°,EduMax,135,14,121
2025-09-11,12,Primaria 5°,EduMax,178,17,161
2025-09-11,12,Primaria 5°,SuperSchool,110,20,90
2025-09-11,12,Primaria 5°,TopKids,182,21,161
2025-09-11,12,Primaria 5°,EduMax,213,20,193
2025-09-11,12,Primaria 6°,EduMax,267,9,258
2025-09-11,12,Primaria 6°,EduMax,74,20,54
2025-09-11,12,Primaria 6°,EduMax,56,19,37
2025-09-11,12,Primaria 6°,EduMax,238,1,237
2025-09-11,12,Primaria 6°,SuperSchool,87,12,75
2025-09-11,12,Primaria 6°,SuperSchool,63,7,56
2025-09-11,12,Primaria 6°,SuperSchool,229,14,215
2025-09-11,12,Primaria 6°,SuperSchool,179,17,162
2025-09-11,12,Primaria 6°,TopKids,149,14,135
2025-09-11,12,Primaria 6°,EduMax,77,15,62
2025-09-11,12,Primaria 6°,TopKids,81,12,69
2025-09-11,12,Primaria 6°,SuperSchool,71,10,61
2025-09-11,12,Primaria 6°,SuperSchool,206,15,191
2025-09-11,12,Primaria 6°,SuperSchool,223,9,214
2025-09-11,12,Primaria 6°,TopKids,87,16,71
2025-09-11,13,Preescolar,EduMax,297,11,286
2025-09-11,13,Preescolar,SuperSchool,76,23,53
2025-09-11,13,Preescolar,TopKids,287,11,276
2025-09-11,13,Preescolar,EduMax,127,1,126
2025-09-11,13,Preescolar,TopKids,207,24,183
2025-09-11,13,Preescolar,EduMax,290,4,286
2025-09-11,13,Preescolar,EduMax,159,8,151
2025-09-11,13,Preescolar,TopKids,257,1,256
2025-09-11,13,Preescolar,SuperSchool,123,2,121
2025-09-11,13,Preescolar,SuperSchool,157,4,153
2025-09-11,13,Preescolar,TopKids,228,1,227
2025-09-11,13,Preescolar,SuperSchool,154,20,134
2025-09-11,13,Preescolar,SuperSchool,252,19,233
2025-09-11,13,Preescolar,SuperSchool,290,3,287
2025-09-11,13,Kínder,SuperSchool,205,22,183
2025-09-11,13,Kínder,SuperSchool,68,20,48
2025-09-11,13,Kínder,SuperSchool,137,9,128
2025-09-11,13,Kínder,TopKids,132,23,109
2025-09-11,13,Kínder,SuperSchool,274,17,257
2025-09-11,13,Kínder,EduMax,221,2,219
2025-09-11,13,Kínder,EduMax,116,24,92
2025-09-11,13,Kínder,SuperSchool,276,14,262
2025-09-11,13,Primaria 1°,EduMax,150,3,147
2025-09-11,13,Primaria 1°,TopKids,211,9,202
2025-09-11,13,Primaria 1°,EduMax,108,2,106
2025-09-11,13,Primaria 1°,EduMax,164,3,161
2025-09-11,13,Primaria 1°,TopKids,267,18,249
2025-09-11,13,Primaria 1°,EduMax,158,16,142
2025-09-11,13,Primaria 1°,SuperSchool,269,11,258
2025-09-11,13,Primaria 1°,SuperSchool,264,24,240
2025-09-11,13,Primaria 1°,EduMax,52,6,46
2025-09-11,13,Primaria 1°,TopKids,161,12,149
2025-09-11,13,Primaria 1°,SuperSchool,197,6,191
2025-09-11,13,Primaria 1°,EduMax,233,9,224
2025-09-11,13,Primaria 2°,SuperSchool,133,22,111
2025-09-11,13,Primaria 2°,TopKids,80,12,68
2025-09-11,13,Primaria 2°,SuperSchool,212,12,200
2025-09-11,13,Primaria 2°,EduMax,275,9,266
2025-09-11,13,Primaria 2°,TopKids,80,20,60
2025-09-11,13,Primaria 3°,SuperSchool,54,5,49
2025-09-11,13,Primaria 3°,EduMax,64,1,63
2025-09-11,13,Primaria 3°,SuperSchool,150,7,143
2025-09-11,13,Primaria 3°,TopKids,267,10,257
2025-09-11,13,Primaria 3°,EduMax,143,14,129
2025-09-11,13,Primaria 3°,SuperSchool,182,16,166
2025-09-11,13,Primaria 3°,SuperSchool,211,10,201
2025-09-11,13,Primaria 3°,TopKids,204,18,186
2025-09-11,13,Primaria 3°,SuperSchool,66,11,55
2025-09-11,13,Primaria 3°,SuperSchool,166,24,142
2025-09-11,13,Primaria 3°,EduMax,172,22,150
2025-09-11,13,Primaria 3°,SuperSchool,262,24,238
2025-09-11,13,Primaria 3°,EduMax,257,17,240
2025-09-11,13,Primaria 3°,SuperSchool,71,2,69
2025-09-11,13,Primaria 3°,TopKids,162,5,157
2025-09-11,13,Primaria 3°,EduMax,252,1,251
2025-09-11,13,Primaria 3°,SuperSchool,236,6,230
2025-09-11,13,Primaria 3°,TopKids,76,8,68
2025-09-11,13,Primaria 3°,SuperSchool,80,12,68
2025-09-11,13,Primaria 4°,TopKids,246,15,231
2025-09-11,13,Primaria 4°,EduMax,192,20,172
2025-09-11,13,Primaria 4°,TopKids,155,7,148
2025-09-11,13,Primaria 4°,EduMax,139,10,129
2025-09-11,13,Primaria 4°,SuperSchool,262,2,260
2025-09-11,13,Primaria 4°,SuperSchool,79,1,78
2025-09-11,13,Primaria 4°,SuperSchool,125,12,113
2025-09-11,13,Primaria 4°,TopKids,265,8,257
2025-09-11,13,Primaria 4°,SuperSchool,237,17,220
2025-09-11,13,Primaria 4°,TopKids,187,15,172
2025-09-11,13,Primaria 4°,SuperSchool,282,18,264
2025-09-11,13,Primaria 4°,SuperSchool,121,14,107
2025-09-11,13,Primaria 4°,TopKids,126,16,110
2025-09-11,13,Primaria 5°,SuperSchool,250,19,231
2025-09-11,13,Primaria 5°,SuperSchool,288,11,277
2025-09-11,13,Primaria 5°,TopKids,113,6,107
2025-09-11,13,Primaria 5°,EduMax,65,5,60
2025-09-11,13,Primaria 5°,EduMax,292,23,269
2025-09-11,13,Primaria 5°,EduMax,283,12,271
2025-09-11,13,Primaria 5°,SuperSchool,212,4,208
2025-09-11,13,Primaria 5°,EduMax,73,12,61
2025-09-11,13,Primaria 5°,TopKids,189,3,186
2025-09-11,13,Primaria 5°,EduMax,132,5,127
2025-09-11,13,Primaria 5°,EduMax,264,8,256
2025-09-11,13,Primaria 5°,EduMax,224,16,208
2025-09-11,13,Primaria 5°,SuperSchool,291,11,280
2025-09-11,13,Primaria 5°,EduMax,187,11,176
2025-09-11,13,Primaria 5°,SuperSchool,143,21,122
2025-09-11,13,Primaria 5°,SuperSchool,274,14,260
2025-09-11,13,Primaria 5°,TopKids,184,8,176
2025-09-11,13,Primaria 5°,SuperSchool,150,3,147
2025-09-11,13,Primaria 6°,TopKids,61,19,42
2025-09-11,13,Primaria 6°,SuperSchool,60,3,57
2025-09-11,13,Primaria 6°,SuperSchool,243,24,219
2025-09-11,13,Primaria 6°,EduMax,287,22,265
2025-09-11,13,Primaria 6°,SuperSchool,258,2,256
2025-09-11,13,Primaria 6°,EduMax,232,15,217
2025-09-11,13,Primaria 6°,TopKids,183,14,169
2025-09-11,13,Primaria 6°,SuperSchool,105,19,86
2025-09-11,13,Primaria 6°,TopKids,253,9,244
2025-09-11,13,Primaria 6°,SuperSchool,142,5,137
2025-09-11,13,Primaria 6°,EduMax,207,14,193
2025-09-11,13,Primaria 6°,SuperSchool,212,11,201
2025-09-11,13,Primaria 6°,SuperSchool,245,20,225
2025-09-11,13,Primaria 6°,SuperSchool,119,10,109
2025-09-11,13,Primaria 6°,TopKids,85,17,68
2025-09-11,13,Primaria 6°,EduMax,271,22,249
2025-09-11,13,Primaria 6°,SuperSchool,246,2,244
2025-09-11,14,Preescolar,TopKids,241,21,220
2025-09-11,14,Preescolar,TopKids,223,22,201
2025-09-11,14,Preescolar,TopKids,225,22,203
2025-09-11,14,Preescolar,EduMax,298,24,274
2025-09-11,14,Preescolar,SuperSchool,88,11,77
2025-09-11,14,Kínder,EduMax,90,22,68
2025-09-11,14,Kínder,TopKids,73,23,50
2025-09-11,14,Kínder,TopKids,274,10,264
2025-09-11,14,Kínder,TopKids,187,8,179
2025-09-11,14,Kínder,SuperSchool,206,2,204
2025-09-11,14,Kínder,EduMax,179,21,158
2025-09-11,14,Kínder,TopKids,144,22,122
2025-09-11,14,Kínder,SuperSchool,140,10,130
2025-09-11,14,Kínder,EduMax,172,4,168
2025-09-11,14,Kínder,SuperSchool,173,1,172
2025-09-11,14,Kínder,TopKids,267,22,245
2025-09-11,14,Kínder,EduMax,136,4,132
2025-09-11,14,Kínder,TopKids,133,13,120
2025-09-11,14,Primaria 1°,EduMax,243,6,237
2025-09-11,14,Primaria 1°,TopKids,228,4,224
2025-09-11,14,Primaria 1°,EduMax,168,9,159
2025-09-11,14,Primaria 1°,SuperSchool,156,5,151
2025-09-11,14,Primaria 1°,SuperSchool,105,1,104
2025-09-11,14,Primaria 2°,TopKids,180,22,158
2025-09-11,14,Primaria 2°,SuperSchool,209,24,185
2025-09-11,14,Primaria 2°,EduMax,242,2,240
2025-09-11,14,Primaria 2°,SuperSchool,235,14,221
2025-09-11,14,Primaria 2°,SuperSchool,93,9,84
2025-09-11,14,Primaria 2°,TopKids,233,20,213
2025-09-11,14,Primaria 3°,EduMax,283,24,259
2025-09-11,14,Primaria 3°,TopKids,196,17,179
2025-09-11,14,Primaria 3°,TopKids,131,7,124
2025-09-11,14,Primaria 3°,TopKids,204,7,197
2025-09-11,14,Primaria 3°,EduMax,72,20,52
2025-09-11,14,Primaria 3°,TopKids,267,16,251
2025-09-11,14,Primaria 3°,TopKids,255,16,239
2025-09-11,14,Primaria 3°,TopKids,268,24,244
2025-09-11,14,Primaria 3°,SuperSchool,200,22,178
2025-09-11,14,Primaria 3°,SuperSchool,240,10,230
2025-09-11,14,Primaria 3°,TopKids,299,23,276
2025-09-11,14,Primaria 4°,EduMax,86,8,78
2025-09-11,14,Primaria 4°,EduMax,215,1,214
2025-09-11,14,Primaria 4°,EduMax,84,7,77
2025-09-11,14,Primaria 4°,EduMax,135,21,114
2025-09-11,14,Primaria 4°,SuperSchool,91,23,68
2025-09-11,14,Primaria 4°,SuperSchool,204,11,193
2025-09-11,14,Primaria 4°,TopKids,268,8,260
2025-09-11,14,Primaria 4°,SuperSchool,131,4,127
2025-09-11,14,Primaria 4°,EduMax,62,23,39
2025-09-11,14,Primaria 4°,EduMax,229,22,207
2025-09-11,14,Primaria 4°,TopKids,207,13,194
2025-09-11,14,Primaria 4°,EduMax,69,6,63
2025-09-11,14,Primaria 4°,SuperSchool,224,6,218
2025-09-11,14,Primaria 4°,TopKids,256,15,241
2025-09-11,14,Primaria 5°,EduMax,238,8,230
2025-09-11,14,Primaria 5°,SuperSchool,199,6,193
2025-09-11,14,Primaria 5°,SuperSchool,177,17,160
2025-09-11,14,Primaria 5°,TopKids,265,22,243
2025-09-11,14,Primaria 5°,TopKids,285,23,262
2025-09-11,14,Primaria 5°,EduMax,245,16,229
2025-09-11,14,Primaria 5°,TopKids,146,18,128
2025-09-11,14,Primaria 5°,TopKids,294,10,284
2025-09-11,14,Primaria 5°,SuperSchool,214,13,201
2025-09-11,14,Primaria 5°,EduMax,79,23,56
2025-09-11,14,Primaria 5°,TopKids,295,1,294
2025-09-11,14,Primaria 5°,EduMax,195,4,191
2025-09-11,14,Primaria 5°,TopKids,133,10,123
2025-09-11,14,Primaria 5°,SuperSchool,187,5,182
2025-09-11,14,Primaria 5°,EduMax,109,18,91
2025-09-11,14,Primaria 5°,EduMax,124,3,121
2025-09-11,14,Primaria 5°,SuperSchool,192,22,170
2025-09-11,14,Primaria 5°,TopKids,132,5,127
2025-09-11,14,Primaria 6°,SuperSchool,180,10,170
2025-09-11,14,Primaria 6°,SuperSchool,181,24,157
2025-09-11,14,Primaria 6°,SuperSchool,293,2,291
2025-09-11,14,Primaria 6°,SuperSchool,210,21,189
2025-09-11,14,Primaria 6°,TopKids,246,23,223
2025-09-11,14,Primaria 6°,SuperSchool,106,13,93
2025-09-11,14,Primaria 6°,SuperSchool,175,10,165
2025-09-11,14,Primaria 6°,EduMax,115,6,109
2025-09-11,14,Primaria 6°,SuperSchool,242,18,224
2025-09-11,14,Primaria 6°,TopKids,299,21,278
2025-09-11,15,Preescolar,EduMax,116,6,110
2025-09-11,15,Preescolar,TopKids,149,11,138
2025-09-11,15,Preescolar,SuperSchool,196,8,188
2025-09-11,15,Preescolar,EduMax,139,16,123
2025-09-11,15,Preescolar,SuperSchool,100,16,84
2025-09-11,15,Preescolar,SuperSchool,187,15,172
2025-09-11,15,Preescolar,TopKids,171,4,167
2025-09-11,15,Preescolar,SuperSchool,126,12,114
2025-09-11,15,Preescolar,TopKids,78,23,55
2025-09-11,15,Preescolar,SuperSchool,87,14,73
2025-09-11,15,Preescolar,TopKids,84,8,76
2025-09-11,15,Kínder,EduMax,159,5,154
2025-09-11,15,Kínder,EduMax,283,3,280
2025-09-11,15,Kínder,TopKids,59,9,50
2025-09-11,15,Kínder,SuperSchool,173,6,167
2025-09-11,15,Kínder,TopKids,143,9,134
2025-09-11,15,Kínder,TopKids,212,7,205
2025-09-11,15,Kínder,EduMax,219,2,217
2025-09-11,15,Kínder,SuperSchool,176,3,173
2025-09-11,15,Kínder,SuperSchool,153,13,140
2025-09-11,15,Kínder,TopKids,281,20,261
2025-09-11,15,Kínder,TopKids,210,2,208
2025-09-11,15,Kínder,EduMax,227,9,218
2025-09-11,15,Kínder,TopKids,186,10,176
2025-09-11,15,Kínder,EduMax,179,5,174
2025-09-11,15,Kínder,SuperSchool,115,20,95
2025-09-11,15,Kínder,EduMax,208,1,207
2025-09-11,15,Primaria 1°,TopKids,183,14,169
2025-09-11,15,Primaria 1°,EduMax,64,1,63
2025-09-11,15,Primaria 1°,SuperSchool,272,17,255
2025-09-11,15,Primaria 1°,TopKids,256,20,236
2025-09-11,15,Primaria 1°,SuperSchool,241,9,232
2025-09-11,15,Primaria 1°,SuperSchool,221,2,219
2025-09-11,15,Primaria 1°,TopKids,58,16,42
2025-09-11,15,Primaria 1°,EduMax,66,20,46
2025-09-11,15,Primaria 1°,TopKids,168,4,164
2025-09-11,15,Primaria 1°,TopKids,87,5,82
2025-09-11,15,Primaria 1°,EduMax,116,24,92
2025-09-11,15,Primaria 1°,SuperSchool,193,11,182
2025-09-11,15,Primaria 1°,SuperSchool,195,14,181
2025-09-11,15,Primaria 1°,EduMax,253,22,231
2025-09-11,15,Primaria 1°,SuperSchool,174,10,164
2025-09-11,15,Primaria 1°,SuperSchool,216,2,214
2025-09-11,15,Primaria 2°,EduMax,162,16,146
2025-09-11,15,Primaria 2°,EduMax,147,11,136
2025-09-11,15,Primaria 2°,TopKids,176,22,154
2025-09-11,15,Primaria 2°,TopKids,204,22,182
2025-09-11,15,Primaria 2°,SuperSchool,128,9,119
2025-09-11,15,Primaria 2°,EduMax,98,16,82
2025-09-11,15,Primaria 2°,TopKids,129,3,126
2025-09-11,15,Primaria 2°,TopKids,161,11,150
2025-09-11,15,Primaria 2°,EduMax,282,14,268
2025-09-11,15,Primaria 2°,EduMax,207,13,194
2025-09-11,15,Primaria 2°,SuperSchool,293,14,279
2025-09-11,15,Primaria 2°,SuperSchool,273,6,267
2025-09-11,15,Primaria 2°,EduMax,252,17,235
2025-09-11,15,Primaria 3°,EduMax,191,14,177
2025-09-11,15,Primaria 3°,TopKids,68,22,46
2025-09-11,15,Primaria 3°,EduMax,112,13,99
2025-09-11,15,Primaria 3°,EduMax,231,19,212
2025-09-11,15,Primaria 3°,TopKids,59,5,54
2025-09-11,15,Primaria 3°,SuperSchool,194,22,172
2025-09-11,15,Primaria 3°,TopKids,182,21,161
2025-09-11,15,Primaria 3°,SuperSchool,167,7,160
2025-09-11,15,Primaria 3°,TopKids,192,15,177
2025-09-11,15,Primaria 3°,SuperSchool,264,1,263
2025-09-11,15,Primaria 3°,EduMax,221,2,219
2025-09-11,15,Primaria 4°,TopKids,248,9,239
2025-09-11,15,Primaria 4°,TopKids,205,22,183
2025-09-11,15,Primaria 4°,TopKids,102,10,92
2025-09-11,15,Primaria 4°,EduMax,170,22,148
2025-09-11,15,Primaria 4°,SuperSchool,266,12,254
2025-09-11,15,Primaria 4°,TopKids,111,5,106
2025-09-11,15,Primaria 5°,SuperSchool,128,9,119
2025-09-11,15,Primaria 5°,EduMax,95,2,93
2025-09-11,15,Primaria 5°,TopKids,109,6,103
2025-09-11,15,Primaria 5°,SuperSchool,85,22,63
2025-09-11,15,Primaria 5°,SuperSchool,252,6,246
2025-09-11,15,Primaria 5°,SuperSchool,242,19,223
2025-09-11,15,Primaria 5°,TopKids,227,10,217
2025-09-11,15,Primaria 5°,EduMax,162,24,138
2025-09-11,15,Primaria 6°,EduMax,107,21,86
2025-09-11,15,Primaria 6°,EduMax,210,12,198
2025-09-11,15,Primaria 6°,SuperSchool,144,17,127
2025-09-11,15,Primaria 6°,TopKids,206,19,187
2025-09-11,15,Primaria 6°,SuperSchool,267,4,263
2025-09-11,15,Primaria 6°,TopKids,217,23,194
2025-09-11,15,Primaria 6°,SuperSchool,211,19,192
2025-09-11,15,Primaria 6°,EduMax,131,16,115
2025-09-11,15,Primaria 6°,SuperSchool,273,18,255
2025-09-11,15,Primaria 6°,EduMax,131,12,119
2025-09-11,15,Primaria 6°,EduMax,270,21,249
2025-09-11,16,Preescolar,EduMax,50,23,27
2025-09-11,16,Preescolar,SuperSchool,146,21,125
2025-09-11,16,Preescolar,TopKids,148,23,125
2025-09-11,16,Preescolar,SuperSchool,204,20,184
2025-09-11,16,Preescolar,TopKids,193,21,172
2025-09-11,16,Preescolar,EduMax,97,24,73
2025-09-11,16,Preescolar,SuperSchool,81,21,60
2025-09-11,16,Preescolar,SuperSchool,179,13,166
2025-09-11,16,Preescolar,EduMax,278,21,257
2025-09-11,16,Preescolar,SuperSchool,145,6,139
2025-09-11,16,Preescolar,SuperSchool,235,2,233
2025-09-11,16,Preescolar,TopKids,270,17,253
2025-09-11,16,Preescolar,TopKids,296,1,295
2025-09-11,16,Preescolar,SuperSchool,68,5,63
2025-09-11,16,Preescolar,SuperSchool,264,24,240
2025-09-11,16,Preescolar,EduMax,70,1,69
2025-09-11,16,Kínder,EduMax,91,22,69
2025-09-11,16,Kínder,TopKids,77,12,65
2025-09-11,16,Kínder,EduMax,176,12,164
2025-09-11,16,Kínder,TopKids,193,20,173
2025-09-11,16,Kínder,SuperSchool,84,7,77
2025-09-11,16,Kínder,EduMax,63,4,59
2025-09-11,16,Kínder,EduMax,251,24,227
2025-09-11,16,Kínder,EduMax,71,16,55
2025-09-11,16,Kínder,TopKids,288,8,280
2025-09-11,16,Kínder,TopKids,169,11,158
2025-09-11,16,Kínder,TopKids,146,2,144
2025-09-11,16,Kínder,SuperSchool,260,20,240
2025-09-11,16,Kínder,EduMax,196,21,175
2025-09-11,16,Kínder,TopKids,61,10,51
2025-09-11,16,Primaria 1°,TopKids,291,16,275
2025-09-11,16,Primaria 1°,SuperSchool,110,6,104
2025-09-11,16,Primaria 1°,SuperSchool,103,13,90
2025-09-11,16,Primaria 1°,TopKids,202,10,192
2025-09-11,16,Primaria 1°,TopKids,155,1,154
2025-09-11,16,Primaria 1°,TopKids,69,9,60
2025-09-11,16,Primaria 1°,TopKids,165,2,163
2025-09-11,16,Primaria 1°,SuperSchool,104,12,92
2025-09-11,16,Primaria 1°,TopKids,228,5,223
2025-09-11,16,Primaria 1°,EduMax,189,14,175
2025-09-11,16,Primaria 1°,TopKids,273,8,265
2025-09-11,16,Primaria 2°,SuperSchool,219,10,209
2025-09-11,16,Primaria 2°,SuperSchool,74,22,52
2025-09-11,16,Primaria 2°,EduMax,127,23,104
2025-09-11,16,Primaria 2°,SuperSchool,168,23,145
2025-09-11,16,Primaria 2°,TopKids,221,19,202
2025-09-11,16,Primaria 2°,EduMax,202,20,182
2025-09-11,16,Primaria 2°,EduMax,142,23,119
2025-09-11,16,Primaria 2°,SuperSchool,157,13,144
2025-09-11,16,Primaria 2°,SuperSchool,171,3,168
2025-09-11,16,Primaria 2°,EduMax,252,2,250
2025-09-11,16,Primaria 2°,EduMax,163,24,139
2025-09-11,16,Primaria 2°,SuperSchool,250,1,249
2025-09-11,16,Primaria 2°,EduMax,267,16,251
2025-09-11,16,Primaria 2°,SuperSchool,178,21,157
2025-09-11,16,Primaria 2°,SuperSchool,173,17,156
2025-09-11,16,Primaria 2°,EduMax,178,13,165
2025-09-11,16,Primaria 2°,EduMax,117,15,102
2025-09-11,16,Primaria 2°,EduMax,289,5,284
2025-09-11,16,Primaria 3°,SuperSchool,75,23,52
2025-09-11,16,Primaria 3°,SuperSchool,245,17,228
2025-09-11,16,Primaria 3°,EduMax,234,4,230
2025-09-11,16,Primaria 3°,TopKids,299,1,298
2025-09-11,16,Primaria 3°,EduMax,126,9,117
2025-09-11,16,Primaria 3°,EduMax,210,9,201
2025-09-11,16,Primaria 3°,EduMax,59,11,48
2025-09-11,16,Primaria 3°,TopKids,69,22,47
2025-09-11,16,Primaria 3°,EduMax,125,14,111
2025-09-11,16,Primaria 3°,EduMax,225,22,203
2025-09-11,16,Primaria 3°,SuperSchool,104,14,90
2025-09-11,16,Primaria 3°,EduMax,51,11,40
2025-09-11,16,Primaria 3°,TopKids,183,3,180
2025-09-11,16,Primaria 3°,TopKids,122,3,119
2025-09-11,16,Primaria 3°,SuperSchool,243,15,228
2025-09-11,16,Primaria 3°,TopKids,89,16,73
2025-09-11,16,Primaria 3°,TopKids,226,3,223
2025-09-11,16,Primaria 3°,TopKids,70,3,67
2025-09-11,16,Primaria 4°,SuperSchool,274,5,269
2025-09-11,16,Primaria 4°,TopKids,131,19,112
2025-09-11,16,Primaria 4°,EduMax,245,13,232
2025-09-11,16,Primaria 4°,SuperSchool,274,4,270
2025-09-11,16,Primaria 4°,SuperSchool,66,11,55
2025-09-11,16,Primaria 4°,TopKids,137,7,130
2025-09-11,16,Primaria 4°,SuperSchool,234,19,215
2025-09-11,16,Primaria 4°,SuperSchool,291,13,278
2025-09-11,16,Primaria 4°,SuperSchool,131,21,110
2025-09-11,16,Primaria 4°,EduMax,228,15,213
2025-09-11,16,Primaria 4°,SuperSchool,271,14,257
2025-09-11,16,Primaria 5°,SuperSchool,253,15,238
2025-09-11,16,Primaria 5°,SuperSchool,211,20,191
2025-09-11,16,Primaria 5°,EduMax,244,5,239
2025-09-11,16,Primaria 5°,EduMax,58,24,34
2025-09-11,16,Primaria 5°,SuperSchool,204,17,187
2025-09-11,16,Primaria 5°,SuperSchool,133,15,118
2025-09-11,16,Primaria 5°,EduMax,94,9,85
2025-09-11,16,Primaria 6°,TopKids,147,11,136
2025-09-11,16,Primaria 6°,TopKids,207,3,204
2025-09-11,16,Primaria 6°,EduMax,177,24,153
2025-09-11,16,Primaria 6°,EduMax,114,6,108
2025-09-11,16,Primaria 6°,EduMax,220,16,204
2025-09-11,16,Primaria 6°,TopKids,242,5,237
2025-09-12,9,Preescolar,EduMax,76,10,66
2025-09-12,9,Preescolar,SuperSchool,173,23,150
2025-09-12,9,Preescolar,EduMax,156,16,140
2025-09-12,9,Preescolar,SuperSchool,157,18,139
2025-09-12,9,Preescolar,EduMax,286,5,281
2025-09-12,9,Preescolar,EduMax,175,13,162
2025-09-12,9,Preescolar,SuperSchool,222,19,203
2025-09-12,9,Preescolar,TopKids,62,11,51
2025-09-12,9,Preescolar,TopKids,63,10,53
2025-09-12,9,Preescolar,EduMax,153,23,130
2025-09-12,9,Preescolar,EduMax,113,22,91
2025-09-12,9,Preescolar,SuperSchool,236,20,216
2025-09-12,9,Preescolar,EduMax,73,14,59
2025-09-12,9,Kínder,TopKids,295,16,279
2025-09-12,9,Kínder,EduMax,283,22,261
2025-09-12,9,Kínder,SuperSchool,147,5,142
2025-09-12,9,Kínder,TopKids,244,23,221
2025-09-12,9,Kínder,TopKids,169,12,157
2025-09-12,9,Kínder,EduMax,219,11,208
2025-09-12,9,Primaria 1°,SuperSchool,290,4,286
2025-09-12,9,Primaria 1°,EduMax,184,5,179
2025-09-12,9,Primaria 1°,EduMax,98,14,84
2025-09-12,9,Primaria 1°,TopKids,150,2,148
2025-09-12,9,Primaria 1°,TopKids,159,16,143
2025-09-12,9,Primaria 1°,EduMax,226,16,210
2025-09-12,9,Primaria 1°,SuperSchool,229,20,209
2025-09-12,9,Primaria 1°,SuperSchool,182,4,178
2025-09-12,9,Primaria 1°,TopKids,110,5,105
2025-09-12,9,Primaria 1°,TopKids,207,8,199
2025-09-12,9,Primaria 1°,TopKids,97,6,91
2025-09-12,9,Primaria 1°,EduMax,78,9,69
2025-09-12,9,Primaria 1°,EduMax,133,18,115
2025-09-12,9,Primaria 1°,TopKids,68,7,61
2025-09-12,9,Primaria 1°,EduMax,182,7,175
2025-09-12,9,Primaria 1°,TopKids,119,18,101
2025-09-12,9,Primaria 1°,SuperSchool,192,10,182
2025-09-12,9,Primaria 1°,EduMax,73,1,72
2025-09-12,9,Primaria 2°,EduMax,72,15,57
2025-09-12,9,Primaria 2°,EduMax,161,5,156
2025-09-12,9,Primaria 2°,EduMax,97,14,83
2025-09-12,9,Primaria 2°,TopKids,164,4,160
2025-09-12,9,Primaria 2°,EduMax,109,22,87
2025-09-12,9,Primaria 2°,SuperSchool,128,17,111
2025-09-12,9,Primaria 2°,TopKids,146,24,122
2025-09-12,9,Primaria 2°,TopKids,97,24,73
2025-09-12,9,Primaria 2°,EduMax,92,9,83
2025-09-12,9,Primaria 2°,SuperSchool,112,15,97
2025-09-12,9,Primaria 2°,EduMax,121,3,118
2025-09-12,9,Primaria 2°,EduMax,168,19,149
2025-09-12,9,Primaria 2°,EduMax,83,1,82
2025-09-12,9,Primaria 2°,EduMax,278,17,261
2025-09-12,9,Primaria 2°,SuperSchool,294,16,278
2025-09-12,9,Primaria 2°,TopKids,59,19,40
2025-09-12,9,Primaria 3°,TopKids,176,3,173
2025-09-12,9,Primaria 3°,EduMax,52,15,37
2025-09-12,9,Primaria 3°,TopKids,293,9,284
2025-09-12,9,Primaria 3°,TopKids,141,2,139
2025-09-12,9,Primaria 3°,EduMax,215,5,210
2025-09-12,9,Primaria 3°,EduMax,182,22,160
2025-09-12,9,Primaria 3°,SuperSchool,75,23,52
2025-09-12,9,Primaria 3°,EduMax,95,14,81
2025-09-12,9,Primaria 3°,TopKids,237,1,236
2025-09-12,9,Primaria 3°,SuperSchool,264,5,259
2025-09-12,9,Primaria 3°,SuperSchool,61,5,56
2025-09-12,9,Primaria 3°,SuperSchool,190,11,179
2025-09-12,9,Primaria 3°,SuperSchool,82,12,70
2025-09-12,9,Primaria 3°,EduMax,284,12,272
2025-09-12,9,Primaria 3°,SuperSchool,279,24,255
2025-09-12,9,Primaria 4°,SuperSchool,131,16,115
2025-09-12,9,Primaria 4°,SuperSchool,248,14,234
2025-09-12,9,Primaria 4°,SuperSchool,230,21,209
2025-09-12,9,Primaria 4°,TopKids,291,11,280
2025-09-12,9,Primaria 4°,TopKids,59,19,40
2025-09-12,9,Primaria 4°,SuperSchool,191,15,176
2025-09-12,9,Primaria 4°,EduMax,216,13,203
2025-09-12,9,Primaria 4°,TopKids,131,3,128
2025-09-12,9,Primaria 4°,SuperSchool,274,24,250
2025-09-12,9,Primaria 4°,SuperSchool,132,6,126
2025-09-12,9,Primaria 4°,TopKids,169,7,162
2025-09-12,9,Primaria 4°,TopKids,151,1,150
2025-09-12,9,Primaria 4°,SuperSchool,106,14,92
2025-09-12,9,Primaria 4°,TopKids,200,16,184
2025-09-12,9,Primaria 4°,TopKids,199,7,192
2025-09-12,9,Primaria 4°,EduMax,82,9,73
2025-09-12,9,Primaria 4°,EduMax,215,24,191
2025-09-12,9,Primaria 4°,TopKids,254,21,233
2025-09-12,9,Primaria 5°,TopKids,228,17,211
2025-09-12,9,Primaria 5°,TopKids,294,1,293
2025-09-12,9,Primaria 5°,SuperSchool,106,22,84
2025-09-12,9,Primaria 5°,TopKids,234,23,211
2025-09-12,9,Primaria 5°,TopKids,275,18,257
2025-09-12,9,Primaria 5°,SuperSchool,233,21,212
2025-09-12,9,Primaria 5°,EduMax,72,18,54
2025-09-12,9,Primaria 5°,SuperSchool,65,9,56
2025-09-12,9,Primaria 5°,SuperSchool,51,14,37
2025-09-12,9,Primaria 5°,TopKids,115,16,99
2025-09-12,9,Primaria 5°,SuperSchool,292,13,279
2025-09-12,9,Primaria 5°,SuperSchool,268,1,267
2025-09-12,9,Primaria 5°,SuperSchool,196,16,180
2025-09-12,9,Primaria 5°,SuperSchool,126,19,107
2025-09-12,9,Primaria 5°,TopKids,241,3,238
2025-09-12,9,Primaria 5°,EduMax,210,3,207
2025-09-12,9,Primaria 6°,TopKids,97,13,84
2025-09-12,9,Primaria 6°,SuperSchool,124,4,120
2025-09-12,9,Primaria 6°,TopKids,141,4,137
2025-09-12,9,Primaria 6°,EduMax,64,23,41
2025-09-12,9,Primaria 6°,TopKids,191,21,170
2025-09-12,9,Primaria 6°,EduMax,174,3,171
2025-09-12,9,Primaria 6°,TopKids,120,16,104
2025-09-12,9,Primaria 6°,EduMax,295,7,288
2025-09-12,9,Primaria 6°,EduMax,156,2,154
2025-09-12,10,Preescolar,TopKids,87,16,71
2025-09-12,10,Preescolar,SuperSchool,156,22,134
2025-09-12,10,Preescolar,EduMax,276,18,258
2025-09-12,10,Preescolar,SuperSchool,290,2,288
2025-09-12,10,Preescolar,TopKids,91,10,81
2025-09-12,10,Preescolar,SuperSchool,281,20,261
2025-09-12,10,Preescolar,EduMax,188,5,183
2025-09-12,10,Preescolar,EduMax,264,1,263
2025-09-12,10,Preescolar,TopKids,228,15,213
2025-09-12,10,Preescolar,EduMax,194,21,173
2025-09-12,10,Preescolar,TopKids,97,14,83
2025-09-12,10,Preescolar,TopKids,172,19,153
2025-09-12,10,Kínder,SuperSchool,291,1,290
2025-09-12,10,Kínder,TopKids,85,3,82
2025-09-12,10,Kínder,TopKids,219,3,216
2025-09-12,10,Kínder,EduMax,118,17,101
2025-09-12,10,Kínder,SuperSchool,299,14,285
2025-09-12,10,Kínder,TopKids,112,14,98
2025-09-12,10,Kínder,EduMax,145,19,126
2025-09-12,10,Kínder,SuperSchool,125,16,109
2025-09-12,10,Kínder,SuperSchool,72,17,55
2025-09-12,10,Kínder,EduMax,197,6,191
2025-09-12,10,Kínder,EduMax,257,3,254
2025-09-12,10,Kínder,SuperSchool,100,7,93
2025-09-12,10,Primaria 1°,SuperSchool,69,23,46
2025-09-12,10,Primaria 1°,TopKids,273,10,263
2025-09-12,10,Primaria 1°,SuperSchool,180,10,170
2025-09-12,10,Primaria 1°,TopKids,58,2,56
2025-09-12,10,Primaria 1°,EduMax,278,3,275
2025-09-12,10,Primaria 1°,TopKids,128,21,107
2025-09-12,10,Primaria 1°,EduMax,149,23,126
2025-09-12,10,Primaria 1°,SuperSchool,62,23,39
2025-09-12,10,Primaria 1°,SuperSchool,160,7,153
2025-09-12,10,Primaria 1°,TopKids,219,13,206
2025-09-12,10,Primaria 1°,EduMax,284,1,283
2025-09-12,10,Primaria 1°,TopKids,50,3,47
2025-09-12,10,Primaria 1°,SuperSchool,56,3,53
2025-09-12,10,Primaria 1°,EduMax,227,5,222
2025-09-12,10,Primaria 1°,SuperSchool,163,16,147
2025-09-12,10,Primaria 1°,TopKids,248,1,247
2025-09-12,10,Primaria 1°,SuperSchool,288,1,287
2025-09-12,10,Primaria 1°,TopKids,66,9,57
2025-09-12,10,Primaria 1°,TopKids,143,15,128
2025-09-12,10,Primaria 2°,TopKids,269,5,264
2025-09-12,10,Primaria 2°,EduMax,103,6,97
2025-09-12,10,Primaria 2°,SuperSchool,125,17,108
2025-09-12,10,Primaria 2°,EduMax,248,24,224
2025-09-12,10,Primaria 2°,EduMax,236,8,228
2025-09-12,10,Primaria 2°,TopKids,139,18,121
2025-09-12,10,Primaria 2°,EduMax,90,23,67
2025-09-12,10,Primaria 2°,SuperSchool,155,22,133
2025-09-12,10,Primaria 2°,SuperSchool,294,18,276
2025-09-12,10,Primaria 2°,TopKids,218,3,215
2025-09-12,10,Primaria 2°,EduMax,72,15,57
2025-09-12,10,Primaria 2°,EduMax,155,4,151
2025-09-12,10,Primaria 2°,EduMax,68,17,51
2025-09-12,10,Primaria 2°,EduMax,263,21,242
2025-09-12,10,Primaria 3°,EduMax,178,11,167
2025-09-12,10,Primaria 3°,TopKids,137,3,134
2025-09-12,10,Primaria 3°,EduMax,117,9,108
2025-09-12,10,Primaria 3°,TopKids,157,16,141
2025-09-12,10,Primaria 3°,TopKids,260,14,246
2025-09-12,10,Primaria 3°,TopKids,277,23,254
2025-09-12,10,Primaria 3°,SuperSchool,151,22,129
2025-09-12,10,Primaria 3°,TopKids,181,8,173
2025-09-12,10,Primaria 3°,SuperSchool,107,23,84
2025-09-12,10,Primaria 3°,EduMax,275,20,255
2025-09-12,10,Primaria 4°,EduMax,179,23,156
2025-09-12,10,Primaria 4°,TopKids,98,11,87
2025-09-12,10,Primaria 4°,TopKids,145,12,133
2025-09-12,10,Primaria 4°,EduMax,80,1,79
2025-09-12,10,Primaria 4°,EduMax,195,24,171
2025-09-12,10,Primaria 4°,EduMax,206,23,183
2025-09-12,10,Primaria 4°,TopKids,79,17,62
2025-09-12,10,Primaria 5°,SuperSchool,226,17,209
2025-09-12,10,Primaria 5°,EduMax,68,5,63
2025-09-12,10,Primaria 5°,EduMax,298,9,289
2025-09-12,10,Primaria 5°,TopKids,225,12,213
2025-09-12,10,Primaria 5°,EduMax,294,5,289
2025-09-12,10,Primaria 5°,TopKids,73,21,52
2025-09-12,10,Primaria 5°,EduMax,151,22,129
2025-09-12,10,Primaria 5°,SuperSchool,106,17,89
2025-09-12,10,Primaria 5°,TopKids,251,3,248
2025-09-12,10,Primaria 5°,TopKids,270,2,268
2025-09-12,10,Primaria 5°,SuperSchool,140,14,126
2025-09-12,10,Primaria 5°,SuperSchool,93,24,69
2025-09-12,10,Primaria 5°,TopKids,275,24,251
2025-09-12,10,Primaria 5°,EduMax,54,13,41
2025-09-12,10,Primaria 5°,EduMax,104,17,87
2025-09-12,10,Primaria 5°,EduMax,151,19,132
2025-09-12,10,Primaria 5°,EduMax,226,17,209
2025-09-12,10,Primaria 5°,EduMax,139,15,124
2025-09-12,10,Primaria 5°,TopKids,269,20,249
2025-09-12,10,Primaria 6°,SuperSchool,192,2,190
2025-09-12,10,Primaria 6°,TopKids,264,3,261
2025-09-12,10,Primaria 6°,TopKids,276,11,265
2025-09-12,10,Primaria 6°,SuperSchool,240,2,238
2025-09-12,10,Primaria 6°,EduMax,101,20,81
2025-09-12,10,Primaria 6°,TopKids,217,2,215
2025-09-12,10,Primaria 6°,TopKids,227,22,205
2025-09-12,10,Primaria 6°,SuperSchool,294,8,286
2025-09-12,11,Preescolar,TopKids,87,24,63
2025-09-12,11,Preescolar,EduMax,189,23,166
2025-09-12,11,Preescolar,SuperSchool,175,12,163
2025-09-12,11,Preescolar,SuperSchool,272,9,263
2025-09-12,11,Preescolar,TopKids,81,11,70
2025-09-12,11,Preescolar,SuperSchool,265,8,257
2025-09-12,11,Preescolar,EduMax,165,24,141
2025-09-12,11,Preescolar,EduMax,156,5,151
2025-09-12,11,Preescolar,SuperSchool,214,21,193
2025-09-12,11,Preescolar,TopKids,98,18,80
2025-09-12,11,Kínder,SuperSchool,161,9,152
2025-09-12,11,Kínder,TopKids,220,6,214
2025-09-12,11,Kínder,TopKids,249,16,233
2025-09-12,11,Kínder,SuperSchool,51,13,38
2025-09-12,11,Kínder,TopKids,137,16,121
2025-09-12,11,Kínder,TopKids,217,23,194
2025-09-12,11,Kínder,EduMax,209,1,208
2025-09-12,11,Kínder,SuperSchool,67,7,60
2025-09-12,11,Kínder,SuperSchool,104,3,101
2025-09-12,11,Kínder,SuperSchool,60,16,44
2025-09-12,11,Kínder,SuperSchool,154,12,142
2025-09-12,11,Primaria 1°,SuperSchool,245,4,241
2025-09-12,11,Primaria 1°,TopKids,115,24,91
2025-09-12,11,Primaria 1°,EduMax,244,2,242
2025-09-12,11,Primaria 1°,SuperSchool,246,7,239
2025-09-12,11,Primaria 1°,TopKids,213,3,210
2025-09-12,11,Primaria 1°,EduMax,189,16,173
2025-09-12,11,Primaria 1°,TopKids,158,14,144
2025-09-12,11,Primaria 1°,TopKids,259,22,237
2025-09-12,11,Primaria 1°,SuperSchool,181,17,164
2025-09-12,11,Primaria 1°,EduMax,133,22,111
2025-09-12,11,Primaria 1°,EduMax,54,14,40
2025-09-12,11,Primaria 1°,TopKids,191,2,189
2025-09-12,11,Primaria 1°,SuperSchool,138,7,131
2025-09-12,11,Primaria 1°,EduMax,69,11,58
2025-09-12,11,Primaria 1°,EduMax,295,21,274
2025-09-12,11,Primaria 1°,TopKids,209,10,199
2025-09-12,11,Primaria 1°,EduMax,130,17,113
2025-09-12,11,Primaria 1°,SuperSchool,240,22,218
2025-09-12,11,Primaria 2°,TopKids,282,9,273
2025-09-12,11,Primaria 2°,TopKids,87,6,81
2025-09-12,11,Primaria 2°,EduMax,219,17,202
2025-09-12,11,Primaria 2°,TopKids,106,4,102
2025-09-12,11,Primaria 2°,EduMax,187,8,179
2025-09-12,11,Primaria 2°,SuperSchool,169,22,147
2025-09-12,11,Primaria 2°,SuperSchool,61,12,49
2025-09-12,11,Primaria 2°,SuperSchool,254,14,240
2025-09-12,11,Primaria 3°,EduMax,280,17,263
2025-09-12,11,Primaria 3°,TopKids,274,8,266
2025-09-12,11,Primaria 3°,SuperSchool,139,24,115
2025-09-12,11,Primaria 3°,SuperSchool,137,24,113
2025-09-12,11,Primaria 3°,TopKids,107,16,91
2025-09-12,11,Primaria 3°,EduMax,238,16,222
2025-09-12,11,Primaria 3°,EduMax,205,3,202
2025-09-12,11,Primaria 3°,SuperSchool,100,24,76
2025-09-12,11,Primaria 3°,EduMax,281,16,265
2025-09-12,11,Primaria 3°,TopKids,216,2,214
2025-09-12,11,Primaria 3°,SuperSchool,150,10,140
2025-09-12,11,Primaria 3°,SuperSchool,196,6,190
2025-09-12,11,Primaria 4°,SuperSchool,130,4,126
2025-09-12,11,Primaria 4°,EduMax,175,18,157
2025-09-12,11,Primaria 4°,EduMax,188,23,165
2025-09-12,11,Primaria 4°,EduMax,219,11,208
2025-09-12,11,Primaria 4°,SuperSchool,116,2,114
2025-09-12,11,Primaria 4°,EduMax,243,12,231
2025-09-12,11,Primaria 5°,SuperSchool,267,4,263
2025-09-12,11,Primaria 5°,EduMax,115,21,94
2025-09-12,11,Primaria 5°,TopKids,294,11,283
2025-09-12,11,Primaria 5°,EduMax,142,5,137
2025-09-12,11,Primaria 5°,EduMax,295,7,288
2025-09-12,11,Primaria 5°,TopKids,247,2,245
2025-09-12,11,Primaria 5°,SuperSchool,153,18,135
2025-09-12,11,Primaria 5°,EduMax,274,20,254
2025-09-12,11,Primaria 5°,EduMax,172,4,168
2025-09-12,11,Primaria 5°,EduMax,291,5,286
2025-09-12,11,Primaria 5°,TopKids,196,12,184
2025-09-12,11,Primaria 5°,EduMax,237,19,218
2025-09-12,11,Primaria 5°,TopKids,102,20,82
2025-09-12,11,Primaria 5°,SuperSchool,133,23,110
2025-09-12,11,Primaria 5°,EduMax,172,5,167
2025-09-12,11,Primaria 5°,EduMax,186,13,173
2025-09-12,11,Primaria 5°,SuperSchool,174,8,166
2025-09-12,11,Primaria 5°,EduMax,222,22,200
2025-09-12,11,Primaria 5°,TopKids,67,23,44
2025-09-12,11,Primaria 6°,TopKids,90,2,88
2025-09-12,11,Primaria 6°,SuperSchool,56,5,51
2025-09-12,11,Primaria 6°,SuperSchool,183,13,170
2025-09-12,11,Primaria 6°,EduMax,212,10,202
2025-09-12,11,Primaria 6°,TopKids,180,1,179
2025-09-12,11,Primaria 6°,EduMax,136,16,120
2025-09-12,11,Primaria 6°,SuperSchool,162,16,146
2025-09-12,11,Primaria 6°,SuperSchool,155,7,148
2025-09-12,11,Primaria 6°,TopKids,118,19,99
2025-09-12,11,Primaria 6°,TopKids,291,22,269
2025-09-12,11,Primaria 6°,EduMax,99,6,93
2025-09-12,11,Primaria 6°,SuperSchool,279,6,273
2025-09-12,11,Primaria 6°,EduMax,144,22,122
2025-09-12,12,Preescolar,TopKids,252,17,235
2025-09-12,12,Preescolar,EduMax,218,22,196
2025-09-12,12,Preescolar,EduMax,128,8,120
2025-09-12,12,Preescolar,EduMax,225,19,206
2025-09-12,12,Preescolar,TopKids,126,9,117
2025-09-12,12,Preescolar,SuperSchool,214,21,193
2025-09-12,12,Preescolar,TopKids,88,7,81
2025-09-12,12,Preescolar,TopKids,249,6,243
2025-09-12,12,Preescolar,TopKids,263,1,262
2025-09-12,12,Preescolar,EduMax,296,20,276
2025-09-12,12,Preescolar,TopKids,101,19,82
2025-09-12,12,Preescolar,SuperSchool,237,13,224
2025-09-12,12,Preescolar,TopKids,66,22,44
2025-09-12,12,Kínder,EduMax,215,11,204
2025-09-12,12,Kínder,TopKids,87,7,80
2025-09-12,12,Kínder,SuperSchool,209,22,187
2025-09-12,12,Kínder,SuperSchool,73,8,65
2025-09-12,12,Kínder,TopKids,95,22,73
2025-09-12,12,Kínder,SuperSchool,118,5,113
2025-09-12,12,Primaria 1°,TopKids,258,11,247
2025-09-12,12,Primaria 1°,EduMax,80,7,73
2025-09-12,12,Primaria 1°,SuperSchool,64,19,45
2025-09-12,12,Primaria 1°,EduMax,58,13,45
2025-09-12,12,Primaria 1°,SuperSchool,139,6,133
2025-09-12,12,Primaria 1°,EduMax,206,16,190
2025-09-12,12,Primaria 1°,SuperSchool,61,23,38
2025-09-12,12,Primaria 1°,EduMax,116,18,98
2025-09-12,12,Primaria 1°,TopKids,54,13,41
2025-09-12,12,Primaria 1°,EduMax,166,22,144
2025-09-12,12,Primaria 1°,TopKids,183,16,167
2025-09-12,12,Primaria 1°,TopKids,264,8,256
2025-09-12,12,Primaria 1°,SuperSchool,276,5,271
2025-09-12,12,Primaria 1°,TopKids,160,3,157
2025-09-12,12,Primaria 1°,TopKids,211,12,199
2025-09-12,12,Primaria 1°,TopKids,246,9,237
2025-09-12,12,Primaria 1°,EduMax,245,23,222
2025-09-12,12,Primaria 1°,EduMax,166,7,159
2025-09-12,12,Primaria 2°,EduMax,179,9,170
2025-09-12,12,Primaria 2°,TopKids,80,4,76
2025-09-12,12,Primaria 2°,SuperSchool,154,15,139
2025-09-12,12,Primaria 2°,SuperSchool,239,2,237
2025-09-12,12,Primaria 2°,SuperSchool,92,19,73
2025-09-12,12,Primaria 2°,TopKids,50,19,31
2025-09-12,12,Primaria 2°,SuperSchool,237,2,235
2025-09-12,12,Primaria 2°,SuperSchool,290,1,289
2025-09-12,12,Primaria 2°,EduMax,189,23,166
2025-09-12,12,Primaria 2°,EduMax,187,19,168
2025-09-12,12,Primaria 2°,TopKids,114,1,113
2025-09-12,12,Primaria 2°,SuperSchool,284,11,273
2025-09-12,12,Primaria 2°,SuperSchool,84,11,73
2025-09-12,12,Primaria 2°,EduMax,163,7,156
2025-09-12,12,Primaria 2°,SuperSchool,169,4,165
2025-09-12,12,Primaria 2°,EduMax,269,8,261
2025-09-12,12,Primaria 2°,TopKids,287,21,266
2025-09-12,12,Primaria 3°,TopKids,81,4,77
2025-09-12,12,Primaria 3°,SuperSchool,118,13,105
2025-09-12,12,Primaria 3°,TopKids,275,20,255
2025-09-12,12,Primaria 3°,TopKids,248,20,228
2025-09-12,12,Primaria 3°,SuperSchool,234,9,225
2025-09-12,12,Primaria 3°,TopKids,298,20,278
2025-09-12,12,Primaria 3°,SuperSchool,205,2,203
2025-09-12,12,Primaria 4°,EduMax,164,18,146
2025-09-12,12,Primaria 4°,SuperSchool,252,23,229
2025-09-12,12,Primaria 4°,EduMax,158,21,137
2025-09-12,12,Primaria 4°,EduMax,131,18,113
2025-09-12,12,Primaria 4°,SuperSchool,97,6,91
2025-09-12,12,Primaria 4°,EduMax,273,5,268
2025-09-12,12,Primaria 4°,TopKids,222,16,206
2025-09-12,12,Primaria 4°,SuperSchool,236,24,212
2025-09-12,12,Primaria 4°,SuperSchool,156,15,141
2025-09-12,12,Primaria 5°,TopKids,110,4,106
2025-09-12,12,Primaria 5°,TopKids,255,23,232
2025-09-12,12,Primaria 5°,TopKids,69,6,63
2025-09-12,12,Primaria 5°,TopKids,149,12,137
2025-09-12,12,Primaria 5°,EduMax,204,18,186
2025-09-12,12,Primaria 5°,EduMax,89,8,81
2025-09-12,12,Primaria 5°,SuperSchool,78,1,77
2025-09-12,12,Primaria 6°,SuperSchool,123,1,122
2025-09-12,12,Primaria 6°,EduMax,92,21,71
2025-09-12,12,Primaria 6°,SuperSchool,283,6,277
2025-09-12,12,Primaria 6°,TopKids,149,13,136
2025-09-12,12,Primaria 6°,TopKids,92,5,87
2025-09-12,12,Primaria 6°,EduMax,74,2,72
2025-09-12,12,Primaria 6°,TopKids,142,3,139
2025-09-12,12,Primaria 6°,TopKids,154,19,135
2025-09-12,13,Preescolar,SuperSchool,87,22,65
2025-09-12,13,Preescolar,EduMax,50,22,28
2025-09-12,13,Preescolar,SuperSchool,145,22,123
2025-09-12,13,Preescolar,SuperSchool,235,22,213
2025-09-12,13,Preescolar,TopKids,276,6,270
2025-09-12,13,Preescolar,EduMax,256,12,244
2025-09-12,13,Preescolar,SuperSchool,283,19,264
2025-09-12,13,Preescolar,SuperSchool,158,3,155
2025-09-12,13,Preescolar,EduMax,229,5,224
2025-09-12,13,Preescolar,EduMax,286,14,272
2025-09-12,13,Preescolar,EduMax,111,15,96
2025-09-12,13,Preescolar,EduMax,270,14,256
2025-09-12,13,Preescolar,TopKids,244,22,222
2025-09-12,13,Preescolar,SuperSchool,136,24,112
2025-09-12,13,Kínder,TopKids,66,15,51
2025-09-12,13,Kínder,SuperSchool,233,15,218
2025-09-12,13,Kínder,EduMax,180,17,163
2025-09-12,13,Kínder,EduMax,50,24,26
2025-09-12,13,Kínder,EduMax,116,20,96
2025-09-12,13,Kínder,EduMax,277,24,253
2025-09-12,13,Kínder,SuperSchool,230,1,229
2025-09-12,13,Kínder,EduMax,222,15,207
2025-09-12,13,Kínder,EduMax,97,6,91
2025-09-12,13,Kínder,EduMax,257,11,246
2025-09-12,13,Kínder,TopKids,122,1,121
2025-09-12,13,Primaria 1°,SuperSchool,173,8,165
2025-09-12,13,Primaria 1°,TopKids,246,6,240
2025-09-12,13,Primaria 1°,TopKids,88,7,81
2025-09-12,13,Primaria 1°,SuperSchool,169,19,150
2025-09-12,13,Primaria 1°,SuperSchool,277,19,258
2025-09-12,13,Primaria 1°,EduMax,134,19,115
2025-09-12,13,Primaria 1°,SuperSchool,177,11,166
2025-09-12,13,Primaria 1°,SuperSchool,122,13,109
2025-09-12,13,Primaria 1°,EduMax,68,5,63
2025-09-12,13,Primaria 1°,TopKids,233,3,230
2025-09-12,13,Primaria 1°,SuperSchool,94,14,80
2025-09-12,13,Primaria 1°,SuperSchool,83,2,81
2025-09-12,13,Primaria 1°,EduMax,109,6,103
2025-09-12,13,Primaria 1°,TopKids,91,21,70
2025-09-12,13,Primaria 2°,SuperSchool,115,6,109
2025-09-12,13,Primaria 2°,EduMax,238,8,230
2025-09-12,13,Primaria 2°,EduMax,136,20,116
2025-09-12,13,Primaria 2°,TopKids,271,24,247
2025-09-12,13,Primaria 2°,SuperSchool,297,20,277
2025-09-12,13,Primaria 2°,SuperSchool,279,9,270
2025-09-12,13,Primaria 2°,SuperSchool,182,14,168
2025-09-12,13,Primaria 2°,EduMax,291,7,284
2025-09-12,13,Primaria 2°,EduMax,108,12,96
2025-09-12,13,Primaria 2°,EduMax,100,16,84
2025-09-12,13,Primaria 2°,TopKids,273,10,263
2025-09-12,13,Primaria 2°,TopKids,117,20,97
2025-09-12,13,Primaria 3°,SuperSchool,187,8,179
2025-09-12,13,Primaria 3°,TopKids,213,13,200
2025-09-12,13,Primaria 3°,TopKids,55,6,49
2025-09-12,13,Primaria 3°,TopKids,243,9,234
2025-09-12,13,Primaria 3°,EduMax,246,2,244
2025-09-12,13,Primaria 3°,SuperSchool,127,10,117
2025-09-12,13,Primaria 4°,TopKids,290,7,283
2025-09-12,13,Primaria 4°,TopKids,126,23,103
2025-09-12,13,Primaria 4°,SuperSchool,113,17,96
2025-09-12,13,Primaria 4°,SuperSchool,157,4,153
2025-09-12,13,Primaria 4°,SuperSchool,59,2,57
2025-09-12,13,Primaria 4°,SuperSchool,112,13,99
2025-09-12,13,Primaria 4°,SuperSchool,176,12,164
2025-09-12,13,Primaria 4°,SuperSchool,123,20,103
2025-09-12,13,Primaria 4°,SuperSchool,251,7,244
2025-09-12,13,Primaria 4°,TopKids,140,18,122
2025-09-12,13,Primaria 4°,SuperSchool,141,8,133
2025-09-12,13,Primaria 4°,TopKids,180,12,168
2025-09-12,13,Primaria 4°,SuperSchool,165,18,147
2025-09-12,13,Primaria 4°,EduMax,198,21,177
2025-09-12,13,Primaria 4°,TopKids,148,24,124
2025-09-12,13,Primaria 4°,TopKids,66,16,50
2025-09-12,13,Primaria 4°,EduMax,82,22,60
2025-09-12,13,Primaria 4°,TopKids,117,17,100
2025-09-12,13,Primaria 4°,TopKids,266,5,261
2025-09-12,13,Primaria 5°,SuperSchool,214,8,206
2025-09-12,13,Primaria 5°,TopKids,218,6,212
2025-09-12,13,Primaria 5°,SuperSchool,153,20,133
2025-09-12,13,Primaria 5°,SuperSchool,117,7,110
2025-09-12,13,Primaria 5°,EduMax,274,9,265
2025-09-12,13,Primaria 5°,SuperSchool,54,10,44
2025-09-12,13,Primaria 5°,TopKids,163,5,158
2025-09-12,13,Primaria 5°,EduMax,201,21,180
2025-09-12,13,Primaria 5°,EduMax,292,16,276
2025-09-12,13,Primaria 5°,EduMax,192,9,183
2025-09-12,13,Primaria 5°,TopKids,226,2,224
2025-09-12,13,Primaria 6°,SuperSchool,247,1,246
2025-09-12,13,Primaria 6°,TopKids,229,23,206
2025-09-12,13,Primaria 6°,EduMax,272,15,257
2025-09-12,13,Primaria 6°,SuperSchool,241,2,239
2025-09-12,13,Primaria 6°,TopKids,130,3,127
2025-09-12,13,Primaria 6°,TopKids,281,11,270
2025-09-12,13,Primaria 6°,EduMax,97,14,83
2025-09-12,13,Primaria 6°,TopKids,132,23,109
2025-09-12,13,Primaria 6°,EduMax,273,12,261
2025-09-12,13,Primaria 6°,TopKids,193,11,182
2025-09-12,14,Preescolar,TopKids,91,5,86
2025-09-12,14,Preescolar,TopKids,126,24,102
2025-09-12,14,Preescolar,EduMax,237,20,217
2025-09-12,14,Preescolar,TopKids,199,9,190
2025-09-12,14,Preescolar,SuperSchool,237,7,230
2025-09-12,14,Preescolar,TopKids,273,7,266
2025-09-12,14,Preescolar,SuperSchool,179,8,171
2025-09-12,14,Kínder,TopKids,236,1,235
2025-09-12,14,Kínder,EduMax,215,18,197
2025-09-12,14,Kínder,EduMax,254,21,233
2025-09-12,14,Kínder,SuperSchool,72,1,71
2025-09-12,14,Kínder,SuperSchool,54,3,51
2025-09-12,14,Kínder,EduMax,215,4,211
2025-09-12,14,Primaria 1°,SuperSchool,203,4,199
2025-09-12,14,Primaria 1°,EduMax,163,18,145
2025-09-12,14,Primaria 1°,SuperSchool,299,10,289
2025-09-12,14,Primaria 1°,SuperSchool,293,22,271
2025-09-12,14,Primaria 1°,EduMax,271,7,264
2025-09-12,14,Primaria 1°,TopKids,217,6,211
2025-09-12,14,Primaria 1°,EduMax,167,8,159
2025-09-12,14,Primaria 1°,EduMax,176,17,159
2025-09-12,14,Primaria 1°,TopKids,167,12,155
2025-09-12,14,Primaria 1°,TopKids,226,16,210
2025-09-12,14,Primaria 1°,EduMax,251,20,231
2025-09-12,14,Primaria 1°,TopKids,68,4,64
2025-09-12,14,Primaria 1°,TopKids,282,20,262
2025-09-12,14,Primaria 1°,SuperSchool,53,17,36
2025-09-12,14,Primaria 1°,EduMax,203,3,200
2025-09-12,14,Primaria 1°,EduMax,177,4,173
2025-09-12,14,Primaria 1°,SuperSchool,247,19,228
2025-09-12,14,Primaria 1°,TopKids,268,16,252
2025-09-12,14,Primaria 1°,TopKids,129,14,115
2025-09-12,14,Primaria 2°,TopKids,147,7,140
2025-09-12,14,Primaria 2°,TopKids,183,20,163
2025-09-12,14,Primaria 2°,SuperSchool,58,17,41
2025-09-12,14,Primaria 2°,SuperSchool,188,16,172
2025-09-12,14,Primaria 2°,EduMax,114,16,98
2025-09-12,14,Primaria 2°,SuperSchool,247,22,225
2025-09-12,14,Primaria 2°,TopKids,56,16,40
2025-09-12,14,Primaria 2°,EduMax,110,22,88
2025-09-12,14,Primaria 3°,SuperSchool,94,15,79
2025-09-12,14,Primaria 3°,TopKids,186,18,168
2025-09-12,14,Primaria 3°,EduMax,296,14,282
2025-09-12,14,Primaria 3°,EduMax,91,11,80
2025-09-12,14,Primaria 3°,EduMax,82,14,68
2025-09-12,14,Primaria 3°,EduMax,220,14,206
2025-09-12,14,Primaria 4°,SuperSchool,263,7,256
2025-09-12,14,Primaria 4°,SuperSchool,132,22,110
2025-09-12,14,Primaria 4°,TopKids,155,22,133
2025-09-12,14,Primaria 4°,SuperSchool,227,17,210
2025-09-12,14,Primaria 4°,EduMax,94,4,90
2025-09-12,14,Primaria 4°,SuperSchool,203,7,196
2025-09-12,14,Primaria 4°,SuperSchool,119,1,118
2025-09-12,14,Primaria 4°,SuperSchool,245,19,226
2025-09-12,14,Primaria 4°,EduMax,153,6,147
2025-09-12,14,Primaria 4°,SuperSchool,237,20,217
2025-09-12,14,Primaria 4°,TopKids,128,6,122
2025-09-12,14,Primaria 5°,SuperSchool,228,10,218
2025-09-12,14,Primaria 5°,SuperSchool,223,22,201
2025-09-12,14,Primaria 5°,SuperSchool,172,7,165
2025-09-12,14,Primaria 5°,SuperSchool,264,17,247
2025-09-12,14,Primaria 5°,SuperSchool,167,23,144
2025-09-12,14,Primaria 5°,TopKids,210,2,208
2025-09-12,14,Primaria 5°,EduMax,132,8,124
2025-09-12,14,Primaria 5°,SuperSchool,192,11,181
2025-09-12,14,Primaria 5°,EduMax,67,2,65
2025-09-12,14,Primaria 5°,EduMax,238,15,223
2025-09-12,14,Primaria 6°,TopKids,250,22,228
2025-09-12,14,Primaria 6°,SuperSchool,191,9,182
2025-09-12,14,Primaria 6°,EduMax,56,15,41
2025-09-12,14,Primaria 6°,TopKids,83,3,80
2025-09-12,14,Primaria 6°,TopKids,179,13,166
2025-09-12,14,Primaria 6°,TopKids,299,13,286
2025-09-12,14,Primaria 6°,TopKids,179,20,159
2025-09-12,14,Primaria 6°,EduMax,100,9,91
2025-09-12,14,Primaria 6°,SuperSchool,134,7,127
2025-09-12,14,Primaria 6°,SuperSchool,286,1,285
2025-09-12,14,Primaria 6°,SuperSchool,243,3,240
2025-09-12,14,Primaria 6°,SuperSchool,171,12,159
2025-09-12,14,Primaria 6°,SuperSchool,110,21,89
2025-09-12,14,Primaria 6°,SuperSchool,127,14,113
2025-09-12,15,Preescolar,EduMax,251,5,246
2025-09-12,15,Preescolar,TopKids,131,17,114
2025-09-12,15,Preescolar,EduMax,124,15,109
2025-09-12,15,Preescolar,TopKids,285,16,269
2025-09-12,15,Preescolar,TopKids,169,12,157
2025-09-12,15,Preescolar,EduMax,103,19,84
2025-09-12,15,Preescolar,SuperSchool,116,13,103
2025-09-12,15,Preescolar,SuperSchool,71,15,56
2025-09-12,15,Preescolar,TopKids,78,17,61
2025-09-12,15,Preescolar,TopKids,74,23,51
2025-09-12,15,Preescolar,TopKids,125,17,108
2025-09-12,15,Preescolar,EduMax,200,5,195
2025-09-12,15,Preescolar,SuperSchool,54,7,47
2025-09-12,15,Preescolar,TopKids,212,17,195
2025-09-12,15,Kínder,EduMax,64,19,45
2025-09-12,15,Kínder,TopKids,283,11,272
2025-09-12,15,Kínder,SuperSchool,255,24,231
2025-09-12,15,Kínder,TopKids,187,1,186
2025-09-12,15,Kínder,SuperSchool,159,8,151
2025-09-12,15,Kínder,EduMax,120,18,102
2025-09-12,15,Kínder,SuperSchool,139,23,116
2025-09-12,15,Kínder,TopKids,282,15,267
2025-09-12,15,Kínder,SuperSchool,188,19,169
2025-09-12,15,Kínder,EduMax,259,22,237
2025-09-12,15,Kínder,EduMax,277,18,259
2025-09-12,15,Kínder,EduMax,71,22,49
2025-09-12,15,Kínder,TopKids,58,18,40
2025-09-12,15,Kínder,EduMax,168,19,149
2025-09-12,15,Kínder,TopKids,74,15,59
2025-09-12,15,Kínder,SuperSchool,124,13,111
2025-09-12,15,Kínder,EduMax,121,11,110
2025-09-12,15,Kínder,EduMax,299,10,289
2025-09-12,15,Primaria 1°,SuperSchool,66,17,49
2025-09-12,15,Primaria 1°,SuperSchool,264,3,261
2025-09-12,15,Primaria 1°,TopKids,150,10,140
2025-09-12,15,Primaria 1°,TopKids,233,7,226
2025-09-12,15,Primaria 1°,SuperSchool,78,17,61
2025-09-12,15,Primaria 2°,EduMax,58,8,50
2025-09-12,15,Primaria 2°,SuperSchool,127,22,105
2025-09-12,15,Primaria 2°,EduMax,186,20,166
2025-09-12,15,Primaria 2°,SuperSchool,124,11,113
2025-09-12,15,Primaria 2°,TopKids,124,4,120
2025-09-12,15,Primaria 2°,TopKids,180,13,167
2025-09-12,15,Primaria 2°,TopKids,249,21,228
2025-09-12,15,Primaria 2°,SuperSchool,297,22,275
2025-09-12,15,Primaria 2°,SuperSchool,114,21,93
2025-09-12,15,Primaria 2°,EduMax,90,6,84
2025-09-12,15,Primaria 2°,TopKids,78,10,68
2025-09-12,15,Primaria 3°,SuperSchool,278,2,276
2025-09-12,15,Primaria 3°,SuperSchool,108,24,84
2025-09-12,15,Primaria 3°,EduMax,108,3,105
2025-09-12,15,Primaria 3°,SuperSchool,98,24,74
2025-09-12,15,Primaria 3°,EduMax,297,2,295
2025-09-12,15,Primaria 3°,TopKids,68,20,48
2025-09-12,15,Primaria 3°,TopKids,145,17,128
2025-09-12,15,Primaria 4°,EduMax,98,13,85
2025-09-12,15,Primaria 4°,TopKids,299,11,288
2025-09-12,15,Primaria 4°,EduMax,181,18,163
2025-09-12,15,Primaria 4°,SuperSchool,288,24,264
2025-09-12,15,Primaria 4°,TopKids,104,15,89
2025-09-12,15,Primaria 4°,TopKids,164,21,143
2025-09-12,15,Primaria 4°,EduMax,98,10,88
2025-09-12,15,Primaria 4°,TopKids,255,4,251
2025-09-12,15,Primaria 4°,SuperSchool,221,7,214
2025-09-12,15,Primaria 4°,SuperSchool,210,21,189
2025-09-12,15,Primaria 4°,EduMax,217,18,199
2025-09-12,15,Primaria 4°,SuperSchool,162,2,160
2025-09-12,15,Primaria 4°,EduMax,206,21,185
2025-09-12,15,Primaria 4°,TopKids,54,20,34
2025-09-12,15,Primaria 4°,SuperSchool,188,8,180
2025-09-12,15,Primaria 4°,SuperSchool,218,18,200
2025-09-12,15,Primaria 5°,EduMax,105,9,96
2025-09-12,15,Primaria 5°,EduMax,297,20,277
2025-09-12,15,Primaria 5°,TopKids,243,3,240
2025-09-12,15,Primaria 5°,SuperSchool,177,24,153
2025-09-12,15,Primaria 5°,SuperSchool,76,4,72
2025-09-12,15,Primaria 5°,TopKids,140,19,121
2025-09-12,15,Primaria 5°,EduMax,176,7,169
2025-09-12,15,Primaria 5°,TopKids,143,12,131
2025-09-12,15,Primaria 5°,SuperSchool,246,24,222
2025-09-12,15,Primaria 5°,SuperSchool,241,9,232
2025-09-12,15,Primaria 5°,EduMax,214,2,212
2025-09-12,15,Primaria 5°,EduMax,99,6,93
2025-09-12,15,Primaria 5°,EduMax,252,10,242
2025-09-12,15,Primaria 5°,SuperSchool,83,21,62
2025-09-12,15,Primaria 5°,EduMax,54,12,42
2025-09-12,15,Primaria 5°,TopKids,198,2,196
2025-09-12,15,Primaria 5°,SuperSchool,151,15,136
2025-09-12,15,Primaria 5°,TopKids,67,17,50
2025-09-12,15,Primaria 6°,SuperSchool,252,4,248
2025-09-12,15,Primaria 6°,EduMax,56,8,48
2025-09-12,15,Primaria 6°,EduMax,207,17,190
2025-09-12,15,Primaria 6°,EduMax,194,3,191
2025-09-12,15,Primaria 6°,EduMax,157,5,152
2025-09-12,15,Primaria 6°,SuperSchool,124,16,108
2025-09-12,15,Primaria 6°,EduMax,91,24,67
2025-09-12,15,Primaria 6°,EduMax,69,20,49
2025-09-12,15,Primaria 6°,TopKids,244,24,220
2025-09-12,15,Primaria 6°,EduMax,202,18,184
2025-09-12,15,Primaria 6°,EduMax,222,14,208
2025-09-12,15,Primaria 6°,SuperSchool,261,15,246
2025-09-12,15,Primaria 6°,SuperSchool,253,16,237
2025-09-12,15,Primaria 6°,TopKids,287,9,278
2025-09-12,15,Primaria 6°,SuperSchool,219,9,210
2025-09-12,15,Primaria 6°,SuperSchool,271,16,255
2025-09-12,15,Primaria 6°,TopKids,281,2,279
2025-09-12,16,Preescolar,EduMax,73,18,55
2025-09-12,16,Preescolar,TopKids,221,24,197
2025-09-12,16,Preescolar,TopKids,83,6,77
2025-09-12,16,Preescolar,EduMax,226,16,210
2025-09-12,16,Preescolar,TopKids,269,13,256
2025-09-12,16,Preescolar,TopKids,96,17,79
2025-09-12,16,Preescolar,SuperSchool,263,24,239
2025-09-12,16,Preescolar,TopKids,268,8,260
2025-09-12,16,Preescolar,EduMax,120,11,109
2025-09-12,16,Preescolar,SuperSchool,110,22,88
2025-09-12,16,Preescolar,TopKids,87,20,67
2025-09-12,16,Preescolar,SuperSchool,260,19,241
2025-09-12,16,Preescolar,EduMax,96,17,79
2025-09-12,16,Kínder,SuperSchool,69,12,57
2025-09-12,16,Kínder,EduMax,90,8,82
2025-09-12,16,Kínder,EduMax,89,11,78
2025-09-12,16,Kínder,TopKids,207,12,195
2025-09-12,16,Kínder,EduMax,111,23,88
2025-09-12,16,Kínder,EduMax,148,15,133
2025-09-12,16,Primaria 1°,EduMax,269,7,262
2025-09-12,16,Primaria 1°,EduMax,76,2,74
2025-09-12,16,Primaria 1°,EduMax,110,2,108
2025-09-12,16,Primaria 1°,SuperSchool,192,10,182
2025-09-12,16,Primaria 1°,EduMax,59,5,54
2025-09-12,16,Primaria 1°,SuperSchool,192,9,183
2025-09-12,16,Primaria 1°,SuperSchool,132,14,118
2025-09-12,16,Primaria 1°,EduMax,221,12,209
2025-09-12,16,Primaria 1°,TopKids,174,19,155
2025-09-12,16,Primaria 1°,TopKids,235,5,230
2025-09-12,16,Primaria 1°,EduMax,55,19,36
2025-09-12,16,Primaria 1°,EduMax,225,12,213
2025-09-12,16,Primaria 1°,EduMax,263,13,250
2025-09-12,16,Primaria 1°,SuperSchool,163,4,159
2025-09-12,16,Primaria 1°,TopKids,108,18,90
2025-09-12,16,Primaria 1°,SuperSchool,80,3,77
2025-09-12,16,Primaria 2°,SuperSchool,158,15,143
2025-09-12,16,Primaria 2°,EduMax,236,21,215
2025-09-12,16,Primaria 2°,SuperSchool,161,16,145
2025-09-12,16,Primaria 2°,SuperSchool,54,10,44
2025-09-12,16,Primaria 2°,TopKids,202,24,178
2025-09-12,16,Primaria 2°,SuperSchool,110,3,107
2025-09-12,16,Primaria 2°,SuperSchool,269,3,266
2025-09-12,16,Primaria 2°,EduMax,145,17,128
2025-09-12,16,Primaria 3°,TopKids,227,13,214
2025-09-12,16,Primaria 3°,EduMax,161,4,157
2025-09-12,16,Primaria 3°,EduMax,259,14,245
2025-09-12,16,Primaria 3°,EduMax,156,17,139
2025-09-12,16,Primaria 3°,TopKids,73,3,70
2025-09-12,16,Primaria 3°,SuperSchool,85,19,66
2025-09-12,16,Primaria 3°,SuperSchool,234,22,212
2025-09-12,16,Primaria 3°,SuperSchool,252,12,240
2025-09-12,16,Primaria 3°,SuperSchool,192,12,180
2025-09-12,16,Primaria 3°,EduMax,152,24,128
2025-09-12,16,Primaria 3°,TopKids,155,16,139
2025-09-12,16,Primaria 3°,SuperSchool,166,11,155
2025-09-12,16,Primaria 3°,SuperSchool,127,18,109
2025-09-12,16,Primaria 3°,TopKids,156,15,141
2025-09-12,16,Primaria 3°,TopKids,289,22,267
2025-09-12,16,Primaria 3°,TopKids,130,14,116
2025-09-12,16,Primaria 3°,EduMax,204,22,182
2025-09-12,16,Primaria 3°,TopKids,137,8,129
2025-09-12,16,Primaria 4°,TopKids,117,4,113
2025-09-12,16,Primaria 4°,TopKids,275,13,262
2025-09-12,16,Primaria 4°,EduMax,217,9,208
2025-09-12,16,Primaria 4°,SuperSchool,242,1,241
2025-09-12,16,Primaria 4°,SuperSchool,124,16,108
2025-09-12,16,Primaria 4°,SuperSchool,277,15,262
2025-09-12,16,Primaria 4°,TopKids,280,2,278
2025-09-12,16,Primaria 4°,EduMax,226,11,215
2025-09-12,16,Primaria 4°,EduMax,72,22,50
2025-09-12,16,Primaria 4°,TopKids,91,4,87
2025-09-12,16,Primaria 4°,SuperSchool,222,1,221
2025-09-12,16,Primaria 4°,TopKids,250,1,249
2025-09-12,16,Primaria 4°,EduMax,227,16,211
2025-09-12,16,Primaria 4°,EduMax,97,5,92
2025-09-12,16,Primaria 4°,EduMax,135,1,134
2025-09-12,16,Primaria 4°,EduMax,140,6,134
2025-09-12,16,Primaria 4°,TopKids,221,18,203
2025-09-12,16,Primaria 5°,TopKids,154,16,138
2025-09-12,16,Primaria 5°,TopKids,234,2,232
2025-09-12,16,Primaria 5°,SuperSchool,142,23,119
2025-09-12,16,Primaria 5°,SuperSchool,190,19,171
2025-09-12,16,Primaria 5°,SuperSchool,270,16,254
2025-09-12,16,Primaria 5°,TopKids,208,13,195
2025-09-12,16,Primaria 5°,EduMax,112,16,96
2025-09-12,16,Primaria 5°,TopKids,266,14,252
2025-09-12,16,Primaria 5°,EduMax,134,19,115
2025-09-12,16,Primaria 5°,SuperSchool,51,19,32
2025-09-12,16,Primaria 6°,EduMax,211,18,193
2025-09-12,16,Primaria 6°,EduMax,100,19,81
2025-09-12,16,Primaria 6°,TopKids,262,19,243
2025-09-12,16,Primaria 6°,EduMax,203,3,200
2025-09-12,16,Primaria 6°,TopKids,153,4,149
2025-09-12,16,Primaria 6°,SuperSchool,52,5,47
2025-09-12,16,Primaria 6°,TopKids,206,23,183
2025-09-12,16,Primaria 6°,TopKids,164,17,147
2025-09-15,9,Preescolar,SuperSchool,244,10,234
2025-09-15,9,Preescolar,SuperSchool,282,20,262
2025-09-15,9,Preescolar,EduMax,120,12,108
2025-09-15,9,Preescolar,TopKids,199,15,184
2025-09-15,9,Preescolar,EduMax,56,15,41
2025-09-15,9,Preescolar,EduMax,205,11,194
2025-09-15,9,Kínder,TopKids,52,12,40
2025-09-15,9,Kínder,SuperSchool,152,12,140
2025-09-15,9,Kínder,EduMax,211,1,210
2025-09-15,9,Kínder,EduMax,138,19,119
2025-09-15,9,Kínder,SuperSchool,240,6,234
2025-09-15,9,Kínder,SuperSchool,117,14,103
2025-09-15,9,Kínder,EduMax,273,16,257
2025-09-15,9,Kínder,SuperSchool,179,9,170
2025-09-15,9,Kínder,SuperSchool,262,14,248
2025-09-15,9,Kínder,EduMax,214,2,212
2025-09-15,9,Kínder,SuperSchool,151,2,149
2025-09-15,9,Kínder,SuperSchool,225,22,203
2025-09-15,9,Kínder,SuperSchool,202,14,188
2025-09-15,9,Kínder,EduMax,58,5,53
2025-09-15,9,Primaria 1°,EduMax,256,17,239
2025-09-15,9,Primaria 1°,TopKids,57,4,53
2025-09-15,9,Primaria 1°,TopKids,292,14,278
2025-09-15,9,Primaria 1°,EduMax,112,21,91
2025-09-15,9,Primaria 1°,EduMax,268,9,259
2025-09-15,9,Primaria 1°,EduMax,76,13,63
2025-09-15,9,Primaria 1°,TopKids,117,16,101
2025-09-15,9,Primaria 1°,SuperSchool,289,17,272
2025-09-15,9,Primaria 1°,TopKids,51,9,42
2025-09-15,9,Primaria 1°,TopKids,285,13,272
2025-09-15,9,Primaria 1°,EduMax,125,3,122
2025-09-15,9,Primaria 1°,EduMax,262,16,246
2025-09-15,9,Primaria 1°,EduMax,298,3,295
2025-09-15,9,Primaria 1°,EduMax,122,15,107
2025-09-15,9,Primaria 1°,EduMax,230,22,208
2025-09-15,9,Primaria 1°,TopKids,144,5,139
2025-09-15,9,Primaria 1°,EduMax,191,19,172
2025-09-15,9,Primaria 1°,EduMax,131,7,124
2025-09-15,9,Primaria 1°,SuperSchool,52,13,39
2025-09-15,9,Primaria 2°,SuperSchool,138,6,132
2025-09-15,9,Primaria 2°,TopKids,109,9,100
2025-09-15,9,Primaria 2°,EduMax,122,22,100
2025-09-15,9,Primaria 2°,SuperSchool,172,19,153
2025-09-15,9,Primaria 2°,SuperSchool,53,1,52
2025-09-15,9,Primaria 2°,SuperSchool,257,12,245
2025-09-15,9,Primaria 2°,SuperSchool,239,15,224
2025-09-15,9,Primaria 2°,EduMax,273,5,268
2025-09-15,9,Primaria 3°,SuperSchool,162,8,154
2025-09-15,9,Primaria 3°,EduMax,241,8,233
2025-09-15,9,Primaria 3°,TopKids,239,22,217
2025-09-15,9,Primaria 3°,EduMax,235,15,220
2025-09-15,9,Primaria 3°,TopKids,189,16,173
2025-09-15,9,Primaria 3°,EduMax,273,3,270
2025-09-15,9,Primaria 3°,SuperSchool,149,15,134
2025-09-15,9,Primaria 3°,EduMax,50,20,30
2025-09-15,9,Primaria 3°,SuperSchool,226,22,204
2025-09-15,9,Primaria 3°,EduMax,210,2,208
2025-09-15,9,Primaria 3°,TopKids,129,14,115
2025-09-15,9,Primaria 4°,TopKids,296,20,276
2025-09-15,9,Primaria 4°,SuperSchool,227,9,218
2025-09-15,9,Primaria 4°,TopKids,241,14,227
2025-09-15,9,Primaria 4°,EduMax,158,14,144
2025-09-15,9,Primaria 4°,EduMax,100,17,83
2025-09-15,9,Primaria 4°,TopKids,217,4,213
2025-09-15,9,Primaria 4°,SuperSchool,233,11,222
2025-09-15,9,Primaria 4°,TopKids,192,18,174
2025-09-15,9,Primaria 5°,SuperSchool,271,5,266
2025-09-15,9,Primaria 5°,SuperSchool,189,17,172
2025-09-15,9,Primaria 5°,SuperSchool,128,21,107
2025-09-15,9,Primaria 5°,EduMax,260,24,236
2025-09-15,9,Primaria 5°,TopKids,294,12,282
2025-09-15,9,Primaria 5°,SuperSchool,88,11,77
2025-09-15,9,Primaria 5°,SuperSchool,98,22,76
2025-09-15,9,Primaria 5°,TopKids,211,11,200
2025-09-15,9,Primaria 6°,TopKids,56,5,51
2025-09-15,9,Primaria 6°,EduMax,119,4,115
2025-09-15,9,Primaria 6°,TopKids,279,22,257
2025-09-15,9,Primaria 6°,SuperSchool,236,5,231
2025-09-15,9,Primaria 6°,EduMax,60,23,37
2025-09-15,9,Primaria 6°,TopKids,57,20,37
2025-09-15,9,Primaria 6°,TopKids,108,19,89
2025-09-15,9,Primaria 6°,TopKids,174,2,172
2025-09-15,9,Primaria 6°,EduMax,280,12,268
2025-09-15,9,Primaria 6°,EduMax,115,7,108
2025-09-15,9,Primaria 6°,TopKids,144,1,143
2025-09-15,9,Primaria 6°,TopKids,281,8,273
2025-09-15,9,Primaria 6°,EduMax,62,10,52
2025-09-15,9,Primaria 6°,SuperSchool,108,6,102
2025-09-15,9,Primaria 6°,SuperSchool,63,24,39
2025-09-15,9,Primaria 6°,TopKids,246,6,240
2025-09-15,9,Primaria 6°,SuperSchool,276,9,267
2025-09-15,9,Primaria 6°,SuperSchool,155,1,154
2025-09-15,9,Primaria 6°,TopKids,197,6,191
2025-09-15,10,Preescolar,TopKids,281,21,260
2025-09-15,10,Preescolar,SuperSchool,61,6,55
2025-09-15,10,Preescolar,TopKids,296,15,281
2025-09-15,10,Preescolar,SuperSchool,134,4,130
2025-09-15,10,Preescolar,SuperSchool,223,7,216
2025-09-15,10,Preescolar,TopKids,158,22,136
2025-09-15,10,Preescolar,EduMax,131,2,129
2025-09-15,10,Preescolar,EduMax,253,13,240
2025-09-15,10,Preescolar,SuperSchool,166,7,159
2025-09-15,10,Preescolar,EduMax,71,11,60
2025-09-15,10,Preescolar,EduMax,219,22,197
2025-09-15,10,Preescolar,EduMax,159,20,139
2025-09-15,10,Preescolar,SuperSchool,261,6,255
2025-09-15,10,Preescolar,SuperSchool,206,5,201
2025-09-15,10,Preescolar,SuperSchool,228,13,215
2025-09-15,10,Preescolar,TopKids,264,5,259
2025-09-15,10,Preescolar,EduMax,147,5,142
2025-09-15,10,Kínder,TopKids,203,12,191
2025-09-15,10,Kínder,TopKids,52,9,43
2025-09-15,10,Kínder,TopKids,128,8,120
2025-09-15,10,Kínder,TopKids,267,16,251
2025-09-15,10,Kínder,SuperSchool,83,20,63
2025-09-15,10,Kínder,SuperSchool,265,4,261
2025-09-15,10,Kínder,TopKids,239,6,233
2025-09-15,10,Kínder,TopKids,281,2,279
2025-09-15,10,Kínder,SuperSchool,162,12,150
2025-09-15,10,Kínder,SuperSchool,93,15,78
2025-09-15,10,Kínder,EduMax,154,21,133
2025-09-15,10,Primaria 1°,EduMax,180,17,163
2025-09-15,10,Primaria 1°,SuperSchool,297,23,274
2025-09-15,10,Primaria 1°,TopKids,127,8,119
2025-09-15,10,Primaria 1°,SuperSchool,51,21,30
2025-09-15,10,Primaria 1°,EduMax,174,24,150
2025-09-15,10,Primaria 1°,TopKids,293,10,283
2025-09-15,10,Primaria 1°,TopKids,242,23,219
2025-09-15,10,Primaria 1°,EduMax,123,19,104
2025-09-15,10,Primaria 1°,SuperSchool,105,22,83
2025-09-15,10,Primaria 2°,SuperSchool,107,9,98
2025-09-15,10,Primaria 2°,SuperSchool,80,13,67
2025-09-15,10,Primaria 2°,EduMax,204,6,198
2025-09-15,10,Primaria 2°,TopKids,208,9,199
2025-09-15,10,Primaria 2°,SuperSchool,213,2,211
2025-09-15,10,Primaria 2°,EduMax,297,21,276
2025-09-15,10,Primaria 2°,EduMax,135,13,122
2025-09-15,10,Primaria 2°,TopKids,210,6,204
2025-09-15,10,Primaria 2°,TopKids,153,17,136
2025-09-15,10,Primaria 2°,TopKids,215,19,196
2025-09-15,10,Primaria 2°,TopKids,64,6,58
2025-09-15,10,Primaria 2°,SuperSchool,110,22,88
2025-09-15,10,Primaria 3°,EduMax,59,4,55
2025-09-15,10,Primaria 3°,SuperSchool,227,10,217
2025-09-15,10,Primaria 3°,EduMax,283,7,276
2025-09-15,10,Primaria 3°,EduMax,266,8,258
2025-09-15,10,Primaria 3°,EduMax,282,24,258
2025-09-15,10,Primaria 3°,SuperSchool,298,21,277
2025-09-15,10,Primaria 3°,SuperSchool,86,20,66
2025-09-15,10,Primaria 3°,EduMax,53,11,42
2025-09-15,10,Primaria 3°,TopKids,294,22,272
2025-09-15,10,Primaria 3°,TopKids,191,13,178
2025-09-15,10,Primaria 3°,EduMax,240,23,217
2025-09-15,10,Primaria 4°,TopKids,197,5,192
2025-09-15,10,Primaria 4°,TopKids,132,21,111
2025-09-15,10,Primaria 4°,EduMax,118,14,104
2025-09-15,10,Primaria 4°,EduMax,54,24,30
2025-09-15,10,Primaria 4°,SuperSchool,206,2,204
2025-09-15,10,Primaria 4°,EduMax,83,12,71
2025-09-15,10,Primaria 4°,EduMax,181,13,168
2025-09-15,10,Primaria 4°,SuperSchool,183,3,180
2025-09-15,10,Primaria 4°,SuperSchool,240,23,217
2025-09-15,10,Primaria 4°,TopKids,139,20,119
2025-09-15,10,Primaria 4°,SuperSchool,136,4,132
2025-09-15,10,Primaria 4°,EduMax,150,8,142
2025-09-15,10,Primaria 4°,EduMax,106,5,101
2025-09-15,10,Primaria 4°,EduMax,120,13,107
2025-09-15,10,Primaria 4°,SuperSchool,152,4,148
2025-09-15,10,Primaria 4°,SuperSchool,109,3,106
2025-09-15,10,Primaria 4°,SuperSchool,260,13,247
2025-09-15,10,Primaria 5°,SuperSchool,232,9,223
2025-09-15,10,Primaria 5°,EduMax,223,10,213
2025-09-15,10,Primaria 5°,SuperSchool,136,19,117
2025-09-15,10,Primaria 5°,SuperSchool,165,15,150
2025-09-15,10,Primaria 5°,EduMax,279,7,272
2025-09-15,10,Primaria 6°,SuperSchool,229,20,209
2025-09-15,10,Primaria 6°,TopKids,275,21,254
2025-09-15,10,Primaria 6°,TopKids,52,2,50
2025-09-15,10,Primaria 6°,SuperSchool,102,12,90
2025-09-15,10,Primaria 6°,SuperSchool,53,24,29
2025-09-15,11,Preescolar,TopKids,241,13,228
2025-09-15,11,Preescolar,SuperSchool,122,16,106
2025-09-15,11,Preescolar,TopKids,142,17,125
2025-09-15,11,Preescolar,EduMax,69,10,59
2025-09-15,11,Preescolar,EduMax,136,20,116
2025-09-15,11,Preescolar,EduMax,178,21,157
2025-09-15,11,Kínder,TopKids,249,5,244
2025-09-15,11,Kínder,TopKids,169,8,161
2025-09-15,11,Kínder,SuperSchool,131,15,116
2025-09-15,11,Kínder,EduMax,94,15,79
2025-09-15,11,Kínder,EduMax,230,13,217
2025-09-15,11,Kínder,TopKids,285,12,273
2025-09-15,11,Kínder,EduMax,274,24,250
2025-09-15,11,Kínder,EduMax,100,24,76
2025-09-15,11,Kínder,SuperSchool,140,1,139
2025-09-15,11,Kínder,TopKids,74,6,68
2025-09-15,11,Kínder,SuperSchool,266,23,243
2025-09-15,11,Kínder,SuperSchool,66,21,45
2025-09-15,11,Kínder,TopKids,261,12,249
2025-09-15,11,Kínder,SuperSchool,131,22,109
2025-09-15,11,Kínder,TopKids,73,1,72
2025-09-15,11,Primaria 1°,SuperSchool,280,17,263
2025-09-15,11,Primaria 1°,SuperSchool,249,11,238
2025-09-15,11,Primaria 1°,TopKids,237,12,225
2025-09-15,11,Primaria 1°,TopKids,186,22,164
2025-09-15,11,Primaria 1°,SuperSchool,110,21,89
2025-09-15,11,Primaria 1°,SuperSchool,97,12,85
2025-09-15,11,Primaria 1°,EduMax,128,15,113
2025-09-15,11,Primaria 2°,TopKids,275,17,258
2025-09-15,11,Primaria 2°,SuperSchool,143,11,132
2025-09-15,11,Primaria 2°,TopKids,240,15,225
2025-09-15,11,Primaria 2°,EduMax,88,8,80
2025-09-15,11,Primaria 2°,EduMax,151,21,130
2025-09-15,11,Primaria 3°,EduMax,77,21,56
2025-09-15,11,Primaria 3°,SuperSchool,77,22,55
2025-09-15,11,Primaria 3°,EduMax,68,20,48
2025-09-15,11,Primaria 3°,EduMax,95,24,71
2025-09-15,11,Primaria 3°,SuperSchool,254,9,245
2025-09-15,11,Primaria 3°,SuperSchool,70,24,46
2025-09-15,11,Primaria 3°,TopKids,241,8,233
2025-09-15,11,Primaria 3°,EduMax,229,4,225
2025-09-15,11,Primaria 3°,TopKids,190,21,169
2025-09-15,11,Primaria 3°,SuperSchool,159,1,158
2025-09-15,11,Primaria 3°,EduMax,125,4,121
2025-09-15,11,Primaria 3°,EduMax,166,4,162
2025-09-15,11,Primaria 3°,SuperSchool,193,11,182
2025-09-15,11,Primaria 3°,TopKids,147,3,144
2025-09-15,11,Primaria 3°,TopKids,162,1,161
2025-09-15,11,Primaria 3°,EduMax,138,11,127
2025-09-15,11,Primaria 3°,EduMax,165,6,159
2025-09-15,11,Primaria 3°,EduMax,103,7,96
2025-09-15,11,Primaria 3°,SuperSchool,89,13,76
2025-09-15,11,Primaria 4°,SuperSchool,238,4,234
2025-09-15,11,Primaria 4°,TopKids,83,8,75
2025-09-15,11,Primaria 4°,EduMax,217,11,206
2025-09-15,11,Primaria 4°,SuperSchool,280,23,257
2025-09-15,11,Primaria 4°,EduMax,59,6,53
2025-09-15,11,Primaria 4°,SuperSchool,257,22,235
2025-09-15,11,Primaria 4°,SuperSchool,240,2,238
2025-09-15,11,Primaria 4°,TopKids,299,24,275
2025-09-15,11,Primaria 4°,TopKids,121,17,104
2025-09-15,11,Primaria 4°,TopKids,110,14,96
2025-09-15,11,Primaria 5°,EduMax,238,14,224
2025-09-15,11,Primaria 5°,SuperSchool,230,22,208
2025-09-15,11,Primaria 5°,TopKids,210,23,187
2025-09-15,11,Primaria 5°,EduMax,246,15,231
2025-09-15,11,Primaria 5°,EduMax,193,22,171
2025-09-15,11,Primaria 5°,TopKids,153,6,147
2025-09-15,11,Primaria 5°,SuperSchool,279,1,278
2025-09-15,11,Primaria 5°,EduMax,132,19,113
2025-09-15,11,Primaria 5°,SuperSchool,128,19,109
2025-09-15,11,Primaria 5°,EduMax,81,5,76
2025-09-15,11,Primaria 5°,EduMax,97,9,88
2025-09-15,11,Primaria 5°,SuperSchool,224,22,202
2025-09-15,11,Primaria 5°,SuperSchool,234,8,226
2025-09-15,11,Primaria 5°,SuperSchool,181,24,157
2025-09-15,11,Primaria 5°,EduMax,161,3,158
2025-09-15,11,Primaria 5°,SuperSchool,75,4,71
2025-09-15,11,Primaria 5°,EduMax,68,23,45
2025-09-15,11,Primaria 5°,SuperSchool,96,7,89
2025-09-15,11,Primaria 6°,TopKids,264,15,249
2025-09-15,11,Primaria 6°,SuperSchool,161,22,139
2025-09-15,11,Primaria 6°,TopKids,147,15,132
2025-09-15,11,Primaria 6°,TopKids,63,9,54
2025-09-15,11,Primaria 6°,EduMax,269,9,260
2025-09-15,11,Primaria 6°,EduMax,256,24,232
2025-09-15,11,Primaria 6°,SuperSchool,201,2,199
2025-09-15,11,Primaria 6°,SuperSchool,220,13,207
2025-09-15,11,Primaria 6°,TopKids,72,20,52
2025-09-15,11,Primaria 6°,SuperSchool,192,11,181
2025-09-15,11,Primaria 6°,TopKids,210,23,187
2025-09-15,11,Primaria 6°,EduMax,260,18,242
2025-09-15,12,Preescolar,EduMax,180,3,177
2025-09-15,12,Preescolar,TopKids,72,23,49
2025-09-15,12,Preescolar,TopKids,250,8,242
2025-09-15,12,Preescolar,EduMax,215,21,194
2025-09-15,12,Preescolar,EduMax,151,6,145
2025-09-15,12,Preescolar,SuperSchool,95,6,89
2025-09-15,12,Preescolar,SuperSchool,172,20,152
2025-09-15,12,Preescolar,TopKids,63,1,62
2025-09-15,12,Preescolar,TopKids,293,23,270
2025-09-15,12,Preescolar,TopKids,280,14,266
2025-09-15,12,Preescolar,TopKids,188,18,170
2025-09-15,12,Preescolar,EduMax,233,5,228
2025-09-15,12,Preescolar,EduMax,169,2,167
2025-09-15,12,Kínder,EduMax,137,16,121
2025-09-15,12,Kínder,SuperSchool,151,6,145
2025-09-15,12,Kínder,SuperSchool,169,23,146
2025-09-15,12,Kínder,SuperSchool,226,10,216
2025-09-15,12,Kínder,TopKids,90,7,83
2025-09-15,12,Kínder,SuperSchool,155,24,131
2025-09-15,12,Kínder,SuperSchool,138,1,137
2025-09-15,12,Kínder,TopKids,240,22,218
2025-09-15,12,Kínder,TopKids,208,23,185
2025-09-15,12,Kínder,EduMax,115,14,101
2025-09-15,12,Kínder,EduMax,222,20,202
2025-09-15,12,Kínder,EduMax,243,17,226
2025-09-15,12,Kínder,TopKids,155,23,132
2025-09-15,12,Kínder,SuperSchool,100,11,89
2025-09-15,12,Primaria 1°,SuperSchool,202,4,198
2025-09-15,12,Primaria 1°,TopKids,289,23,266
2025-09-15,12,Primaria 1°,EduMax,52,12,40
2025-09-15,12,Primaria 1°,TopKids,293,12,281
2025-09-15,12,Primaria 1°,SuperSchool,155,23,132
2025-09-15,12,Primaria 1°,TopKids,89,13,76
2025-09-15,12,Primaria 1°,EduMax,64,17,47
2025-09-15,12,Primaria 1°,TopKids,157,16,141
2025-09-15,12,Primaria 1°,SuperSchool,92,19,73
2025-09-15,12,Primaria 1°,SuperSchool,222,3,219
2025-09-15,12,Primaria 2°,TopKids,297,15,282
2025-09-15,12,Primaria 2°,EduMax,241,11,230
2025-09-15,12,Primaria 2°,TopKids,173,13,160
2025-09-15,12,Primaria 2°,EduMax,286,21,265
2025-09-15,12,Primaria 2°,TopKids,132,4,128
2025-09-15,12,Primaria 2°,TopKids,225,1,224
2025-09-15,12,Primaria 2°,SuperSchool,200,13,187
2025-09-15,12,Primaria 2°,EduMax,207,10,197
2025-09-15,12,Primaria 2°,SuperSchool,197,6,191
2025-09-15,12,Primaria 2°,TopKids,196,3,193
2025-09-15,12,Primaria 2°,EduMax,59,24,35
2025-09-15,12,Primaria 2°,SuperSchool,176,24,152
2025-09-15,12,Primaria 2°,SuperSchool,179,13,166
2025-09-15,12,Primaria 3°,SuperSchool,222,14,208
2025-09-15,12,Primaria 3°,EduMax,63,23,40
2025-09-15,12,Primaria 3°,TopKids,158,19,139
2025-09-15,12,Primaria 3°,SuperSchool,189,20,169
2025-09-15,12,Primaria 3°,EduMax,174,4,170
2025-09-15,12,Primaria 3°,SuperSchool,105,19,86
2025-09-15,12,Primaria 3°,SuperSchool,176,9,167
2025-09-15,12,Primaria 3°,TopKids,155,3,152
2025-09-15,12,Primaria 3°,EduMax,284,6,278
2025-09-15,12,Primaria 3°,EduMax,57,23,34
2025-09-15,12,Primaria 3°,EduMax,197,5,192
2025-09-15,12,Primaria 4°,EduMax,271,18,253
2025-09-15,12,Primaria 4°,TopKids,294,2,292
2025-09-15,12,Primaria 4°,EduMax,113,12,101
2025-09-15,12,Primaria 4°,TopKids,150,10,140
2025-09-15,12,Primaria 4°,SuperSchool,280,1,279
2025-09-15,12,Primaria 4°,EduMax,173,22,151
2025-09-15,12,Primaria 4°,SuperSchool,157,7,150
2025-09-15,12,Primaria 4°,TopKids,160,12,148
2025-09-15,12,Primaria 4°,EduMax,290,2,288
2025-09-15,12,Primaria 4°,SuperSchool,266,4,262
2025-09-15,12,Primaria 4°,TopKids,64,21,43
2025-09-15,12,Primaria 4°,SuperSchool,289,6,283
2025-09-15,12,Primaria 4°,SuperSchool,171,16,155
2025-09-15,12,Primaria 5°,TopKids,229,5,224
2025-09-15,12,Primaria 5°,SuperSchool,191,2,189
2025-09-15,12,Primaria 5°,EduMax,208,19,189
2025-09-15,12,Primaria 5°,TopKids,221,23,198
2025-09-15,12,Primaria 5°,EduMax,130,2,128
2025-09-15,12,Primaria 6°,SuperSchool,255,9,246
2025-09-15,12,Primaria 6°,EduMax,298,19,279
2025-09-15,12,Primaria 6°,TopKids,178,5,173
2025-09-15,12,Primaria 6°,TopKids,83,14,69
2025-09-15,12,Primaria 6°,TopKids,137,8,129
2025-09-15,12,Primaria 6°,SuperSchool,243,17,226
2025-09-15,12,Primaria 6°,EduMax,194,6,188
2025-09-15,12,Primaria 6°,EduMax,220,8,212
2025-09-15,12,Primaria 6°,SuperSchool,217,7,210
2025-09-15,12,Primaria 6°,EduMax,139,3,136
2025-09-15,12,Primaria 6°,EduMax,221,4,217
2025-09-15,12,Primaria 6°,SuperSchool,225,2,223
2025-09-15,12,Primaria 6°,TopKids,76,24,52
2025-09-15,12,Primaria 6°,SuperSchool,117,5,112
2025-09-15,12,Primaria 6°,TopKids,157,15,142
2025-09-15,13,Preescolar,SuperSchool,225,9,216
2025-09-15,13,Preescolar,TopKids,239,4,235
2025-09-15,13,Preescolar,SuperSchool,265,1,264
2025-09-15,13,Preescolar,TopKids,269,20,249
2025-09-15,13,Preescolar,SuperSchool,149,23,126
2025-09-15,13,Preescolar,SuperSchool,185,18,167
2025-09-15,13,Preescolar,SuperSchool,250,5,245
2025-09-15,13,Preescolar,EduMax,92,14,78
2025-09-15,13,Preescolar,EduMax,259,20,239
2025-09-15,13,Kínder,TopKids,118,2,116
2025-09-15,13,Kínder,SuperSchool,205,4,201
2025-09-15,13,Kínder,EduMax,271,22,249
2025-09-15,13,Kínder,EduMax,119,20,99
2025-09-15,13,Kínder,EduMax,256,1,255
2025-09-15,13,Kínder,SuperSchool,272,2,270
2025-09-15,13,Kínder,TopKids,176,21,155
2025-09-15,13,Kínder,TopKids,233,14,219
2025-09-15,13,Primaria 1°,TopKids,57,8,49
2025-09-15,13,Primaria 1°,SuperSchool,163,7,156
2025-09-15,13,Primaria 1°,EduMax,111,1,110
2025-09-15,13,Primaria 1°,SuperSchool,277,20,257
2025-09-15,13,Primaria 1°,TopKids,78,14,64
2025-09-15,13,Primaria 1°,SuperSchool,150,19,131
2025-09-15,13,Primaria 1°,EduMax,230,5,225
2025-09-15,13,Primaria 1°,TopKids,156,2,154
2025-09-15,13,Primaria 2°,EduMax,287,8,279
2025-09-15,13,Primaria 2°,SuperSchool,57,5,52
2025-09-15,13,Primaria 2°,SuperSchool,234,14,220
2025-09-15,13,Primaria 2°,SuperSchool,122,22,100
2025-09-15,13,Primaria 2°,TopKids,92,17,75
2025-09-15,13,Primaria 2°,TopKids,285,12,273
2025-09-15,13,Primaria 2°,EduMax,210,18,192
2025-09-15,13,Primaria 2°,EduMax,214,18,196
2025-09-15,13,Primaria 2°,SuperSchool,279,7,272
2025-09-15,13,Primaria 2°,TopKids,220,8,212
2025-09-15,13,Primaria 2°,EduMax,154,23,131
2025-09-15,13,Primaria 2°,SuperSchool,260,15,245
2025-09-15,13,Primaria 2°,SuperSchool,138,13,125
2025-09-15,13,Primaria 2°,SuperSchool,297,8,289
2025-09-15,13,Primaria 2°,SuperSchool,113,21,92
2025-09-15,13,Primaria 2°,SuperSchool,140,9,131
2025-09-15,13,Primaria 2°,TopKids,247,6,241
2025-09-15,13,Primaria 2°,TopKids,283,14,269
2025-09-15,13,Primaria 2°,EduMax,152,9,143
2025-09-15,13,Primaria 3°,TopKids,61,16,45
2025-09-15,13,Primaria 3°,TopKids,222,6,216
2025-09-15,13,Primaria 3°,SuperSchool,139,5,134
2025-09-15,13,Primaria 3°,TopKids,176,2,174
2025-09-15,13,Primaria 3°,TopKids,88,12,76
2025-09-15,13,Primaria 3°,SuperSchool,85,10,75
2025-09-15,13,Primaria 3°,SuperSchool,93,11,82
2025-09-15,13,Primaria 3°,SuperSchool,79,19,60
2025-09-15,13,Primaria 3°,EduMax,87,6,81
2025-09-15,13,Primaria 3°,SuperSchool,248,12,236
2025-09-15,13,Primaria 3°,SuperSchool,104,12,92
2025-09-15,13,Primaria 3°,SuperSchool,72,6,66
2025-09-15,13,Primaria 3°,EduMax,145,17,128
2025-09-15,13,Primaria 3°,SuperSchool,163,13,150
2025-09-15,13,Primaria 3°,SuperSchool,204,11,193
2025-09-15,13,Primaria 3°,TopKids,98,2,96
2025-09-15,13,Primaria 3°,EduMax,237,2,235
2025-09-15,13,Primaria 3°,TopKids,108,22,86
2025-09-15,13,Primaria 3°,SuperSchool,155,14,141
2025-09-15,13,Primaria 4°,TopKids,98,16,82
2025-09-15,13,Primaria 4°,SuperSchool,291,11,280
2025-09-15,13,Primaria 4°,TopKids,284,10,274
2025-09-15,13,Primaria 4°,EduMax,127,14,113
2025-09-15,13,Primaria 4°,EduMax,113,21,92
2025-09-15,13,Primaria 4°,TopKids,85,10,75
2025-09-15,13,Primaria 4°,TopKids,151,22,129
2025-09-15,13,Primaria 4°,SuperSchool,60,18,42
2025-09-15,13,Primaria 4°,EduMax,294,15,279
2025-09-15,13,Primaria 5°,EduMax,229,1,228
2025-09-15,13,Primaria 5°,SuperSchool,63,3,60
2025-09-15,13,Primaria 5°,EduMax,208,1,207
2025-09-15,13,Primaria 5°,EduMax,191,4,187
2025-09-15,13,Primaria 5°,EduMax,232,4,228
2025-09-15,13,Primaria 5°,TopKids,293,9,284
2025-09-15,13,Primaria 5°,TopKids,192,6,186
2025-09-15,13,Primaria 5°,SuperSchool,93,13,80
2025-09-15,13,Primaria 5°,EduMax,104,23,81
2025-09-15,13,Primaria 5°,EduMax,265,11,254
2025-09-15,13,Primaria 5°,SuperSchool,233,2,231
2025-09-15,13,Primaria 5°,TopKids,173,2,171
2025-09-15,13,Primaria 5°,SuperSchool,113,23,90
2025-09-15,13,Primaria 5°,SuperSchool,235,11,224
2025-09-15,13,Primaria 5°,EduMax,170,20,150
2025-09-15,13,Primaria 6°,SuperSchool,236,16,220
2025-09-15,13,Primaria 6°,SuperSchool,237,10,227
2025-09-15,13,Primaria 6°,SuperSchool,295,24,271
2025-09-15,13,Primaria 6°,TopKids,78,3,75
2025-09-15,13,Primaria 6°,SuperSchool,135,20,115
2025-09-15,14,Preescolar,TopKids,149,12,137
2025-09-15,14,Preescolar,TopKids,152,8,144
2025-09-15,14,Preescolar,EduMax,113,23,90
2025-09-15,14,Preescolar,SuperSchool,169,13,156
2025-09-15,14,Preescolar,EduMax,129,7,122
2025-09-15,14,Preescolar,SuperSchool,69,19,50
2025-09-15,14,Preescolar,SuperSchool,173,8,165
2025-09-15,14,Preescolar,SuperSchool,278,21,257
2025-09-15,14,Preescolar,EduMax,209,5,204
2025-09-15,14,Preescolar,EduMax,67,7,60
2025-09-15,14,Preescolar,SuperSchool,169,6,163
2025-09-15,14,Preescolar,TopKids,233,9,224
2025-09-15,14,Kínder,SuperSchool,249,17,232
2025-09-15,14,Kínder,SuperSchool,264,1,263
2025-09-15,14,Kínder,EduMax,99,15,84
2025-09-15,14,Kínder,EduMax,76,16,60
2025-09-15,14,Kínder,EduMax,272,13,259
2025-09-15,14,Kínder,EduMax,95,7,88
2025-09-15,14,Kínder,TopKids,288,17,271
2025-09-15,14,Kínder,TopKids,70,17,53
2025-09-15,14,Kínder,TopKids,129,9,120
2025-09-15,14,Primaria 1°,SuperSchool,165,19,146
2025-09-15,14,Primaria 1°,TopKids,90,6,84
2025-09-15,14,Primaria 1°,SuperSchool,144,5,139
2025-09-15,14,Primaria 1°,SuperSchool,296,1,295
2025-09-15,14,Primaria 1°,SuperSchool,142,22,120
2025-09-15,14,Primaria 1°,EduMax,90,19,71
2025-09-15,14,Primaria 1°,SuperSchool,198,17,181
2025-09-15,14,Primaria 1°,TopKids,135,20,115
2025-09-15,14,Primaria 1°,EduMax,206,13,193
2025-09-15,14,Primaria 2°,SuperSchool,84,11,73
2025-09-15,14,Primaria 2°,SuperSchool,101,1,100
2025-09-15,14,Primaria 2°,SuperSchool,63,21,42
2025-09-15,14,Primaria 2°,SuperSchool,297,13,284
2025-09-15,14,Primaria 2°,TopKids,104,21,83
2025-09-15,14,Primaria 2°,TopKids,222,1,221
2025-09-15,14,Primaria 2°,TopKids,241,20,221
2025-09-15,14,Primaria 2°,TopKids,70,4,66
2025-09-15,14,Primaria 2°,EduMax,202,12,190
2025-09-15,14,Primaria 2°,SuperSchool,91,18,73
2025-09-15,14,Primaria 2°,SuperSchool,152,2,150
2025-09-15,14,Primaria 2°,SuperSchool,89,1,88
2025-09-15,14,Primaria 3°,EduMax,252,19,233
2025-09-15,14,Primaria 3°,SuperSchool,77,10,67
2025-09-15,14,Primaria 3°,TopKids,129,16,113
2025-09-15,14,Primaria 3°,EduMax,259,22,237
2025-09-15,14,Primaria 3°,EduMax,276,12,264
2025-09-15,14,Primaria 3°,EduMax,269,16,253
2025-09-15,14,Primaria 3°,SuperSchool,58,18,40
2025-09-15,14,Primaria 4°,EduMax,132,14,118
2025-09-15,14,Primaria 4°,EduMax,188,8,180
2025-09-15,14,Primaria 4°,TopKids,64,13,51
2025-09-15,14,Primaria 4°,SuperSchool,257,22,235
2025-09-15,14,Primaria 4°,SuperSchool,175,2,173
2025-09-15,14,Primaria 4°,SuperSchool,270,14,256
2025-09-15,14,Primaria 4°,EduMax,65,14,51
2025-09-15,14,Primaria 4°,TopKids,295,14,281
2025-09-15,14,Primaria 4°,EduMax,162,5,157
2025-09-15,14,Primaria 4°,TopKids,195,16,179
2025-09-15,14,Primaria 4°,EduMax,251,6,245
2025-09-15,14,Primaria 4°,EduMax,243,9,234
2025-09-15,14,Primaria 4°,SuperSchool,70,23,47
2025-09-15,14,Primaria 4°,EduMax,180,13,167
2025-09-15,14,Primaria 4°,SuperSchool,210,20,190
2025-09-15,14,Primaria 4°,SuperSchool,277,18,259
2025-09-15,14,Primaria 4°,SuperSchool,286,6,280
2025-09-15,14,Primaria 5°,EduMax,192,18,174
2025-09-15,14,Primaria 5°,SuperSchool,287,4,283
2025-09-15,14,Primaria 5°,SuperSchool,146,8,138
2025-09-15,14,Primaria 5°,TopKids,62,17,45
2025-09-15,14,Primaria 5°,SuperSchool,127,17,110
2025-09-15,14,Primaria 5°,SuperSchool,185,19,166
2025-09-15,14,Primaria 5°,EduMax,60,23,37
2025-09-15,14,Primaria 5°,EduMax,108,1,107
2025-09-15,14,Primaria 5°,SuperSchool,129,20,109
2025-09-15,14,Primaria 5°,SuperSchool,161,3,158
2025-09-15,14,Primaria 5°,EduMax,136,2,134
2025-09-15,14,Primaria 5°,SuperSchool,167,1,166
2025-09-15,14,Primaria 5°,TopKids,168,24,144
2025-09-15,14,Primaria 6°,TopKids,83,20,63
2025-09-15,14,Primaria 6°,TopKids,284,6,278
2025-09-15,14,Primaria 6°,EduMax,223,4,219
2025-09-15,14,Primaria 6°,TopKids,234,22,212
2025-09-15,14,Primaria 6°,SuperSchool,275,2,273
2025-09-15,14,Primaria 6°,SuperSchool,222,3,219
2025-09-15,14,Primaria 6°,SuperSchool,279,21,258
2025-09-15,14,Primaria 6°,SuperSchool,78,1,77
2025-09-15,14,Primaria 6°,TopKids,239,7,232
2025-09-15,14,Primaria 6°,SuperSchool,235,22,213
2025-09-15,14,Primaria 6°,SuperSchool,131,1,130
2025-09-15,14,Primaria 6°,TopKids,295,22,273
2025-09-15,14,Primaria 6°,SuperSchool,209,11,198
2025-09-15,14,Primaria 6°,EduMax,226,17,209
2025-09-15,14,Primaria 6°,EduMax,109,10,99
2025-09-15,14,Primaria 6°,EduMax,198,6,192
2025-09-15,14,Primaria 6°,EduMax,174,20,154
2025-09-15,14,Primaria 6°,EduMax,57,5,52
2025-09-15,15,Preescolar,TopKids,211,17,194
2025-09-15,15,Preescolar,EduMax,78,9,69
2025-09-15,15,Preescolar,SuperSchool,81,8,73
2025-09-15,15,Preescolar,TopKids,220,10,210
2025-09-15,15,Preescolar,SuperSchool,136,20,116
2025-09-15,15,Preescolar,SuperSchool,135,9,126
2025-09-15,15,Preescolar,TopKids,80,13,67
2025-09-15,15,Preescolar,SuperSchool,62,21,41
2025-09-15,15,Preescolar,EduMax,155,15,140
2025-09-15,15,Preescolar,SuperSchool,237,10,227
2025-09-15,15,Kínder,TopKids,251,21,230
2025-09-15,15,Kínder,SuperSchool,54,13,41
2025-09-15,15,Kínder,SuperSchool,166,19,147
2025-09-15,15,Kínder,SuperSchool,102,2,100
2025-09-15,15,Kínder,SuperSchool,154,24,130
2025-09-15,15,Kínder,EduMax,106,23,83
2025-09-15,15,Kínder,EduMax,143,1,142
2025-09-15,15,Kínder,EduMax,254,3,251
2025-09-15,15,Kínder,TopKids,261,5,256
2025-09-15,15,Primaria 1°,EduMax,294,18,276
2025-09-15,15,Primaria 1°,SuperSchool,199,12,187
2025-09-15,15,Primaria 1°,SuperSchool,259,23,236
2025-09-15,15,Primaria 1°,TopKids,147,10,137
2025-09-15,15,Primaria 1°,EduMax,219,3,216
2025-09-15,15,Primaria 1°,EduMax,54,24,30
2025-09-15,15,Primaria 2°,EduMax,190,24,166
2025-09-15,15,Primaria 2°,SuperSchool,55,13,42
2025-09-15,15,Primaria 2°,SuperSchool,61,3,58
2025-09-15,15,Primaria 2°,EduMax,161,5,156
2025-09-15,15,Primaria 2°,EduMax,252,4,248
2025-09-15,15,Primaria 2°,EduMax,242,13,229
2025-09-15,15,Primaria 2°,EduMax,129,2,127
2025-09-15,15,Primaria 2°,SuperSchool,204,12,192
2025-09-15,15,Primaria 2°,SuperSchool,182,22,160
2025-09-15,15,Primaria 2°,SuperSchool,129,19,110
2025-09-15,15,Primaria 2°,SuperSchool,225,19,206
2025-09-15,15,Primaria 3°,TopKids,186,16,170
2025-09-15,15,Primaria 3°,EduMax,297,6,291
2025-09-15,15,Primaria 3°,SuperSchool,273,14,259
2025-09-15,15,Primaria 3°,EduMax,108,16,92
2025-09-15,15,Primaria 3°,EduMax,179,13,166
2025-09-15,15,Primaria 3°,TopKids,251,6,245
2025-09-15,15,Primaria 3°,TopKids,236,15,221
2025-09-15,15,Primaria 3°,TopKids,52,21,31
2025-09-15,15,Primaria 4°,EduMax,103,2,101
2025-09-15,15,Primaria 4°,TopKids,97,23,74
2025-09-15,15,Primaria 4°,SuperSchool,128,13,115
2025-09-15,15,Primaria 4°,SuperSchool,238,12,226
2025-09-15,15,Primaria 4°,TopKids,174,20,154
2025-09-15,15,Primaria 4°,TopKids,250,3,247
2025-09-15,15,Primaria 4°,TopKids,281,8,273
2025-09-15,15,Primaria 4°,EduMax,169,15,154
2025-09-15,15,Primaria 4°,SuperSchool,190,15,175
2025-09-15,15,Primaria 4°,TopKids,189,3,186
2025-09-15,15,Primaria 4°,TopKids,185,10,175
2025-09-15,15,Primaria 4°,EduMax,249,22,227
2025-09-15,15,Primaria 4°,EduMax,189,22,167
2025-09-15,15,Primaria 4°,TopKids,235,18,217
2025-09-15,15,Primaria 4°,TopKids,172,5,167
2025-09-15,15,Primaria 5°,SuperSchool,251,19,232
2025-09-15,15,Primaria 5°,SuperSchool,157,1,156
2025-09-15,15,Primaria 5°,EduMax,194,3,191
2025-09-15,15,Primaria 5°,TopKids,293,9,284
2025-09-15,15,Primaria 5°,TopKids,182,9,173
2025-09-15,15,Primaria 6°,TopKids,127,14,113
2025-09-15,15,Primaria 6°,SuperSchool,181,16,165
2025-09-15,15,Primaria 6°,SuperSchool,235,1,234
2025-09-15,15,Primaria 6°,TopKids,265,3,262
2025-09-15,15,Primaria 6°,EduMax,162,11,151
2025-09-15,15,Primaria 6°,EduMax,244,7,237
2025-09-15,15,Primaria 6°,EduMax,212,8,204
2025-09-15,16,Preescolar,SuperSchool,204,10,194
2025-09-15,16,Preescolar,EduMax,279,8,271
2025-09-15,16,Preescolar,EduMax,215,23,192
2025-09-15,16,Preescolar,EduMax,186,16,170
2025-09-15,16,Preescolar,TopKids,74,2,72
2025-09-15,16,Preescolar,SuperSchool,158,7,151
2025-09-15,16,Preescolar,EduMax,59,13,46
2025-09-15,16,Preescolar,EduMax,77,4,73
2025-09-15,16,Preescolar,TopKids,60,9,51
2025-09-15,16,Preescolar,SuperSchool,104,5,99
2025-09-15,16,Preescolar,SuperSchool,87,2,85
2025-09-15,16,Preescolar,TopKids,287,11,276
2025-09-15,16,Preescolar,TopKids,113,11,102
2025-09-15,16,Kínder,EduMax,126,19,107
2025-09-15,16,Kínder,TopKids,74,16,58
2025-09-15,16,Kínder,SuperSchool,238,3,235
2025-09-15,16,Kínder,TopKids,192,22,170
2025-09-15,16,Kínder,SuperSchool,98,21,77
2025-09-15,16,Kínder,SuperSchool,138,8,130
2025-09-15,16,Kínder,EduMax,287,9,278
2025-09-15,16,Kínder,TopKids,174,9,165
2025-09-15,16,Kínder,TopKids,273,17,256
2025-09-15,16,Kínder,SuperSchool,137,8,129
2025-09-15,16,Kínder,EduMax,58,15,43
2025-09-15,16,Kínder,EduMax,295,11,284
2025-09-15,16,Kínder,TopKids,169,14,155
2025-09-15,16,Primaria 1°,SuperSchool,295,13,282
2025-09-15,16,Primaria 1°,EduMax,108,16,92
2025-09-15,16,Primaria 1°,SuperSchool,265,18,247
2025-09-15,16,Primaria 1°,SuperSchool,290,21,269
2025-09-15,16,Primaria 1°,TopKids,114,13,101
2025-09-15,16,Primaria 1°,EduMax,212,6,206
2025-09-15,16,Primaria 1°,SuperSchool,292,8,284
2025-09-15,16,Primaria 1°,SuperSchool,72,20,52
2025-09-15,16,Primaria 1°,TopKids,56,11,45
2025-09-15,16,Primaria 1°,TopKids,121,11,110
2025-09-15,16,Primaria 1°,EduMax,63,4,59
2025-09-15,16,Primaria 1°,SuperSchool,281,15,266
2025-09-15,16,Primaria 1°,TopKids,133,6,127
2025-09-15,16,Primaria 1°,SuperSchool,289,16,273
2025-09-15,16,Primaria 1°,SuperSchool,63,15,48
2025-09-15,16,Primaria 1°,EduMax,236,21,215
2025-09-15,16,Primaria 1°,TopKids,163,24,139
2025-09-15,16,Primaria 2°,TopKids,119,3,116
2025-09-15,16,Primaria 2°,SuperSchool,64,2,62
2025-09-15,16,Primaria 2°,EduMax,151,12,139
2025-09-15,16,Primaria 2°,TopKids,154,6,148
2025-09-15,16,Primaria 2°,EduMax,86,4,82
2025-09-15,16,Primaria 2°,EduMax,76,20,56
2025-09-15,16,Primaria 2°,SuperSchool,258,18,240
2025-09-15,16,Primaria 2°,TopKids,200,13,187
2025-09-15,16,Primaria 2°,SuperSchool,178,19,159
2025-09-15,16,Primaria 2°,TopKids,103,2,101
2025-09-15,16,Primaria 2°,SuperSchool,237,21,216
2025-09-15,16,Primaria 2°,EduMax,271,24,247
2025-09-15,16,Primaria 2°,EduMax,55,12,43
2025-09-15,16,Primaria 2°,SuperSchool,175,18,157
2025-09-15,16,Primaria 2°,TopKids,74,17,57
2025-09-15,16,Primaria 3°,SuperSchool,106,22,84
2025-09-15,16,Primaria 3°,EduMax,221,7,214
2025-09-15,16,Primaria 3°,TopKids,134,13,121
2025-09-15,16,Primaria 3°,SuperSchool,282,4,278
2025-09-15,16,Primaria 3°,EduMax,67,1,66
2025-09-15,16,Primaria 3°,TopKids,115,5,110
2025-09-15,16,Primaria 3°,TopKids,263,14,249
2025-09-15,16,Primaria 3°,SuperSchool,197,20,177
2025-09-15,16,Primaria 3°,TopKids,293,1,292
2025-09-15,16,Primaria 3°,EduMax,132,4,128
2025-09-15,16,Primaria 3°,EduMax,178,5,173
2025-09-15,16,Primaria 4°,SuperSchool,226,14,212
2025-09-15,16,Primaria 4°,TopKids,259,10,249
2025-09-15,16,Primaria 4°,TopKids,74,4,70
2025-09-15,16,Primaria 4°,TopKids,287,3,284
2025-09-15,16,Primaria 4°,SuperSchool,268,23,245
2025-09-15,16,Primaria 4°,EduMax,188,10,178
2025-09-15,16,Primaria 4°,SuperSchool,269,23,246
2025-09-15,16,Primaria 4°,EduMax,255,24,231
2025-09-15,16,Primaria 4°,SuperSchool,95,8,87
2025-09-15,16,Primaria 4°,EduMax,297,6,291
2025-09-15,16,Primaria 4°,EduMax,135,2,133
2025-09-15,16,Primaria 4°,SuperSchool,73,5,68
2025-09-15,16,Primaria 4°,EduMax,116,11,105
2025-09-15,16,Primaria 4°,EduMax,143,7,136
2025-09-15,16,Primaria 5°,SuperSchool,222,16,206
2025-09-15,16,Primaria 5°,TopKids,157,8,149
2025-09-15,16,Primaria 5°,EduMax,203,14,189
2025-09-15,16,Primaria 5°,SuperSchool,235,10,225
2025-09-15,16,Primaria 5°,EduMax,263,24,239
2025-09-15,16,Primaria 5°,EduMax,81,14,67
2025-09-15,16,Primaria 5°,TopKids,66,4,62
2025-09-15,16,Primaria 5°,SuperSchool,201,15,186
2025-09-15,16,Primaria 5°,TopKids,90,15,75
2025-09-15,16,Primaria 5°,EduMax,140,20,120
2025-09-15,16,Primaria 5°,EduMax,109,1,108
2025-09-15,16,Primaria 5°,SuperSchool,201,20,181
2025-09-15,16,Primaria 5°,SuperSchool,117,5,112
2025-09-15,16,Primaria 5°,SuperSchool,237,14,223
2025-09-15,16,Primaria 5°,SuperSchool,80,2,78
2025-09-15,16,Primaria 5°,EduMax,155,5,150
2025-09-15,16,Primaria 5°,SuperSchool,222,23,199
2025-09-15,16,Primaria 6°,SuperSchool,62,9,53
2025-09-15,16,Primaria 6°,EduMax,258,3,255
2025-09-15,16,Primaria 6°,EduMax,176,12,164
2025-09-15,16,Primaria 6°,TopKids,218,16,202
2025-09-15,16,Primaria 6°,EduMax,62,18,44
2025-09-15,16,Primaria 6°,EduMax,147,19,128
2025-09-15,16,Primaria 6°,SuperSchool,247,18,229
2025-09-15,16,Primaria 6°,TopKids,103,6,97
2025-09-15,16,Primaria 6°,SuperSchool,104,18,86
2025-09-15,16,Primaria 6°,EduMax,120,2,118
2025-09-15,16,Primaria 6°,TopKids,71,17,54
2025-09-15,16,Primaria 6°,EduMax,185,8,177
2025-09-15,16,Primaria 6°,TopKids,149,20,129
2025-09-15,16,Primaria 6°,SuperSchool,249,14,235
2025-09-15,16,Primaria 6°,SuperSchool,276,18,258
2025-09-15,16,Primaria 6°,EduMax,288,21,267
2025-09-15,16,Primaria 6°,SuperSchool,176,15,161
2025-09-16,9,Preescolar,TopKids,55,10,45
2025-09-16,9,Preescolar,TopKids,229,15,214
2025-09-16,9,Preescolar,SuperSchool,213,8,205
2025-09-16,9,Preescolar,EduMax,190,17,173
2025-09-16,9,Preescolar,EduMax,171,5,166
2025-09-16,9,Preescolar,EduMax,129,23,106
2025-09-16,9,Preescolar,EduMax,136,15,121
2025-09-16,9,Preescolar,SuperSchool,142,4,138
2025-09-16,9,Preescolar,TopKids,128,5,123
2025-09-16,9,Preescolar,TopKids,223,7,216
2025-09-16,9,Preescolar,TopKids,86,9,77
2025-09-16,9,Preescolar,SuperSchool,79,7,72
2025-09-16,9,Preescolar,TopKids,146,15,131
2025-09-16,9,Preescolar,TopKids,259,15,244
2025-09-16,9,Preescolar,EduMax,148,5,143
2025-09-16,9,Kínder,SuperSchool,225,23,202
2025-09-16,9,Kínder,SuperSchool,251,22,229
2025-09-16,9,Kínder,TopKids,200,13,187
2025-09-16,9,Kínder,TopKids,281,20,261
2025-09-16,9,Kínder,TopKids,223,6,217
2025-09-16,9,Kínder,TopKids,162,5,157
2025-09-16,9,Kínder,SuperSchool,116,19,97
2025-09-16,9,Kínder,EduMax,79,15,64
2025-09-16,9,Kínder,EduMax,294,20,274
2025-09-16,9,Kínder,TopKids,56,14,42
2025-09-16,9,Kínder,TopKids,112,24,88
2025-09-16,9,Kínder,TopKids,172,7,165
2025-09-16,9,Kínder,TopKids,281,24,257
2025-09-16,9,Kínder,EduMax,297,11,286
2025-09-16,9,Kínder,SuperSchool,69,10,59
2025-09-16,9,Kínder,TopKids,263,3,260
2025-09-16,9,Primaria 1°,EduMax,107,6,101
2025-09-16,9,Primaria 1°,EduMax,178,4,174
2025-09-16,9,Primaria 1°,SuperSchool,216,11,205
2025-09-16,9,Primaria 1°,EduMax,108,5,103
2025-09-16,9,Primaria 1°,SuperSchool,147,18,129
2025-09-16,9,Primaria 1°,EduMax,186,14,172
2025-09-16,9,Primaria 1°,SuperSchool,242,7,235
2025-09-16,9,Primaria 2°,EduMax,211,4,207
2025-09-16,9,Primaria 2°,SuperSchool,89,22,67
2025-09-16,9,Primaria 2°,TopKids,255,13,242
2025-09-16,9,Primaria 2°,TopKids,257,7,250
2025-09-16,9,Primaria 2°,EduMax,188,11,177
2025-09-16,9,Primaria 2°,EduMax,215,12,203
2025-09-16,9,Primaria 2°,EduMax,240,9,231
2025-09-16,9,Primaria 2°,EduMax,215,9,206
2025-09-16,9,Primaria 2°,EduMax,106,3,103
2025-09-16,9,Primaria 2°,TopKids,276,20,256
2025-09-16,9,Primaria 2°,EduMax,170,8,162
2025-09-16,9,Primaria 3°,EduMax,185,13,172
2025-09-16,9,Primaria 3°,EduMax,63,5,58
2025-09-16,9,Primaria 3°,SuperSchool,136,13,123
2025-09-16,9,Primaria 3°,TopKids,73,3,70
2025-09-16,9,Primaria 3°,EduMax,117,10,107
2025-09-16,9,Primaria 3°,EduMax,215,2,213
2025-09-16,9,Primaria 3°,EduMax,68,3,65
2025-09-16,9,Primaria 3°,EduMax,203,11,192
2025-09-16,9,Primaria 3°,TopKids,177,17,160
2025-09-16,9,Primaria 3°,SuperSchool,95,2,93
2025-09-16,9,Primaria 4°,TopKids,51,22,29
2025-09-16,9,Primaria 4°,EduMax,270,1,269
2025-09-16,9,Primaria 4°,EduMax,160,21,139
2025-09-16,9,Primaria 4°,EduMax,198,3,195
2025-09-16,9,Primaria 4°,TopKids,132,22,110
2025-09-16,9,Primaria 4°,TopKids,159,4,155
2025-09-16,9,Primaria 4°,TopKids,203,19,184
2025-09-16,9,Primaria 4°,EduMax,242,22,220
2025-09-16,9,Primaria 4°,TopKids,92,9,83
2025-09-16,9,Primaria 4°,TopKids,259,19,240
2025-09-16,9,Primaria 4°,TopKids,195,13,182
2025-09-16,9,Primaria 4°,TopKids,293,8,285
2025-09-16,9,Primaria 4°,TopKids,107,24,83
2025-09-16,9,Primaria 4°,SuperSchool,168,22,146
2025-09-16,9,Primaria 4°,TopKids,267,20,247
2025-09-16,9,Primaria 4°,EduMax,288,12,276
2025-09-16,9,Primaria 4°,EduMax,273,17,256
2025-09-16,9,Primaria 4°,TopKids,53,12,41
2025-09-16,9,Primaria 5°,SuperSchool,86,6,80
2025-09-16,9,Primaria 5°,TopKids,205,8,197
2025-09-16,9,Primaria 5°,TopKids,197,16,181
2025-09-16,9,Primaria 5°,SuperSchool,296,15,281
2025-09-16,9,Primaria 5°,EduMax,254,15,239
2025-09-16,9,Primaria 6°,SuperSchool,171,20,151
2025-09-16,9,Primaria 6°,EduMax,67,7,60
2025-09-16,9,Primaria 6°,SuperSchool,90,7,83
2025-09-16,9,Primaria 6°,SuperSchool,157,10,147
2025-09-16,9,Primaria 6°,TopKids,91,13,78
2025-09-16,9,Primaria 6°,SuperSchool,108,22,86
2025-09-16,10,Preescolar,EduMax,215,11,204
2025-09-16,10,Preescolar,EduMax,183,13,170
2025-09-16,10,Preescolar,SuperSchool,285,14,271
2025-09-16,10,Preescolar,EduMax,138,8,130
2025-09-16,10,Preescolar,TopKids,86,22,64
2025-09-16,10,Preescolar,TopKids,227,6,221
2025-09-16,10,Preescolar,EduMax,185,7,178
2025-09-16,10,Preescolar,EduMax,149,23,126
2025-09-16,10,Preescolar,SuperSchool,225,19,206
2025-09-16,10,Preescolar,EduMax,107,8,99
2025-09-16,10,Preescolar,SuperSchool,65,8,57
2025-09-16,10,Preescolar,TopKids,232,20,212
2025-09-16,10,Kínder,TopKids,126,10,116
2025-09-16,10,Kínder,TopKids,74,9,65
2025-09-16,10,Kínder,SuperSchool,75,12,63
2025-09-16,10,Kínder,EduMax,224,22,202
2025-09-16,10,Kínder,SuperSchool,241,12,229
2025-09-16,10,Kínder,EduMax,63,22,41
2025-09-16,10,Kínder,TopKids,179,3,176
2025-09-16,10,Kínder,EduMax,260,21,239
2025-09-16,10,Kínder,SuperSchool,69,21,48
2025-09-16,10,Kínder,TopKids,245,19,226
2025-09-16,10,Kínder,TopKids,248,1,247
2025-09-16,10,Kínder,TopKids,139,17,122
2025-09-16,10,Kínder,EduMax,166,15,151
2025-09-16,10,Kínder,TopKids,248,24,224
2025-09-16,10,Kínder,SuperSchool,50,7,43
2025-09-16,10,Kínder,SuperSchool,67,8,59
2025-09-16,10,Kínder,TopKids,291,6,285
2025-09-16,10,Kínder,SuperSchool,71,11,60
2025-09-16,10,Kínder,EduMax,121,9,112
2025-09-16,10,Primaria 1°,TopKids,244,7,237
2025-09-16,10,Primaria 1°,TopKids,252,14,238
2025-09-16,10,Primaria 1°,EduMax,77,21,56
2025-09-16,10,Primaria 1°,EduMax,80,20,60
2025-09-16,10,Primaria 1°,TopKids,186,12,174
2025-09-16,10,Primaria 1°,SuperSchool,135,18,117
2025-09-16,10,Primaria 1°,EduMax,98,11,87
2025-09-16,10,Primaria 1°,SuperSchool,179,23,156
2025-09-16,10,Primaria 1°,SuperSchool,203,19,184
2025-09-16,10,Primaria 1°,EduMax,296,3,293
2025-09-16,10,Primaria 1°,EduMax,149,12,137
2025-09-16,10,Primaria 1°,EduMax,211,6,205
2025-09-16,10,Primaria 1°,TopKids,241,5,236
2025-09-16,10,Primaria 1°,SuperSchool,214,8,206
2025-09-16,10,Primaria 1°,SuperSchool,169,8,161
2025-09-16,10,Primaria 1°,SuperSchool,165,9,156
2025-09-16,10,Primaria 1°,EduMax,80,2,78
2025-09-16,10,Primaria 2°,SuperSchool,299,16,283
2025-09-16,10,Primaria 2°,EduMax,88,12,76
2025-09-16,10,Primaria 2°,SuperSchool,246,8,238
2025-09-16,10,Primaria 2°,SuperSchool,284,19,265
2025-09-16,10,Primaria 2°,SuperSchool,141,19,122
2025-09-16,10,Primaria 2°,TopKids,196,5,191
2025-09-16,10,Primaria 2°,EduMax,74,19,55
2025-09-16,10,Primaria 2°,EduMax,79,17,62
2025-09-16,10,Primaria 2°,SuperSchool,261,18,243
2025-09-16,10,Primaria 2°,TopKids,257,12,245
2025-09-16,10,Primaria 2°,SuperSchool,183,24,159
2025-09-16,10,Primaria 2°,EduMax,220,6,214
2025-09-16,10,Primaria 2°,SuperSchool,219,19,200
2025-09-16,10,Primaria 2°,TopKids,289,23,266
2025-09-16,10,Primaria 2°,SuperSchool,206,17,189
2025-09-16,10,Primaria 3°,TopKids,260,8,252
2025-09-16,10,Primaria 3°,SuperSchool,92,2,90
2025-09-16,10,Primaria 3°,EduMax,262,4,258
2025-09-16,10,Primaria 3°,SuperSchool,290,23,267
2025-09-16,10,Primaria 3°,TopKids,219,14,205
2025-09-16,10,Primaria 3°,TopKids,235,14,221
2025-09-16,10,Primaria 3°,SuperSchool,153,11,142
2025-09-16,10,Primaria 3°,EduMax,131,23,108
2025-09-16,10,Primaria 3°,SuperSchool,134,16,118
2025-09-16,10,Primaria 3°,EduMax,262,11,251
2025-09-16,10,Primaria 4°,EduMax,211,19,192
2025-09-16,10,Primaria 4°,SuperSchool,141,20,121
2025-09-16,10,Primaria 4°,EduMax,299,16,283
2025-09-16,10,Primaria 4°,SuperSchool,180,1,179
2025-09-16,10,Primaria 4°,SuperSchool,89,17,72
2025-09-16,10,Primaria 4°,SuperSchool,254,6,248
2025-09-16,10,Primaria 4°,TopKids,248,24,224
2025-09-16,10,Primaria 4°,TopKids,256,4,252
2025-09-16,10,Primaria 4°,SuperSchool,92,21,71
2025-09-16,10,Primaria 4°,TopKids,255,9,246
2025-09-16,10,Primaria 4°,SuperSchool,166,6,160
2025-09-16,10,Primaria 4°,TopKids,173,5,168
2025-09-16,10,Primaria 4°,SuperSchool,266,10,256
2025-09-16,10,Primaria 5°,EduMax,264,17,247
2025-09-16,10,Primaria 5°,EduMax,204,11,193
2025-09-16,10,Primaria 5°,EduMax,132,4,128
2025-09-16,10,Primaria 5°,EduMax,227,1,226
2025-09-16,10,Primaria 5°,TopKids,69,11,58
2025-09-16,10,Primaria 5°,TopKids,74,19,55
2025-09-16,10,Primaria 5°,SuperSchool,242,3,239
2025-09-16,10,Primaria 5°,EduMax,287,8,279
2025-09-16,10,Primaria 5°,TopKids,149,11,138
2025-09-16,10,Primaria 5°,EduMax,152,24,128
2025-09-16,10,Primaria 5°,EduMax,57,22,35
2025-09-16,10,Primaria 5°,EduMax,260,23,237
2025-09-16,10,Primaria 5°,SuperSchool,129,8,121
2025-09-16,10,Primaria 5°,TopKids,271,8,263
2025-09-16,10,Primaria 5°,TopKids,56,21,35
2025-09-16,10,Primaria 5°,EduMax,134,5,129
2025-09-16,10,Primaria 5°,EduMax,220,17,203
2025-09-16,10,Primaria 5°,SuperSchool,55,13,42
2025-09-16,10,Primaria 6°,TopKids,131,6,125
2025-09-16,10,Primaria 6°,TopKids,177,12,165
2025-09-16,10,Primaria 6°,EduMax,52,19,33
2025-09-16,10,Primaria 6°,TopKids,136,2,134
2025-09-16,10,Primaria 6°,TopKids,264,17,247
2025-09-16,10,Primaria 6°,SuperSchool,78,2,76
2025-09-16,10,Primaria 6°,SuperSchool,270,13,257
2025-09-16,10,Primaria 6°,EduMax,201,7,194
2025-09-16,10,Primaria 6°,SuperSchool,81,11,70
2025-09-16,10,Primaria 6°,SuperSchool,239,18,221
2025-09-16,10,Primaria 6°,EduMax,84,6,78
2025-09-16,11,Preescolar,EduMax,137,4,133
2025-09-16,11,Preescolar,SuperSchool,58,4,54
2025-09-16,11,Preescolar,SuperSchool,82,22,60
2025-09-16,11,Preescolar,TopKids,60,5,55
2025-09-16,11,Preescolar,EduMax,180,15,165
2025-09-16,11,Preescolar,TopKids,172,14,158
2025-09-16,11,Preescolar,SuperSchool,217,17,200
2025-09-16,11,Kínder,TopKids,181,2,179
2025-09-16,11,Kínder,EduMax,144,2,142
2025-09-16,11,Kínder,TopKids,77,9,68
2025-09-16,11,Kínder,SuperSchool,165,15,150
2025-09-16,11,Kínder,TopKids,218,10,208
2025-09-16,11,Kínder,SuperSchool,79,22,57
2025-09-16,11,Kínder,TopKids,68,5,63
2025-09-16,11,Kínder,TopKids,156,4,152
2025-09-16,11,Primaria 1°,EduMax,288,8,280
2025-09-16,11,Primaria 1°,SuperSchool,204,13,191
2025-09-16,11,Primaria 1°,EduMax,239,20,219
2025-09-16,11,Primaria 1°,EduMax,82,14,68
2025-09-16,11,Primaria 1°,EduMax,261,8,253
2025-09-16,11,Primaria 1°,SuperSchool,83,15,68
2025-09-16,11,Primaria 1°,TopKids,213,4,209
2025-09-16,11,Primaria 1°,EduMax,102,18,84
2025-09-16,11,Primaria 2°,SuperSchool,149,24,125
2025-09-16,11,Primaria 2°,TopKids,227,17,210
2025-09-16,11,Primaria 2°,EduMax,203,24,179
2025-09-16,11,Primaria 2°,TopKids,74,1,73
2025-09-16,11,Primaria 2°,TopKids,250,5,245
2025-09-16,11,Primaria 2°,EduMax,271,13,258
2025-09-16,11,Primaria 2°,TopKids,244,23,221
2025-09-16,11,Primaria 2°,TopKids,295,24,271
2025-09-16,11,Primaria 2°,TopKids,214,12,202
2025-09-16,11,Primaria 2°,EduMax,69,18,51
2025-09-16,11,Primaria 2°,TopKids,293,22,271
2025-09-16,11,Primaria 3°,EduMax,289,2,287
2025-09-16,11,Primaria 3°,EduMax,57,1,56
2025-09-16,11,Primaria 3°,EduMax,219,23,196
2025-09-16,11,Primaria 3°,EduMax,177,21,156
2025-09-16,11,Primaria 3°,SuperSchool,283,13,270
2025-09-16,11,Primaria 3°,SuperSchool,137,1,136
2025-09-16,11,Primaria 3°,SuperSchool,173,16,157
2025-09-16,11,Primaria 3°,EduMax,53,10,43
2025-09-16,11,Primaria 3°,TopKids,235,2,233
2025-09-16,11,Primaria 3°,SuperSchool,297,21,276
2025-09-16,11,Primaria 3°,EduMax,273,22,251
2025-09-16,11,Primaria 3°,SuperSchool,127,2,125
2025-09-16,11,Primaria 3°,SuperSchool,221,1,220
2025-09-16,11,Primaria 3°,TopKids,167,24,143
2025-09-16,11,Primaria 4°,SuperSchool,125,20,105
2025-09-16,11,Primaria 4°,SuperSchool,133,2,131
2025-09-16,11,Primaria 4°,EduMax,194,24,170
2025-09-16,11,Primaria 4°,EduMax,64,17,47
2025-09-16,11,Primaria 4°,EduMax,166,8,158
2025-09-16,11,Primaria 4°,EduMax,52,11,41
2025-09-16,11,Primaria 4°,TopKids,186,15,171
2025-09-16,11,Primaria 4°,EduMax,295,11,284
2025-09-16,11,Primaria 4°,TopKids,75,7,68
2025-09-16,11,Primaria 4°,TopKids,88,4,84
2025-09-16,11,Primaria 4°,EduMax,215,19,196
2025-09-16,11,Primaria 4°,EduMax,85,19,66
2025-09-16,11,Primaria 4°,TopKids,162,21,141
2025-09-16,11,Primaria 4°,TopKids,253,17,236
2025-09-16,11,Primaria 4°,TopKids,250,20,230
2025-09-16,11,Primaria 4°,SuperSchool,257,18,239
2025-09-16,11,Primaria 5°,SuperSchool,140,1,139
2025-09-16,11,Primaria 5°,SuperSchool,285,14,271
2025-09-16,11,Primaria 5°,EduMax,99,21,78
2025-09-16,11,Primaria 5°,EduMax,139,16,123
2025-09-16,11,Primaria 5°,EduMax,116,20,96
2025-09-16,11,Primaria 5°,TopKids,118,6,112
2025-09-16,11,Primaria 6°,SuperSchool,103,12,91
2025-09-16,11,Primaria 6°,SuperSchool,231,10,221
2025-09-16,11,Primaria 6°,TopKids,198,5,193
2025-09-16,11,Primaria 6°,EduMax,128,4,124
2025-09-16,11,Primaria 6°,TopKids,130,23,107
2025-09-16,11,Primaria 6°,SuperSchool,249,5,244
2025-09-16,11,Primaria 6°,TopKids,73,22,51
2025-09-16,11,Primaria 6°,SuperSchool,286,21,265
2025-09-16,11,Primaria 6°,SuperSchool,249,19,230
2025-09-16,11,Primaria 6°,TopKids,230,14,216
2025-09-16,11,Primaria 6°,EduMax,200,5,195
2025-09-16,11,Primaria 6°,TopKids,253,16,237
2025-09-16,11,Primaria 6°,EduMax,120,21,99
2025-09-16,12,Preescolar,SuperSchool,84,14,70
2025-09-16,12,Preescolar,SuperSchool,255,20,235
2025-09-16,12,Preescolar,EduMax,244,6,238
2025-09-16,12,Preescolar,SuperSchool,198,3,195
2025-09-16,12,Preescolar,SuperSchool,141,18,123
2025-09-16,12,Preescolar,SuperSchool,101,3,98
2025-09-16,12,Preescolar,EduMax,102,21,81
2025-09-16,12,Preescolar,EduMax,152,9,143
2025-09-16,12,Preescolar,TopKids,243,3,240
2025-09-16,12,Kínder,SuperSchool,265,23,242
2025-09-16,12,Kínder,EduMax,134,15,119
2025-09-16,12,Kínder,EduMax,54,13,41
2025-09-16,12,Kínder,TopKids,254,19,235
2025-09-16,12,Kínder,SuperSchool,52,14,38
2025-09-16,12,Kínder,TopKids,62,9,53
2025-09-16,12,Kínder,TopKids,90,11,79
2025-09-16,12,Kínder,EduMax,224,17,207
2025-09-16,12,Kínder,SuperSchool,84,23,61
2025-09-16,12,Kínder,TopKids,116,4,112
2025-09-16,12,Primaria 1°,EduMax,145,17,128
2025-09-16,12,Primaria 1°,SuperSchool,105,7,98
2025-09-16,12,Primaria 1°,TopKids,292,7,285
2025-09-16,12,Primaria 1°,SuperSchool,71,4,67
2025-09-16,12,Primaria 1°,SuperSchool,247,3,244
2025-09-16,12,Primaria 1°,TopKids,82,7,75
2025-09-16,12,Primaria 1°,SuperSchool,276,23,253
2025-09-16,12,Primaria 1°,SuperSchool,224,3,221
2025-09-16,12,Primaria 1°,SuperSchool,220,18,202
2025-09-16,12,Primaria 1°,TopKids,108,20,88
2025-09-16,12,Primaria 1°,EduMax,88,9,79
2025-09-16,12,Primaria 1°,SuperSchool,130,9,121
2025-09-16,12,Primaria 2°,SuperSchool,54,14,40
2025-09-16,12,Primaria 2°,EduMax,270,11,259
2025-09-16,12,Primaria 2°,EduMax,155,5,150
2025-09-16,12,Primaria 2°,SuperSchool,189,21,168
2025-09-16,12,Primaria 2°,TopKids,73,13,60
2025-09-16,12,Primaria 2°,EduMax,89,4,85
2025-09-16,12,Primaria 2°,SuperSchool,79,15,64
2025-09-16,12,Primaria 2°,SuperSchool,137,6,131
2025-09-16,12,Primaria 2°,EduMax,186,22,164
2025-09-16,12,Primaria 2°,EduMax,198,7,191
2025-09-16,12,Primaria 2°,EduMax,60,3,57
2025-09-16,12,Primaria 2°,TopKids,240,7,233
2025-09-16,12,Primaria 2°,EduMax,123,3,120
2025-09-16,12,Primaria 2°,SuperSchool,156,1,155
2025-09-16,12,Primaria 3°,SuperSchool,255,17,238
2025-09-16,12,Primaria 3°,TopKids,83,17,66
2025-09-16,12,Primaria 3°,TopKids,298,9,289
2025-09-16,12,Primaria 3°,SuperSchool,157,16,141
2025-09-16,12,Primaria 3°,EduMax,233,11,222
2025-09-16,12,Primaria 3°,SuperSchool,197,4,193
2025-09-16,12,Primaria 4°,EduMax,218,17,201
2025-09-16,12,Primaria 4°,SuperSchool,191,4,187
2025-09-16,12,Primaria 4°,EduMax,275,18,257
2025-09-16,12,Primaria 4°,SuperSchool,123,14,109
2025-09-16,12,Primaria 4°,SuperSchool,220,20,200
2025-09-16,12,Primaria 4°,SuperSchool,157,17,140
2025-09-16,12,Primaria 5°,SuperSchool,262,20,242
2025-09-16,12,Primaria 5°,TopKids,266,21,245
2025-09-16,12,Primaria 5°,SuperSchool,170,13,157
2025-09-16,12,Primaria 5°,TopKids,99,13,86
2025-09-16,12,Primaria 5°,TopKids,104,19,85
2025-09-16,12,Primaria 6°,EduMax,63,10,53
2025-09-16,12,Primaria 6°,SuperSchool,126,1,125
2025-09-16,12,Primaria 6°,TopKids,298,15,283
2025-09-16,12,Primaria 6°,SuperSchool,160,20,140
2025-09-16,12,Primaria 6°,TopKids,223,13,210
2025-09-16,12,Primaria 6°,EduMax,111,8,103
2025-09-16,12,Primaria 6°,SuperSchool,100,19,81
2025-09-16,12,Primaria 6°,TopKids,90,23,67
2025-09-16,12,Primaria 6°,EduMax,238,7,231
2025-09-16,12,Primaria 6°,EduMax,51,12,39
2025-09-16,12,Primaria 6°,TopKids,290,2,288
2025-09-16,12,Primaria 6°,EduMax,269,12,257
2025-09-16,12,Primaria 6°,EduMax,107,15,92
2025-09-16,12,Primaria 6°,SuperSchool,153,8,145
2025-09-16,13,Preescolar,EduMax,191,10,181
2025-09-16,13,Preescolar,SuperSchool,102,17,85
2025-09-16,13,Preescolar,SuperSchool,188,13,175
2025-09-16,13,Preescolar,SuperSchool,280,11,269
2025-09-16,13,Preescolar,SuperSchool,244,2,242
2025-09-16,13,Preescolar,EduMax,155,24,131
2025-09-16,13,Preescolar,SuperSchool,217,15,202
2025-09-16,13,Preescolar,EduMax,247,20,227
2025-09-16,13,Preescolar,EduMax,51,22,29
2025-09-16,13,Preescolar,TopKids,97,2,95
2025-09-16,13,Kínder,EduMax,234,23,211
2025-09-16,13,Kínder,EduMax,144,20,124
2025-09-16,13,Kínder,SuperSchool,218,17,201
2025-09-16,13,Kínder,SuperSchool,287,23,264
2025-09-16,13,Kínder,EduMax,62,13,49
2025-09-16,13,Kínder,EduMax,231,19,212
2025-09-16,13,Kínder,TopKids,217,7,210
2025-09-16,13,Kínder,SuperSchool,226,8,218
2025-09-16,13,Kínder,TopKids,168,20,148
2025-09-16,13,Kínder,SuperSchool,141,17,124
2025-09-16,13,Primaria 1°,TopKids,228,1,227
2025-09-16,13,Primaria 1°,SuperSchool,265,10,255
2025-09-16,13,Primaria 1°,EduMax,221,17,204
2025-09-16,13,Primaria 1°,SuperSchool,167,9,158
2025-09-16,13,Primaria 1°,SuperSchool,54,19,35
2025-09-16,13,Primaria 1°,EduMax,268,24,244
2025-09-16,13,Primaria 1°,TopKids,61,5,56
2025-09-16,13,Primaria 1°,SuperSchool,57,2,55
2025-09-16,13,Primaria 1°,TopKids,67,19,48
2025-09-16,13,Primaria 2°,EduMax,88,9,79
2025-09-16,13,Primaria 2°,SuperSchool,92,17,75
2025-09-16,13,Primaria 2°,TopKids,252,15,237
2025-09-16,13,Primaria 2°,TopKids,70,12,58
2025-09-16,13,Primaria 2°,TopKids,153,24,129
2025-09-16,13,Primaria 2°,TopKids,220,1,219
2025-09-16,13,Primaria 2°,EduMax,85,6,79
2025-09-16,13,Primaria 2°,EduMax,288,8,280
2025-09-16,13,Primaria 2°,EduMax,275,24,251
2025-09-16,13,Primaria 3°,SuperSchool,215,3,212
2025-09-16,13,Primaria 3°,EduMax,287,18,269
2025-09-16,13,Primaria 3°,TopKids,85,16,69
2025-09-16,13,Primaria 3°,TopKids,157,17,140
2025-09-16,13,Primaria 3°,SuperSchool,112,20,92
2025-09-16,13,Primaria 3°,SuperSchool,253,5,248
2025-09-16,13,Primaria 3°,SuperSchool,244,6,238
2025-09-16,13,Primaria 3°,SuperSchool,80,3,77
2025-09-16,13,Primaria 3°,TopKids,103,6,97
2025-09-16,13,Primaria 3°,SuperSchool,75,13,62
2025-09-16,13,Primaria 3°,SuperSchool,234,19,215
2025-09-16,13,Primaria 4°,TopKids,299,7,292
2025-09-16,13,Primaria 4°,SuperSchool,101,2,99
2025-09-16,13,Primaria 4°,EduMax,68,19,49
2025-09-16,13,Primaria 4°,TopKids,116,6,110
2025-09-16,13,Primaria 4°,SuperSchool,287,6,281
2025-09-16,13,Primaria 4°,TopKids,154,24,130
2025-09-16,13,Primaria 4°,EduMax,65,23,42
2025-09-16,13,Primaria 4°,TopKids,61,13,48
2025-09-16,13,Primaria 4°,EduMax,107,2,105
2025-09-16,13,Primaria 4°,EduMax,194,23,171
2025-09-16,13,Primaria 4°,TopKids,242,22,220
2025-09-16,13,Primaria 4°,TopKids,127,12,115
2025-09-16,13,Primaria 4°,TopKids,63,17,46
2025-09-16,13,Primaria 4°,EduMax,235,9,226
2025-09-16,13,Primaria 4°,SuperSchool,65,2,63
2025-09-16,13,Primaria 4°,EduMax,289,10,279
2025-09-16,13,Primaria 4°,TopKids,79,4,75
2025-09-16,13,Primaria 4°,TopKids,129,19,110
2025-09-16,13,Primaria 4°,TopKids,86,5,81
2025-09-16,13,Primaria 5°,TopKids,216,17,199
2025-09-16,13,Primaria 5°,SuperSchool,240,3,237
2025-09-16,13,Primaria 5°,EduMax,211,1,210
2025-09-16,13,Primaria 5°,EduMax,294,7,287
2025-09-16,13,Primaria 5°,EduMax,116,18,98
2025-09-16,13,Primaria 5°,SuperSchool,276,7,269
2025-09-16,13,Primaria 5°,TopKids,50,24,26
2025-09-16,13,Primaria 5°,TopKids,150,21,129
2025-09-16,13,Primaria 5°,EduMax,248,11,237
2025-09-16,13,Primaria 5°,SuperSchool,231,2,229
2025-09-16,13,Primaria 5°,EduMax,155,3,152
2025-09-16,13,Primaria 6°,SuperSchool,130,7,123
2025-09-16,13,Primaria 6°,SuperSchool,169,11,158
2025-09-16,13,Primaria 6°,EduMax,289,14,275
2025-09-16,13,Primaria 6°,SuperSchool,64,14,50
2025-09-16,13,Primaria 6°,TopKids,219,19,200
2025-09-16,13,Primaria 6°,TopKids,224,24,200
2025-09-16,13,Primaria 6°,EduMax,255,15,240
2025-09-16,13,Primaria 6°,TopKids,102,16,86
2025-09-16,13,Primaria 6°,EduMax,111,2,109
2025-09-16,13,Primaria 6°,SuperSchool,161,19,142
2025-09-16,13,Primaria 6°,TopKids,284,24,260
2025-09-16,13,Primaria 6°,SuperSchool,118,23,95
2025-09-16,13,Primaria 6°,SuperSchool,282,1,281
2025-09-16,13,Primaria 6°,SuperSchool,172,9,163
2025-09-16,13,Primaria 6°,TopKids,123,5,118
2025-09-16,13,Primaria 6°,EduMax,225,4,221
2025-09-16,13,Primaria 6°,EduMax,102,15,87
2025-09-16,13,Primaria 6°,TopKids,196,9,187
2025-09-16,14,Preescolar,TopKids,244,8,236
2025-09-16,14,Preescolar,EduMax,238,3,235
2025-09-16,14,Preescolar,TopKids,282,3,279
2025-09-16,14,Preescolar,SuperSchool,159,16,143
2025-09-16,14,Preescolar,TopKids,117,3,114
2025-09-16,14,Preescolar,SuperSchool,90,13,77
2025-09-16,14,Preescolar,SuperSchool,273,12,261
2025-09-16,14,Preescolar,EduMax,262,15,247
2025-09-16,14,Preescolar,TopKids,116,2,114
2025-09-16,14,Kínder,EduMax,234,16,218
2025-09-16,14,Kínder,TopKids,144,18,126
2025-09-16,14,Kínder,SuperSchool,207,3,204
2025-09-16,14,Kínder,TopKids,171,23,148
2025-09-16,14,Kínder,EduMax,149,18,131
2025-09-16,14,Kínder,EduMax,291,21,270
2025-09-16,14,Kínder,TopKids,75,7,68
2025-09-16,14,Kínder,SuperSchool,120,22,98
2025-09-16,14,Kínder,SuperSchool,169,4,165
2025-09-16,14,Kínder,SuperSchool,269,15,254
2025-09-16,14,Kínder,SuperSchool,283,10,273
2025-09-16,14,Kínder,SuperSchool,85,19,66
2025-09-16,14,Kínder,EduMax,160,9,151
2025-09-16,14,Kínder,TopKids,277,11,266
2025-09-16,14,Primaria 1°,SuperSchool,242,9,233
2025-09-16,14,Primaria 1°,TopKids,189,10,179
2025-09-16,14,Primaria 1°,SuperSchool,230,20,210
2025-09-16,14,Primaria 1°,SuperSchool,148,18,130
2025-09-16,14,Primaria 1°,TopKids,266,13,253
2025-09-16,14,Primaria 2°,SuperSchool,189,24,165
2025-09-16,14,Primaria 2°,SuperSchool,211,3,208
2025-09-16,14,Primaria 2°,EduMax,134,21,113
2025-09-16,14,Primaria 2°,EduMax,190,12,178
2025-09-16,14,Primaria 2°,EduMax,73,14,59
2025-09-16,14,Primaria 2°,SuperSchool,54,6,48
2025-09-16,14,Primaria 2°,TopKids,283,22,261
2025-09-16,14,Primaria 2°,SuperSchool,145,7,138
2025-09-16,14,Primaria 2°,TopKids,120,11,109
2025-09-16,14,Primaria 2°,TopKids,215,16,199
2025-09-16,14,Primaria 2°,SuperSchool,222,12,210
2025-09-16,14,Primaria 2°,SuperSchool,231,2,229
2025-09-16,14,Primaria 2°,SuperSchool,94,1,93
2025-09-16,14,Primaria 2°,EduMax,235,10,225
2025-09-16,14,Primaria 2°,EduMax,77,11,66
2025-09-16,14,Primaria 2°,SuperSchool,245,17,228
2025-09-16,14,Primaria 3°,EduMax,158,2,156
2025-09-16,14,Primaria 3°,SuperSchool,113,7,106
2025-09-16,14,Primaria 3°,EduMax,219,12,207
2025-09-16,14,Primaria 3°,TopKids,295,20,275
2025-09-16,14,Primaria 3°,TopKids,85,12,73
2025-09-16,14,Primaria 3°,TopKids,153,20,133
2025-09-16,14,Primaria 3°,EduMax,216,3,213
2025-09-16,14,Primaria 4°,SuperSchool,77,19,58
2025-09-16,14,Primaria 4°,EduMax,260,10,250
2025-09-16,14,Primaria 4°,SuperSchool,227,19,208
2025-09-16,14,Primaria 4°,EduMax,222,17,205
2025-09-16,14,Primaria 4°,SuperSchool,137,6,131
2025-09-16,14,Primaria 4°,EduMax,257,18,239
2025-09-16,14,Primaria 4°,SuperSchool,175,13,162
2025-09-16,14,Primaria 4°,SuperSchool,148,4,144
2025-09-16,14,Primaria 4°,TopKids,73,1,72
2025-09-16,14,Primaria 4°,SuperSchool,122,23,99
2025-09-16,14,Primaria 4°,SuperSchool,52,3,49
2025-09-16,14,Primaria 4°,EduMax,195,2,193
2025-09-16,14,Primaria 4°,TopKids,250,2,248
2025-09-16,14,Primaria 4°,TopKids,149,9,140
2025-09-16,14,Primaria 4°,EduMax,68,16,52
2025-09-16,14,Primaria 4°,EduMax,63,15,48
2025-09-16,14,Primaria 5°,TopKids,196,9,187
2025-09-16,14,Primaria 5°,SuperSchool,198,16,182
2025-09-16,14,Primaria 5°,TopKids,207,17,190
2025-09-16,14,Primaria 5°,EduMax,214,9,205
2025-09-16,14,Primaria 5°,EduMax,145,22,123
2025-09-16,14,Primaria 5°,EduMax,265,1,264
2025-09-16,14,Primaria 6°,EduMax,165,3,162
2025-09-16,14,Primaria 6°,SuperSchool,208,13,195
2025-09-16,14,Primaria 6°,SuperSchool,168,11,157
2025-09-16,14,Primaria 6°,SuperSchool,239,3,236
2025-09-16,14,Primaria 6°,EduMax,87,16,71
2025-09-16,14,Primaria 6°,EduMax,241,2,239
2025-09-16,14,Primaria 6°,SuperSchool,260,20,240
2025-09-16,14,Primaria 6°,EduMax,60,23,37
2025-09-16,14,Primaria 6°,EduMax,268,3,265
2025-09-16,14,Primaria 6°,TopKids,94,21,73
2025-09-16,14,Primaria 6°,SuperSchool,144,9,135
2025-09-16,14,Primaria 6°,EduMax,248,1,247
2025-09-16,15,Preescolar,TopKids,52,7,45
2025-09-16,15,Preescolar,EduMax,193,13,180
2025-09-16,15,Preescolar,EduMax,137,17,120
2025-09-16,15,Preescolar,TopKids,78,24,54
2025-09-16,15,Preescolar,SuperSchool,127,5,122
2025-09-16,15,Kínder,EduMax,55,24,31
2025-09-16,15,Kínder,SuperSchool,186,10,176
2025-09-16,15,Kínder,SuperSchool,116,23,93
2025-09-16,15,Kínder,SuperSchool,71,13,58
2025-09-16,15,Kínder,EduMax,143,20,123
2025-09-16,15,Kínder,TopKids,158,6,152
2025-09-16,15,Kínder,EduMax,229,2,227
2025-09-16,15,Kínder,EduMax,144,11,133
2025-09-16,15,Kínder,TopKids,84,11,73
2025-09-16,15,Kínder,SuperSchool,209,17,192
2025-09-16,15,Kínder,TopKids,139,22,117
2025-09-16,15,Kínder,SuperSchool,114,16,98
2025-09-16,15,Kínder,SuperSchool,229,7,222
2025-09-16,15,Kínder,EduMax,231,8,223
2025-09-16,15,Kínder,SuperSchool,206,5,201
2025-09-16,15,Primaria 1°,EduMax,173,18,155
2025-09-16,15,Primaria 1°,TopKids,61,19,42
2025-09-16,15,Primaria 1°,EduMax,185,24,161
2025-09-16,15,Primaria 1°,EduMax,190,8,182
2025-09-16,15,Primaria 1°,EduMax,127,15,112
2025-09-16,15,Primaria 1°,SuperSchool,128,6,122
2025-09-16,15,Primaria 1°,EduMax,87,23,64
2025-09-16,15,Primaria 1°,SuperSchool,187,19,168
2025-09-16,15,Primaria 1°,TopKids,180,23,157
2025-09-16,15,Primaria 1°,EduMax,247,9,238
2025-09-16,15,Primaria 1°,SuperSchool,218,4,214
2025-09-16,15,Primaria 1°,TopKids,180,20,160
2025-09-16,15,Primaria 1°,TopKids,232,11,221
2025-09-16,15,Primaria 1°,TopKids,240,17,223
2025-09-16,15,Primaria 1°,EduMax,118,8,110
2025-09-16,15,Primaria 2°,TopKids,196,16,180
2025-09-16,15,Primaria 2°,EduMax,232,3,229
2025-09-16,15,Primaria 2°,SuperSchool,121,8,113
2025-09-16,15,Primaria 2°,SuperSchool,121,20,101
2025-09-16,15,Primaria 2°,TopKids,95,22,73
2025-09-16,15,Primaria 2°,SuperSchool,221,5,216
2025-09-16,15,Primaria 2°,EduMax,202,15,187
2025-09-16,15,Primaria 2°,TopKids,192,13,179
2025-09-16,15,Primaria 2°,TopKids,93,15,78
2025-09-16,15,Primaria 2°,TopKids,99,23,76
2025-09-16,15,Primaria 2°,SuperSchool,85,11,74
2025-09-16,15,Primaria 2°,EduMax,224,24,200
2025-09-16,15,Primaria 2°,SuperSchool,271,5,266
2025-09-16,15,Primaria 2°,SuperSchool,261,10,251
2025-09-16,15,Primaria 2°,EduMax,91,22,69
2025-09-16,15,Primaria 3°,EduMax,232,6,226
2025-09-16,15,Primaria 3°,TopKids,163,4,159
2025-09-16,15,Primaria 3°,EduMax,188,7,181
2025-09-16,15,Primaria 3°,EduMax,293,2,291
2025-09-16,15,Primaria 3°,TopKids,51,7,44
2025-09-16,15,Primaria 3°,TopKids,144,18,126
2025-09-16,15,Primaria 3°,TopKids,263,20,243
2025-09-16,15,Primaria 3°,SuperSchool,86,2,84
2025-09-16,15,Primaria 3°,EduMax,152,10,142
2025-09-16,15,Primaria 3°,EduMax,177,8,169
2025-09-16,15,Primaria 4°,EduMax,173,9,164
2025-09-16,15,Primaria 4°,EduMax,216,9,207
2025-09-16,15,Primaria 4°,TopKids,186,24,162
2025-09-16,15,Primaria 4°,SuperSchool,184,12,172
2025-09-16,15,Primaria 4°,TopKids,130,20,110
2025-09-16,15,Primaria 4°,SuperSchool,125,22,103
2025-09-16,15,Primaria 4°,TopKids,118,18,100
2025-09-16,15,Primaria 4°,SuperSchool,86,7,79
2025-09-16,15,Primaria 4°,SuperSchool,180,1,179
2025-09-16,15,Primaria 4°,EduMax,173,7,166
2025-09-16,15,Primaria 4°,TopKids,235,8,227
2025-09-16,15,Primaria 5°,TopKids,192,7,185
2025-09-16,15,Primaria 5°,TopKids,210,9,201
2025-09-16,15,Primaria 5°,SuperSchool,184,20,164
2025-09-16,15,Primaria 5°,TopKids,227,14,213
2025-09-16,15,Primaria 5°,EduMax,192,18,174
2025-09-16,15,Primaria 5°,EduMax,276,11,265
2025-09-16,15,Primaria 5°,SuperSchool,232,2,230
2025-09-16,15,Primaria 5°,TopKids,237,17,220
2025-09-16,15,Primaria 5°,TopKids,124,4,120
2025-09-16,15,Primaria 5°,EduMax,216,22,194
2025-09-16,15,Primaria 5°,SuperSchool,188,4,184
2025-09-16,15,Primaria 5°,SuperSchool,276,22,254
2025-09-16,15,Primaria 5°,TopKids,161,2,159
2025-09-16,15,Primaria 5°,SuperSchool,138,18,120
2025-09-16,15,Primaria 5°,TopKids,77,2,75
2025-09-16,15,Primaria 5°,EduMax,135,22,113
2025-09-16,15,Primaria 5°,SuperSchool,79,2,77
2025-09-16,15,Primaria 5°,SuperSchool,270,19,251
2025-09-16,15,Primaria 6°,SuperSchool,229,9,220
2025-09-16,15,Primaria 6°,SuperSchool,284,1,283
2025-09-16,15,Primaria 6°,TopKids,130,6,124
2025-09-16,15,Primaria 6°,SuperSchool,227,9,218
2025-09-16,15,Primaria 6°,TopKids,82,4,78
2025-09-16,15,Primaria 6°,EduMax,131,17,114
2025-09-16,15,Primaria 6°,TopKids,232,23,209
2025-09-16,16,Preescolar,EduMax,139,7,132
2025-09-16,16,Preescolar,SuperSchool,106,20,86
2025-09-16,16,Preescolar,SuperSchool,288,11,277
2025-09-16,16,Preescolar,TopKids,87,9,78
2025-09-16,16,Preescolar,SuperSchool,215,17,198
2025-09-16,16,Preescolar,EduMax,202,14,188
2025-09-16,16,Preescolar,SuperSchool,227,8,219
2025-09-16,16,Preescolar,EduMax,252,22,230
2025-09-16,16,Preescolar,SuperSchool,212,2,210
2025-09-16,16,Preescolar,EduMax,172,14,158
2025-09-16,16,Preescolar,SuperSchool,162,21,141
2025-09-16,16,Preescolar,EduMax,282,21,261
2025-09-16,16,Preescolar,EduMax,235,9,226
2025-09-16,16,Preescolar,TopKids,141,4,137
2025-09-16,16,Preescolar,EduMax,95,20,75
2025-09-16,16,Preescolar,EduMax,277,8,269
2025-09-16,16,Kínder,SuperSchool,256,15,241
2025-09-16,16,Kínder,EduMax,117,22,95
2025-09-16,16,Kínder,SuperSchool,250,23,227
2025-09-16,16,Kínder,EduMax,88,24,64
2025-09-16,16,Kínder,EduMax,171,12,159
2025-09-16,16,Kínder,EduMax,184,6,178
2025-09-16,16,Kínder,TopKids,231,19,212
2025-09-16,16,Kínder,SuperSchool,68,22,46
2025-09-16,16,Kínder,TopKids,68,12,56
2025-09-16,16,Kínder,EduMax,220,13,207
2025-09-16,16,Kínder,SuperSchool,146,24,122
2025-09-16,16,Primaria 1°,EduMax,159,18,141
2025-09-16,16,Primaria 1°,TopKids,60,19,41
2025-09-16,16,Primaria 1°,SuperSchool,226,2,224
2025-09-16,16,Primaria 1°,EduMax,79,13,66
2025-09-16,16,Primaria 1°,EduMax,64,11,53
2025-09-16,16,Primaria 1°,TopKids,270,14,256
2025-09-16,16,Primaria 1°,EduMax,130,8,122
2025-09-16,16,Primaria 1°,SuperSchool,264,15,249
2025-09-16,16,Primaria 1°,TopKids,129,18,111
2025-09-16,16,Primaria 2°,TopKids,125,6,119
2025-09-16,16,Primaria 2°,TopKids,215,4,211
2025-09-16,16,Primaria 2°,SuperSchool,239,24,215
2025-09-16,16,Primaria 2°,SuperSchool,139,17,122
2025-09-16,16,Primaria 2°,SuperSchool,278,9,269
2025-09-16,16,Primaria 2°,SuperSchool,151,12,139
2025-09-16,16,Primaria 2°,SuperSchool,107,21,86
2025-09-16,16,Primaria 2°,EduMax,275,1,274
2025-09-16,16,Primaria 2°,SuperSchool,230,21,209
2025-09-16,16,Primaria 2°,SuperSchool,254,23,231
2025-09-16,16,Primaria 2°,TopKids,252,22,230
2025-09-16,16,Primaria 2°,EduMax,239,2,237
2025-09-16,16,Primaria 2°,EduMax,290,1,289
2025-09-16,16,Primaria 2°,TopKids,165,21,144
2025-09-16,16,Primaria 2°,EduMax,70,5,65
2025-09-16,16,Primaria 2°,EduMax,197,9,188
2025-09-16,16,Primaria 3°,SuperSchool,177,4,173
2025-09-16,16,Primaria 3°,SuperSchool,118,8,110
2025-09-16,16,Primaria 3°,SuperSchool,256,20,236
2025-09-16,16,Primaria 3°,SuperSchool,160,4,156
2025-09-16,16,Primaria 3°,EduMax,228,24,204
2025-09-16,16,Primaria 3°,EduMax,210,2,208
2025-09-16,16,Primaria 3°,TopKids,78,22,56
2025-09-16,16,Primaria 3°,TopKids,289,23,266
2025-09-16,16,Primaria 3°,TopKids,297,6,291
2025-09-16,16,Primaria 4°,TopKids,125,5,120
2025-09-16,16,Primaria 4°,SuperSchool,52,4,48
2025-09-16,16,Primaria 4°,TopKids,265,5,260
2025-09-16,16,Primaria 4°,SuperSchool,272,3,269
2025-09-16,16,Primaria 4°,EduMax,132,24,108
2025-09-16,16,Primaria 4°,TopKids,215,23,192
2025-09-16,16,Primaria 4°,TopKids,87,13,74
2025-09-16,16,Primaria 4°,SuperSchool,234,21,213
2025-09-16,16,Primaria 4°,SuperSchool,183,10,173
2025-09-16,16,Primaria 4°,TopKids,165,10,155
2025-09-16,16,Primaria 4°,SuperSchool,141,16,125
2025-09-16,16,Primaria 4°,EduMax,108,3,105
2025-09-16,16,Primaria 5°,SuperSchool,166,3,163
2025-09-16,16,Primaria 5°,EduMax,68,1,67
2025-09-16,16,Primaria 5°,EduMax,68,4,64
2025-09-16,16,Primaria 5°,SuperSchool,246,2,244
2025-09-16,16,Primaria 5°,TopKids,279,7,272
2025-09-16,16,Primaria 5°,TopKids,91,10,81
2025-09-16,16,Primaria 5°,TopKids,137,16,121
2025-09-16,16,Primaria 5°,TopKids,71,23,48
2025-09-16,16,Primaria 5°,SuperSchool,73,8,65
2025-09-16,16,Primaria 5°,TopKids,82,17,65
2025-09-16,16,Primaria 5°,EduMax,131,24,107
2025-09-16,16,Primaria 5°,EduMax,128,6,122
2025-09-16,16,Primaria 5°,TopKids,71,17,54
2025-09-16,16,Primaria 6°,SuperSchool,260,2,258
2025-09-16,16,Primaria 6°,EduMax,138,7,131
2025-09-16,16,Primaria 6°,SuperSchool,288,16,272
2025-09-16,16,Primaria 6°,TopKids,226,3,223
2025-09-16,16,Primaria 6°,EduMax,112,6,106
2025-09-16,16,Primaria 6°,SuperSchool,179,11,168
2025-09-17,9,Preescolar,EduMax,61,20,41
2025-09-17,9,Preescolar,TopKids,195,5,190
2025-09-17,9,Preescolar,EduMax,286,2,284
2025-09-17,9,Preescolar,TopKids,235,8,227
2025-09-17,9,Preescolar,TopKids,230,16,214
2025-09-17,9,Preescolar,EduMax,242,16,226
2025-09-17,9,Preescolar,SuperSchool,186,6,180
2025-09-17,9,Preescolar,TopKids,62,17,45
2025-09-17,9,Preescolar,EduMax,92,14,78
2025-09-17,9,Preescolar,SuperSchool,272,16,256
2025-09-17,9,Preescolar,SuperSchool,67,11,56
2025-09-17,9,Preescolar,EduMax,205,21,184
2025-09-17,9,Kínder,EduMax,202,6,196
2025-09-17,9,Kínder,EduMax,188,1,187
2025-09-17,9,Kínder,SuperSchool,275,11,264
2025-09-17,9,Kínder,EduMax,137,13,124
2025-09-17,9,Kínder,TopKids,284,6,278
2025-09-17,9,Kínder,EduMax,100,9,91
2025-09-17,9,Kínder,TopKids,227,14,213
2025-09-17,9,Kínder,SuperSchool,269,12,257
2025-09-17,9,Kínder,SuperSchool,248,16,232
2025-09-17,9,Primaria 1°,SuperSchool,63,9,54
2025-09-17,9,Primaria 1°,EduMax,171,1,170
2025-09-17,9,Primaria 1°,EduMax,234,23,211
2025-09-17,9,Primaria 1°,TopKids,274,19,255
2025-09-17,9,Primaria 1°,EduMax,224,17,207
2025-09-17,9,Primaria 2°,EduMax,111,22,89
2025-09-17,9,Primaria 2°,TopKids,168,12,156
2025-09-17,9,Primaria 2°,TopKids,163,13,150
2025-09-17,9,Primaria 2°,TopKids,54,22,32
2025-09-17,9,Primaria 2°,SuperSchool,141,21,120
2025-09-17,9,Primaria 2°,TopKids,196,6,190
2025-09-17,9,Primaria 2°,TopKids,258,5,253
2025-09-17,9,Primaria 2°,SuperSchool,150,19,131
2025-09-17,9,Primaria 3°,TopKids,242,13,229
2025-09-17,9,Primaria 3°,SuperSchool,220,18,202
2025-09-17,9,Primaria 3°,EduMax,234,10,224
2025-09-17,9,Primaria 3°,TopKids,203,11,192
2025-09-17,9,Primaria 3°,EduMax,274,4,270
2025-09-17,9,Primaria 3°,SuperSchool,147,22,125
2025-09-17,9,Primaria 3°,TopKids,109,21,88
2025-09-17,9,Primaria 3°,TopKids,238,21,217
2025-09-17,9,Primaria 3°,TopKids,102,13,89
2025-09-17,9,Primaria 3°,EduMax,284,8,276
2025-09-17,9,Primaria 4°,TopKids,130,9,121
2025-09-17,9,Primaria 4°,TopKids,62,22,40
2025-09-17,9,Primaria 4°,TopKids,76,13,63
2025-09-17,9,Primaria 4°,TopKids,89,12,77
2025-09-17,9,Primaria 4°,TopKids,101,13,88
2025-09-17,9,Primaria 5°,EduMax,97,18,79
2025-09-17,9,Primaria 5°,SuperSchool,288,7,281
2025-09-17,9,Primaria 5°,EduMax,56,6,50
2025-09-17,9,Primaria 5°,EduMax,102,1,101
2025-09-17,9,Primaria 5°,EduMax,78,5,73
2025-09-17,9,Primaria 5°,SuperSchool,152,15,137
2025-09-17,9,Primaria 6°,TopKids,151,2,149
2025-09-17,9,Primaria 6°,SuperSchool,265,17,248
2025-09-17,9,Primaria 6°,TopKids,190,13,177
2025-09-17,9,Primaria 6°,EduMax,171,23,148
2025-09-17,9,Primaria 6°,TopKids,124,13,111
2025-09-17,9,Primaria 6°,SuperSchool,69,1,68
2025-09-17,9,Primaria 6°,SuperSchool,115,11,104
2025-09-17,9,Primaria 6°,EduMax,79,5,74
2025-09-17,9,Primaria 6°,TopKids,201,16,185
2025-09-17,10,Preescolar,TopKids,299,15,284
2025-09-17,10,Preescolar,EduMax,178,7,171
2025-09-17,10,Preescolar,SuperSchool,75,11,64
2025-09-17,10,Preescolar,TopKids,170,17,153
2025-09-17,10,Preescolar,EduMax,50,15,35
2025-09-17,10,Preescolar,TopKids,104,21,83
2025-09-17,10,Preescolar,EduMax,138,18,120
2025-09-17,10,Preescolar,SuperSchool,213,19,194
2025-09-17,10,Preescolar,SuperSchool,223,23,200
2025-09-17,10,Preescolar,SuperSchool,204,19,185
2025-09-17,10,Preescolar,TopKids,65,22,43
2025-09-17,10,Preescolar,SuperSchool,292,1,291
2025-09-17,10,Preescolar,EduMax,144,2,142
2025-09-17,10,Preescolar,TopKids,228,4,224
2025-09-17,10,Preescolar,TopKids,230,4,226
2025-09-17,10,Preescolar,SuperSchool,230,19,211
2025-09-17,10,Preescolar,TopKids,233,9,224
2025-09-17,10,Preescolar,SuperSchool,103,16,87
2025-09-17,10,Kínder,SuperSchool,228,18,210
2025-09-17,10,Kínder,SuperSchool,184,16,168
2025-09-17,10,Kínder,TopKids,104,11,93
2025-09-17,10,Kínder,EduMax,212,14,198
2025-09-17,10,Kínder,EduMax,240,17,223
2025-09-17,10,Kínder,TopKids,67,20,47
2025-09-17,10,Kínder,TopKids,272,6,266
2025-09-17,10,Kínder,EduMax,239,17,222
2025-09-17,10,Kínder,SuperSchool,230,16,214
2025-09-17,10,Kínder,SuperSchool,208,16,192
2025-09-17,10,Kínder,SuperSchool,70,9,61
2025-09-17,10,Kínder,TopKids,86,9,77
2025-09-17,10,Kínder,SuperSchool,123,21,102
2025-09-17,10,Kínder,SuperSchool,152,21,131
2025-09-17,10,Kínder,SuperSchool,151,6,145
2025-09-17,10,Kínder,TopKids,141,15,126
2025-09-17,10,Kínder,SuperSchool,251,3,248
2025-09-17,10,Kínder,EduMax,289,1,288
2025-09-17,10,Kínder,EduMax,54,16,38
2025-09-17,10,Primaria 1°,EduMax,106,11,95
2025-09-17,10,Primaria 1°,EduMax,120,8,112
2025-09-17,10,Primaria 1°,SuperSchool,271,14,257
2025-09-17,10,Primaria 1°,SuperSchool,157,18,139
2025-09-17,10,Primaria 1°,SuperSchool,201,7,194
2025-09-17,10,Primaria 1°,EduMax,128,18,110
2025-09-17,10,Primaria 1°,TopKids,138,17,121
2025-09-17,10,Primaria 1°,SuperSchool,179,7,172
2025-09-17,10,Primaria 1°,EduMax,191,12,179
2025-09-17,10,Primaria 2°,EduMax,228,10,218
2025-09-17,10,Primaria 2°,TopKids,89,13,76
2025-09-17,10,Primaria 2°,EduMax,281,5,276
2025-09-17,10,Primaria 2°,SuperSchool,235,11,224
2025-09-17,10,Primaria 2°,SuperSchool,146,7,139
2025-09-17,10,Primaria 3°,EduMax,194,17,177
2025-09-17,10,Primaria 3°,EduMax,131,21,110
2025-09-17,10,Primaria 3°,TopKids,192,13,179
2025-09-17,10,Primaria 3°,SuperSchool,197,14,183
2025-09-17,10,Primaria 3°,TopKids,224,3,221
2025-09-17,10,Primaria 3°,EduMax,90,14,76
2025-09-17,10,Primaria 3°,SuperSchool,257,17,240
2025-09-17,10,Primaria 3°,SuperSchool,273,11,262
2025-09-17,10,Primaria 3°,EduMax,284,8,276
2025-09-17,10,Primaria 3°,EduMax,119,7,112
2025-09-17,10,Primaria 4°,EduMax,69,6,63
2025-09-17,10,Primaria 4°,SuperSchool,62,17,45
2025-09-17,10,Primaria 4°,SuperSchool,108,20,88
2025-09-17,10,Primaria 4°,TopKids,273,11,262
2025-09-17,10,Primaria 4°,SuperSchool,212,17,195
2025-09-17,10,Primaria 4°,SuperSchool,247,18,229
2025-09-17,10,Primaria 4°,SuperSchool,279,6,273
2025-09-17,10,Primaria 4°,EduMax,91,11,80
2025-09-17,10,Primaria 4°,EduMax,253,20,233
2025-09-17,10,Primaria 4°,EduMax,201,22,179
2025-09-17,10,Primaria 5°,TopKids,272,10,262
2025-09-17,10,Primaria 5°,SuperSchool,64,22,42
2025-09-17,10,Primaria 5°,EduMax,229,2,227
2025-09-17,10,Primaria 5°,TopKids,201,14,187
2025-09-17,10,Primaria 5°,TopKids,95,13,82
2025-09-17,10,Primaria 5°,SuperSchool,155,14,141
2025-09-17,10,Primaria 5°,SuperSchool,171,16,155
2025-09-17,10,Primaria 5°,TopKids,156,23,133
2025-09-17,10,Primaria 5°,TopKids,61,1,60
2025-09-17,10,Primaria 5°,TopKids,124,21,103
2025-09-17,10,Primaria 5°,TopKids,182,15,167
2025-09-17,10,Primaria 5°,TopKids,176,20,156
2025-09-17,10,Primaria 5°,TopKids,153,16,137
2025-09-17,10,Primaria 5°,EduMax,117,15,102
2025-09-17,10,Primaria 5°,TopKids,75,15,60
2025-09-17,10,Primaria 5°,SuperSchool,59,2,57
2025-09-17,10,Primaria 5°,EduMax,290,8,282
2025-09-17,10,Primaria 5°,SuperSchool,81,21,60
2025-09-17,10,Primaria 5°,SuperSchool,232,12,220
2025-09-17,10,Primaria 6°,TopKids,123,6,117
2025-09-17,10,Primaria 6°,SuperSchool,259,16,243
2025-09-17,10,Primaria 6°,TopKids,276,3,273
2025-09-17,10,Primaria 6°,SuperSchool,147,1,146
2025-09-17,10,Primaria 6°,EduMax,286,3,283
2025-09-17,10,Primaria 6°,TopKids,180,10,170
2025-09-17,10,Primaria 6°,TopKids,231,9,222
2025-09-17,10,Primaria 6°,EduMax,206,10,196
2025-09-17,10,Primaria 6°,TopKids,240,13,227
2025-09-17,10,Primaria 6°,EduMax,145,18,127
2025-09-17,10,Primaria 6°,SuperSchool,259,22,237
2025-09-17,11,Preescolar,SuperSchool,266,5,261
2025-09-17,11,Preescolar,SuperSchool,93,12,81
2025-09-17,11,Preescolar,SuperSchool,170,24,146
2025-09-17,11,Preescolar,TopKids,56,20,36
2025-09-17,11,Preescolar,TopKids,157,9,148
2025-09-17,11,Kínder,EduMax,196,21,175
2025-09-17,11,Kínder,TopKids,113,11,102
2025-09-17,11,Kínder,SuperSchool,66,7,59
2025-09-17,11,Kínder,SuperSchool,148,7,141
2025-09-17,11,Kínder,TopKids,236,14,222
2025-09-17,11,Kínder,EduMax,65,21,44
2025-09-17,11,Kínder,EduMax,255,7,248
2025-09-17,11,Kínder,EduMax,299,10,289
2025-09-17,11,Kínder,EduMax,268,13,255
2025-09-17,11,Kínder,EduMax,51,10,41
2025-09-17,11,Kínder,EduMax,258,19,239
2025-09-17,11,Kínder,SuperSchool,215,4,211
2025-09-17,11,Primaria 1°,SuperSchool,160,23,137
2025-09-17,11,Primaria 1°,TopKids,297,16,281
2025-09-17,11,Primaria 1°,TopKids,158,1,157
2025-09-17,11,Primaria 1°,TopKids,222,1,221
2025-09-17,11,Primaria 1°,EduMax,178,12,166
2025-09-17,11,Primaria 1°,SuperSchool,136,24,112
2025-09-17,11,Primaria 2°,EduMax,210,5,205
2025-09-17,11,Primaria 2°,TopKids,179,4,175
2025-09-17,11,Primaria 2°,TopKids,159,9,150
2025-09-17,11,Primaria 2°,EduMax,264,24,240
2025-09-17,11,Primaria 2°,SuperSchool,218,15,203
2025-09-17,11,Primaria 2°,EduMax,59,2,57
2025-09-17,11,Primaria 2°,SuperSchool,208,23,185
2025-09-17,11,Primaria 2°,EduMax,56,9,47
2025-09-17,11,Primaria 2°,SuperSchool,262,18,244
2025-09-17,11,Primaria 2°,SuperSchool,116,13,103
2025-09-17,11,Primaria 2°,EduMax,194,3,191
2025-09-17,11,Primaria 2°,SuperSchool,250,17,233
2025-09-17,11,Primaria 2°,EduMax,77,18,59
2025-09-17,11,Primaria 2°,EduMax,107,6,101
2025-09-17,11,Primaria 3°,SuperSchool,59,2,57
2025-09-17,11,Primaria 3°,SuperSchool,284,6,278
2025-09-17,11,Primaria 3°,SuperSchool,129,9,120
2025-09-17,11,Primaria 3°,SuperSchool,62,7,55
2025-09-17,11,Primaria 3°,SuperSchool,50,3,47
2025-09-17,11,Primaria 4°,TopKids,105,19,86
2025-09-17,11,Primaria 4°,SuperSchool,77,12,65
2025-09-17,11,Primaria 4°,EduMax,85,21,64
2025-09-17,11,Primaria 4°,EduMax,171,4,167
2025-09-17,11,Primaria 4°,TopKids,252,4,248
2025-09-17,11,Primaria 4°,TopKids,290,21,269
2025-09-17,11,Primaria 4°,EduMax,293,20,273
2025-09-17,11,Primaria 4°,SuperSchool,194,13,181
2025-09-17,11,Primaria 4°,SuperSchool,228,20,208
2025-09-17,11,Primaria 4°,TopKids,181,18,163
2025-09-17,11,Primaria 4°,TopKids,58,16,42
2025-09-17,11,Primaria 4°,TopKids,268,18,250
2025-09-17,11,Primaria 5°,EduMax,234,5,229
2025-09-17,11,Primaria 5°,SuperSchool,224,20,204
2025-09-17,11,Primaria 5°,EduMax,182,24,158
2025-09-17,11,Primaria 5°,TopKids,247,8,239
2025-09-17,11,Primaria 5°,TopKids,84,5,79
2025-09-17,11,Primaria 6°,TopKids,268,12,256
2025-09-17,11,Primaria 6°,TopKids,152,1,151
2025-09-17,11,Primaria 6°,SuperSchool,51,19,32
2025-09-17,11,Primaria 6°,SuperSchool,293,18,275
2025-09-17,11,Primaria 6°,EduMax,222,5,217
2025-09-17,11,Primaria 6°,TopKids,222,9,213
2025-09-17,12,Preescolar,EduMax,110,22,88
2025-09-17,12,Preescolar,EduMax,242,18,224
2025-09-17,12,Preescolar,TopKids,161,8,153
2025-09-17,12,Preescolar,EduMax,222,17,205
2025-09-17,12,Preescolar,EduMax,190,10,180
2025-09-17,12,Kínder,EduMax,267,23,244
2025-09-17,12,Kínder,EduMax,172,20,152
2025-09-17,12,Kínder,TopKids,94,15,79
2025-09-17,12,Kínder,EduMax,188,8,180
2025-09-17,12,Kínder,EduMax,177,13,164
2025-09-17,12,Kínder,EduMax,211,1,210
2025-09-17,12,Kínder,SuperSchool,273,11,262
2025-09-17,12,Kínder,EduMax,143,12,131
2025-09-17,12,Kínder,EduMax,282,2,280
2025-09-17,12,Kínder,TopKids,266,4,262
2025-09-17,12,Kínder,EduMax,198,6,192
2025-09-17,12,Kínder,TopKids,138,22,116
2025-09-17,12,Kínder,EduMax,68,2,66
2025-09-17,12,Kínder,EduMax,143,19,124
2025-09-17,12,Kínder,TopKids,72,4,68
2025-09-17,12,Primaria 1°,EduMax,247,6,241
2025-09-17,12,Primaria 1°,SuperSchool,214,7,207
2025-09-17,12,Primaria 1°,SuperSchool,50,24,26
2025-09-17,12,Primaria 1°,EduMax,229,10,219
2025-09-17,12,Primaria 1°,TopKids,237,6,231
2025-09-17,12,Primaria 1°,EduMax,174,16,158
2025-09-17,12,Primaria 1°,TopKids,94,12,82
2025-09-17,12,Primaria 1°,TopKids,160,6,154
2025-09-17,12,Primaria 1°,SuperSchool,198,14,184
2025-09-17,12,Primaria 1°,TopKids,288,23,265
2025-09-17,12,Primaria 1°,TopKids,263,4,259
2025-09-17,12,Primaria 1°,TopKids,150,23,127
2025-09-17,12,Primaria 1°,TopKids,204,2,202
2025-09-17,12,Primaria 1°,TopKids,91,4,87
2025-09-17,12,Primaria 1°,SuperSchool,232,8,224
2025-09-17,12,Primaria 1°,TopKids,98,7,91
2025-09-17,12,Primaria 2°,EduMax,283,1,282
2025-09-17,12,Primaria 2°,EduMax,145,8,137
2025-09-17,12,Primaria 2°,SuperSchool,254,7,247
2025-09-17,12,Primaria 2°,TopKids,188,12,176
2025-09-17,12,Primaria 2°,EduMax,221,1,220
2025-09-17,12,Primaria 2°,EduMax,80,11,69
2025-09-17,12,Primaria 2°,TopKids,61,1,60
2025-09-17,12,Primaria 2°,EduMax,270,23,247
2025-09-17,12,Primaria 2°,SuperSchool,271,12,259
2025-09-17,12,Primaria 2°,EduMax,251,23,228
2025-09-17,12,Primaria 2°,TopKids,251,18,233
2025-09-17,12,Primaria 2°,EduMax,233,8,225
2025-09-17,12,Primaria 2°,TopKids,154,16,138
2025-09-17,12,Primaria 2°,EduMax,113,11,102
2025-09-17,12,Primaria 2°,TopKids,53,3,50
2025-09-17,12,Primaria 3°,TopKids,130,9,121
2025-09-17,12,Primaria 3°,SuperSchool,114,8,106
2025-09-17,12,Primaria 3°,EduMax,232,13,219
2025-09-17,12,Primaria 3°,SuperSchool,71,10,61
2025-09-17,12,Primaria 3°,TopKids,60,10,50
2025-09-17,12,Primaria 3°,EduMax,127,8,119
2025-09-17,12,Primaria 3°,TopKids,71,9,62
2025-09-17,12,Primaria 3°,TopKids,274,19,255
2025-09-17,12,Primaria 3°,TopKids,67,12,55
2025-09-17,12,Primaria 3°,EduMax,150,13,137
2025-09-17,12,Primaria 3°,SuperSchool,178,2,176
2025-09-17,12,Primaria 3°,TopKids,179,22,157
2025-09-17,12,Primaria 3°,SuperSchool,223,20,203
2025-09-17,12,Primaria 3°,TopKids,58,18,40
2025-09-17,12,Primaria 3°,SuperSchool,65,19,46
2025-09-17,12,Primaria 3°,SuperSchool,132,6,126
2025-09-17,12,Primaria 3°,TopKids,166,6,160
2025-09-17,12,Primaria 3°,SuperSchool,270,14,256
2025-09-17,12,Primaria 3°,TopKids,292,18,274
2025-09-17,12,Primaria 4°,SuperSchool,218,20,198
2025-09-17,12,Primaria 4°,EduMax,77,22,55
2025-09-17,12,Primaria 4°,SuperSchool,102,7,95
2025-09-17,12,Primaria 4°,EduMax,102,12,90
2025-09-17,12,Primaria 4°,SuperSchool,275,3,272
2025-09-17,12,Primaria 4°,SuperSchool,163,14,149
2025-09-17,12,Primaria 4°,EduMax,203,19,184
2025-09-17,12,Primaria 4°,SuperSchool,150,10,140
2025-09-17,12,Primaria 4°,SuperSchool,229,1,228
2025-09-17,12,Primaria 4°,SuperSchool,245,5,240
2025-09-17,12,Primaria 4°,TopKids,255,24,231
2025-09-17,12,Primaria 4°,TopKids,156,24,132
2025-09-17,12,Primaria 4°,SuperSchool,173,7,166
2025-09-17,12,Primaria 4°,SuperSchool,133,6,127
2025-09-17,12,Primaria 5°,SuperSchool,54,17,37
2025-09-17,12,Primaria 5°,EduMax,187,16,171
2025-09-17,12,Primaria 5°,SuperSchool,230,14,216
2025-09-17,12,Primaria 5°,EduMax,78,22,56
2025-09-17,12,Primaria 5°,SuperSchool,194,5,189
2025-09-17,12,Primaria 5°,EduMax,85,18,67
2025-09-17,12,Primaria 5°,EduMax,94,7,87
2025-09-17,12,Primaria 5°,SuperSchool,213,5,208
2025-09-17,12,Primaria 6°,SuperSchool,138,18,120
2025-09-17,12,Primaria 6°,TopKids,159,15,144
2025-09-17,12,Primaria 6°,SuperSchool,164,1,163
2025-09-17,12,Primaria 6°,EduMax,185,4,181
2025-09-17,12,Primaria 6°,TopKids,213,11,202
2025-09-17,12,Primaria 6°,TopKids,251,17,234
2025-09-17,12,Primaria 6°,SuperSchool,283,8,275
2025-09-17,12,Primaria 6°,EduMax,191,13,178
2025-09-17,12,Primaria 6°,TopKids,159,14,145
2025-09-17,12,Primaria 6°,TopKids,142,16,126
2025-09-17,12,Primaria 6°,EduMax,117,20,97
2025-09-17,12,Primaria 6°,EduMax,117,2,115
2025-09-17,12,Primaria 6°,TopKids,256,11,245
2025-09-17,12,Primaria 6°,TopKids,294,23,271
2025-09-17,12,Primaria 6°,EduMax,291,18,273
2025-09-17,12,Primaria 6°,SuperSchool,286,1,285
2025-09-17,12,Primaria 6°,SuperSchool,294,5,289
2025-09-17,12,Primaria 6°,TopKids,226,16,210
2025-09-17,12,Primaria 6°,SuperSchool,259,10,249
2025-09-17,13,Preescolar,TopKids,192,19,173
2025-09-17,13,Preescolar,TopKids,58,21,37
2025-09-17,13,Preescolar,SuperSchool,278,10,268
2025-09-17,13,Preescolar,SuperSchool,274,21,253
2025-09-17,13,Preescolar,EduMax,119,3,116
2025-09-17,13,Kínder,TopKids,220,8,212
2025-09-17,13,Kínder,SuperSchool,253,11,242
2025-09-17,13,Kínder,EduMax,278,8,270
2025-09-17,13,Kínder,EduMax,215,9,206
2025-09-17,13,Kínder,SuperSchool,98,2,96
2025-09-17,13,Primaria 1°,EduMax,52,14,38
2025-09-17,13,Primaria 1°,SuperSchool,211,22,189
2025-09-17,13,Primaria 1°,TopKids,86,10,76
2025-09-17,13,Primaria 1°,SuperSchool,99,3,96
2025-09-17,13,Primaria 1°,EduMax,155,17,138
2025-09-17,13,Primaria 2°,EduMax,162,3,159
2025-09-17,13,Primaria 2°,TopKids,158,23,135
2025-09-17,13,Primaria 2°,SuperSchool,138,23,115
2025-09-17,13,Primaria 2°,TopKids,282,24,258
2025-09-17,13,Primaria 2°,SuperSchool,61,3,58
2025-09-17,13,Primaria 2°,TopKids,122,16,106
2025-09-17,13,Primaria 2°,SuperSchool,81,19,62
2025-09-17,13,Primaria 2°,EduMax,222,2,220
2025-09-17,13,Primaria 2°,TopKids,291,12,279
2025-09-17,13,Primaria 2°,EduMax,54,20,34
2025-09-17,13,Primaria 2°,TopKids,69,8,61
2025-09-17,13,Primaria 2°,EduMax,231,16,215
2025-09-17,13,Primaria 2°,EduMax,243,13,230
2025-09-17,13,Primaria 2°,SuperSchool,54,23,31
2025-09-17,13,Primaria 2°,SuperSchool,189,4,185
2025-09-17,13,Primaria 2°,SuperSchool,124,10,114
2025-09-17,13,Primaria 2°,SuperSchool,186,7,179
2025-09-17,13,Primaria 2°,TopKids,270,14,256
2025-09-17,13,Primaria 2°,TopKids,239,18,221
2025-09-17,13,Primaria 3°,EduMax,295,8,287
2025-09-17,13,Primaria 3°,EduMax,263,21,242
2025-09-17,13,Primaria 3°,TopKids,152,5,147
2025-09-17,13,Primaria 3°,EduMax,255,3,252
2025-09-17,13,Primaria 3°,EduMax,200,17,183
2025-09-17,13,Primaria 3°,SuperSchool,101,24,77
2025-09-17,13,Primaria 3°,TopKids,174,15,159
2025-09-17,13,Primaria 3°,SuperSchool,100,2,98
2025-09-17,13,Primaria 3°,SuperSchool,217,9,208
2025-09-17,13,Primaria 3°,SuperSchool,84,12,72
2025-09-17,13,Primaria 3°,TopKids,297,19,278
2025-09-17,13,Primaria 3°,SuperSchool,299,16,283
2025-09-17,13,Primaria 3°,TopKids,274,17,257
2025-09-17,13,Primaria 4°,TopKids,290,23,267
2025-09-17,13,Primaria 4°,SuperSchool,193,6,187
2025-09-17,13,Primaria 4°,EduMax,99,14,85
2025-09-17,13,Primaria 4°,TopKids,154,21,133
2025-09-17,13,Primaria 4°,EduMax,163,1,162
2025-09-17,13,Primaria 4°,SuperSchool,194,4,190
2025-09-17,13,Primaria 4°,EduMax,157,13,144
2025-09-17,13,Primaria 4°,EduMax,263,12,251
2025-09-17,13,Primaria 4°,EduMax,270,15,255
2025-09-17,13,Primaria 5°,SuperSchool,153,21,132
2025-09-17,13,Primaria 5°,SuperSchool,291,6,285
2025-09-17,13,Primaria 5°,TopKids,82,14,68
2025-09-17,13,Primaria 5°,EduMax,85,18,67
2025-09-17,13,Primaria 5°,TopKids,100,8,92
2025-09-17,13,Primaria 5°,EduMax,286,7,279
2025-09-17,13,Primaria 5°,SuperSchool,107,12,95
2025-09-17,13,Primaria 5°,EduMax,200,7,193
2025-09-17,13,Primaria 5°,SuperSchool,159,23,136
2025-09-17,13,Primaria 6°,TopKids,254,6,248
2025-09-17,13,Primaria 6°,TopKids,158,22,136
2025-09-17,13,Primaria 6°,SuperSchool,60,10,50
2025-09-17,13,Primaria 6°,TopKids,196,7,189
2025-09-17,13,Primaria 6°,TopKids,278,24,254
2025-09-17,13,Primaria 6°,TopKids,288,2,286
2025-09-17,13,Primaria 6°,TopKids,279,5,274
2025-09-17,13,Primaria 6°,TopKids,213,5,208
2025-09-17,13,Primaria 6°,SuperSchool,76,10,66
2025-09-17,13,Primaria 6°,EduMax,147,15,132
2025-09-17,13,Primaria 6°,SuperSchool,147,3,144
2025-09-17,13,Primaria 6°,EduMax,69,24,45
2025-09-17,13,Primaria 6°,EduMax,176,2,174
2025-09-17,13,Primaria 6°,TopKids,223,18,205
2025-09-17,13,Primaria 6°,SuperSchool,274,7,267
2025-09-17,13,Primaria 6°,TopKids,266,7,259
2025-09-17,14,Preescolar,EduMax,235,10,225
2025-09-17,14,Preescolar,EduMax,87,24,63
2025-09-17,14,Preescolar,EduMax,108,13,95
2025-09-17,14,Preescolar,EduMax,271,12,259
2025-09-17,14,Preescolar,TopKids,242,1,241
2025-09-17,14,Preescolar,TopKids,227,22,205
2025-09-17,14,Kínder,EduMax,65,1,64
2025-09-17,14,Kínder,SuperSchool,205,15,190
2025-09-17,14,Kínder,EduMax,81,7,74
2025-09-17,14,Kínder,SuperSchool,289,9,280
2025-09-17,14,Kínder,SuperSchool,138,11,127
2025-09-17,14,Kínder,EduMax,283,11,272
2025-09-17,14,Primaria 1°,EduMax,99,12,87
2025-09-17,14,Primaria 1°,EduMax,121,4,117
2025-09-17,14,Primaria 1°,EduMax,144,21,123
2025-09-17,14,Primaria 1°,SuperSchool,209,23,186
2025-09-17,14,Primaria 1°,EduMax,293,15,278
2025-09-17,14,Primaria 1°,TopKids,173,14,159
2025-09-17,14,Primaria 1°,EduMax,96,6,90
2025-09-17,14,Primaria 1°,TopKids,243,6,237
2025-09-17,14,Primaria 1°,TopKids,136,11,125
2025-09-17,14,Primaria 1°,SuperSchool,269,22,247
2025-09-17,14,Primaria 2°,SuperSchool,282,15,267
2025-09-17,14,Primaria 2°,EduMax,277,22,255
2025-09-17,14,Primaria 2°,SuperSchool,259,6,253
2025-09-17,14,Primaria 2°,SuperSchool,266,17,249
2025-09-17,14,Primaria 2°,SuperSchool,222,12,210
2025-09-17,14,Primaria 2°,EduMax,185,15,170
2025-09-17,14,Primaria 2°,SuperSchool,210,17,193
2025-09-17,14,Primaria 2°,EduMax,239,23,216
2025-09-17,14,Primaria 2°,EduMax,150,11,139
2025-09-17,14,Primaria 2°,TopKids,298,2,296
2025-09-17,14,Primaria 2°,EduMax,181,21,160
2025-09-17,14,Primaria 2°,EduMax,210,9,201
2025-09-17,14,Primaria 2°,TopKids,87,14,73
2025-09-17,14,Primaria 3°,TopKids,82,12,70
2025-09-17,14,Primaria 3°,SuperSchool,257,20,237
2025-09-17,14,Primaria 3°,TopKids,228,18,210
2025-09-17,14,Primaria 3°,EduMax,84,14,70
2025-09-17,14,Primaria 3°,SuperSchool,94,1,93
2025-09-17,14,Primaria 3°,SuperSchool,142,8,134
2025-09-17,14,Primaria 3°,SuperSchool,275,19,256
2025-09-17,14,Primaria 3°,TopKids,255,14,241
2025-09-17,14,Primaria 3°,EduMax,192,10,182
2025-09-17,14,Primaria 3°,EduMax,69,4,65
2025-09-17,14,Primaria 3°,TopKids,115,9,106
2025-09-17,14,Primaria 3°,TopKids,85,12,73
2025-09-17,14,Primaria 3°,TopKids,272,10,262
2025-09-17,14,Primaria 4°,SuperSchool,254,7,247
2025-09-17,14,Primaria 4°,SuperSchool,119,9,110
2025-09-17,14,Primaria 4°,EduMax,176,3,173
2025-09-17,14,Primaria 4°,SuperSchool,180,13,167
2025-09-17,14,Primaria 4°,EduMax,241,6,235
2025-09-17,14,Primaria 4°,EduMax,140,2,138
2025-09-17,14,Primaria 4°,SuperSchool,146,17,129
2025-09-17,14,Primaria 4°,SuperSchool,78,9,69
2025-09-17,14,Primaria 4°,EduMax,89,23,66
2025-09-17,14,Primaria 4°,SuperSchool,183,14,169
2025-09-17,14,Primaria 4°,SuperSchool,75,17,58
2025-09-17,14,Primaria 4°,TopKids,90,15,75
2025-09-17,14,Primaria 4°,EduMax,177,14,163
2025-09-17,14,Primaria 4°,SuperSchool,111,2,109
2025-09-17,14,Primaria 4°,TopKids,245,21,224
2025-09-17,14,Primaria 5°,TopKids,92,21,71
2025-09-17,14,Primaria 5°,TopKids,206,23,183
2025-09-17,14,Primaria 5°,EduMax,201,13,188
2025-09-17,14,Primaria 5°,SuperSchool,262,2,260
2025-09-17,14,Primaria 5°,EduMax,214,5,209
2025-09-17,14,Primaria 5°,SuperSchool,95,6,89
2025-09-17,14,Primaria 5°,TopKids,161,8,153
2025-09-17,14,Primaria 5°,TopKids,150,13,137
2025-09-17,14,Primaria 5°,TopKids,250,4,246
2025-09-17,14,Primaria 5°,SuperSchool,252,23,229
2025-09-17,14,Primaria 5°,TopKids,155,22,133
2025-09-17,14,Primaria 5°,TopKids,125,23,102
2025-09-17,14,Primaria 5°,EduMax,153,10,143
2025-09-17,14,Primaria 5°,SuperSchool,150,13,137
2025-09-17,14,Primaria 5°,EduMax,61,11,50
2025-09-17,14,Primaria 5°,EduMax,288,20,268
2025-09-17,14,Primaria 5°,TopKids,81,8,73
2025-09-17,14,Primaria 5°,TopKids,290,20,270
2025-09-17,14,Primaria 5°,EduMax,71,15,56
2025-09-17,14,Primaria 6°,TopKids,286,12,274
2025-09-17,14,Primaria 6°,EduMax,58,10,48
2025-09-17,14,Primaria 6°,TopKids,278,21,257
2025-09-17,14,Primaria 6°,SuperSchool,294,20,274
2025-09-17,14,Primaria 6°,EduMax,93,17,76
2025-09-17,14,Primaria 6°,EduMax,170,22,148
2025-09-17,14,Primaria 6°,EduMax,123,20,103
2025-09-17,14,Primaria 6°,SuperSchool,282,2,280
2025-09-17,14,Primaria 6°,TopKids,91,8,83
2025-09-17,14,Primaria 6°,SuperSchool,141,21,120
2025-09-17,14,Primaria 6°,TopKids,146,2,144
2025-09-17,14,Primaria 6°,SuperSchool,266,12,254
2025-09-17,14,Primaria 6°,EduMax,288,18,270
2025-09-17,14,Primaria 6°,SuperSchool,253,18,235
2025-09-17,14,Primaria 6°,EduMax,75,21,54
2025-09-17,14,Primaria 6°,SuperSchool,104,4,100
2025-09-17,14,Primaria 6°,EduMax,73,17,56
2025-09-17,15,Preescolar,SuperSchool,157,12,145
2025-09-17,15,Preescolar,TopKids,232,4,228
2025-09-17,15,Preescolar,TopKids,242,12,230
2025-09-17,15,Preescolar,SuperSchool,121,8,113
2025-09-17,15,Preescolar,EduMax,85,23,62
2025-09-17,15,Preescolar,SuperSchool,60,3,57
2025-09-17,15,Preescolar,EduMax,61,17,44
2025-09-17,15,Preescolar,SuperSchool,198,2,196
2025-09-17,15,Preescolar,EduMax,195,12,183
2025-09-17,15,Preescolar,EduMax,138,18,120
2025-09-17,15,Preescolar,SuperSchool,128,1,127
2025-09-17,15,Preescolar,TopKids,217,18,199
2025-09-17,15,Preescolar,TopKids,111,20,91
2025-09-17,15,Preescolar,SuperSchool,146,10,136
2025-09-17,15,Kínder,TopKids,196,19,177
2025-09-17,15,Kínder,TopKids,296,22,274
2025-09-17,15,Kínder,TopKids,239,14,225
2025-09-17,15,Kínder,EduMax,108,6,102
2025-09-17,15,Kínder,EduMax,296,9,287
2025-09-17,15,Kínder,SuperSchool,218,17,201
2025-09-17,15,Kínder,EduMax,73,19,54
2025-09-17,15,Kínder,EduMax,130,3,127
2025-09-17,15,Kínder,EduMax,280,5,275
2025-09-17,15,Kínder,SuperSchool,52,12,40
2025-09-17,15,Kínder,TopKids,154,3,151
2025-09-17,15,Kínder,TopKids,129,20,109
2025-09-17,15,Kínder,SuperSchool,183,1,182
2025-09-17,15,Kínder,TopKids,227,3,224
2025-09-17,15,Kínder,EduMax,207,11,196
2025-09-17,15,Kínder,EduMax,192,3,189
2025-09-17,15,Kínder,EduMax,70,12,58
2025-09-17,15,Primaria 1°,SuperSchool,252,23,229
2025-09-17,15,Primaria 1°,SuperSchool,224,9,215
2025-09-17,15,Primaria 1°,TopKids,284,18,266
2025-09-17,15,Primaria 1°,TopKids,232,7,225
2025-09-17,15,Primaria 1°,EduMax,256,16,240
2025-09-17,15,Primaria 2°,TopKids,271,4,267
2025-09-17,15,Primaria 2°,TopKids,205,14,191
2025-09-17,15,Primaria 2°,SuperSchool,116,23,93
2025-09-17,15,Primaria 2°,TopKids,260,10,250
2025-09-17,15,Primaria 2°,SuperSchool,98,4,94
2025-09-17,15,Primaria 2°,EduMax,67,22,45
2025-09-17,15,Primaria 2°,EduMax,168,16,152
2025-09-17,15,Primaria 2°,TopKids,285,19,266
2025-09-17,15,Primaria 2°,SuperSchool,84,9,75
2025-09-17,15,Primaria 2°,TopKids,257,21,236
2025-09-17,15,Primaria 2°,SuperSchool,242,15,227
2025-09-17,15,Primaria 2°,EduMax,97,7,90
2025-09-17,15,Primaria 2°,EduMax,136,2,134
2025-09-17,15,Primaria 2°,EduMax,297,18,279
2025-09-17,15,Primaria 2°,SuperSchool,193,9,184
2025-09-17,15,Primaria 2°,EduMax,52,13,39
2025-09-17,15,Primaria 2°,SuperSchool,51,18,33
2025-09-17,15,Primaria 2°,EduMax,89,3,86
2025-09-17,15,Primaria 2°,SuperSchool,201,2,199
2025-09-17,15,Primaria 3°,EduMax,234,17,217
2025-09-17,15,Primaria 3°,SuperSchool,105,6,99
2025-09-17,15,Primaria 3°,SuperSchool,65,6,59
2025-09-17,15,Primaria 3°,EduMax,108,3,105
2025-09-17,15,Primaria 3°,TopKids,90,19,71
2025-09-17,15,Primaria 3°,SuperSchool,81,10,71
2025-09-17,15,Primaria 3°,TopKids,268,13,255
2025-09-17,15,Primaria 3°,TopKids,254,20,234
2025-09-17,15,Primaria 3°,EduMax,192,13,179
2025-09-17,15,Primaria 3°,SuperSchool,79,6,73
2025-09-17,15,Primaria 4°,EduMax,120,3,117
2025-09-17,15,Primaria 4°,SuperSchool,125,23,102
2025-09-17,15,Primaria 4°,SuperSchool,156,12,144
2025-09-17,15,Primaria 4°,TopKids,80,16,64
2025-09-17,15,Primaria 4°,SuperSchool,230,18,212
2025-09-17,15,Primaria 4°,SuperSchool,135,5,130
2025-09-17,15,Primaria 4°,SuperSchool,192,5,187
2025-09-17,15,Primaria 4°,TopKids,290,20,270
2025-09-17,15,Primaria 4°,EduMax,286,24,262
2025-09-17,15,Primaria 4°,TopKids,96,7,89
2025-09-17,15,Primaria 4°,TopKids,297,7,290
2025-09-17,15,Primaria 4°,SuperSchool,53,22,31
2025-09-17,15,Primaria 4°,EduMax,153,19,134
2025-09-17,15,Primaria 4°,EduMax,129,16,113
2025-09-17,15,Primaria 4°,TopKids,266,2,264
2025-09-17,15,Primaria 4°,EduMax,174,22,152
2025-09-17,15,Primaria 5°,TopKids,231,4,227
2025-09-17,15,Primaria 5°,SuperSchool,89,3,86
2025-09-17,15,Primaria 5°,TopKids,143,5,138
2025-09-17,15,Primaria 5°,TopKids,158,2,156
2025-09-17,15,Primaria 5°,EduMax,152,24,128
2025-09-17,15,Primaria 5°,SuperSchool,53,9,44
2025-09-17,15,Primaria 5°,EduMax,271,14,257
2025-09-17,15,Primaria 6°,EduMax,165,2,163
2025-09-17,15,Primaria 6°,TopKids,84,4,80
2025-09-17,15,Primaria 6°,TopKids,188,23,165
2025-09-17,15,Primaria 6°,SuperSchool,256,21,235
2025-09-17,15,Primaria 6°,TopKids,136,23,113
2025-09-17,15,Primaria 6°,EduMax,53,13,40
2025-09-17,15,Primaria 6°,SuperSchool,179,6,173
2025-09-17,15,Primaria 6°,TopKids,137,8,129
2025-09-17,15,Primaria 6°,EduMax,133,14,119
2025-09-17,15,Primaria 6°,EduMax,253,9,244
2025-09-17,15,Primaria 6°,EduMax,120,13,107
2025-09-17,15,Primaria 6°,EduMax,257,8,249
2025-09-17,16,Preescolar,EduMax,207,23,184
2025-09-17,16,Preescolar,EduMax,116,10,106
2025-09-17,16,Preescolar,EduMax,76,18,58
2025-09-17,16,Preescolar,SuperSchool,124,4,120
2025-09-17,16,Preescolar,TopKids,285,13,272
2025-09-17,16,Preescolar,TopKids,264,11,253
2025-09-17,16,Preescolar,SuperSchool,117,11,106
2025-09-17,16,Preescolar,EduMax,208,3,205
2025-09-17,16,Preescolar,SuperSchool,194,16,178
2025-09-17,16,Preescolar,TopKids,243,5,238
2025-09-17,16,Preescolar,SuperSchool,295,13,282
2025-09-17,16,Preescolar,TopKids,71,8,63
2025-09-17,16,Preescolar,TopKids,289,22,267
2025-09-17,16,Preescolar,EduMax,183,18,165
2025-09-17,16,Preescolar,SuperSchool,53,21,32
2025-09-17,16,Preescolar,SuperSchool,286,19,267
2025-09-17,16,Preescolar,SuperSchool,51,3,48
2025-09-17,16,Preescolar,SuperSchool,134,7,127
2025-09-17,16,Kínder,EduMax,255,18,237
2025-09-17,16,Kínder,SuperSchool,63,9,54
2025-09-17,16,Kínder,SuperSchool,138,5,133
2025-09-17,16,Kínder,TopKids,264,7,257
2025-09-17,16,Kínder,EduMax,266,22,244
2025-09-17,16,Kínder,TopKids,201,17,184
2025-09-17,16,Kínder,EduMax,252,20,232
2025-09-17,16,Kínder,EduMax,99,21,78
2025-09-17,16,Kínder,TopKids,204,1,203
2025-09-17,16,Kínder,TopKids,133,6,127
2025-09-17,16,Kínder,EduMax,183,17,166
2025-09-17,16,Kínder,TopKids,162,17,145
2025-09-17,16,Kínder,SuperSchool,180,14,166
2025-09-17,16,Kínder,EduMax,111,4,107
2025-09-17,16,Kínder,TopKids,172,18,154
2025-09-17,16,Kínder,EduMax,206,12,194
2025-09-17,16,Kínder,TopKids,94,11,83
2025-09-17,16,Primaria 1°,SuperSchool,288,3,285
2025-09-17,16,Primaria 1°,EduMax,153,6,147
2025-09-17,16,Primaria 1°,TopKids,206,14,192
2025-09-17,16,Primaria 1°,EduMax,260,9,251
2025-09-17,16,Primaria 1°,SuperSchool,165,16,149
2025-09-17,16,Primaria 1°,SuperSchool,126,12,114
2025-09-17,16,Primaria 1°,EduMax,102,20,82
2025-09-17,16,Primaria 1°,EduMax,181,7,174
2025-09-17,16,Primaria 1°,TopKids,148,11,137
2025-09-17,16,Primaria 1°,TopKids,209,14,195
2025-09-17,16,Primaria 1°,SuperSchool,118,14,104
2025-09-17,16,Primaria 2°,SuperSchool,133,22,111
2025-09-17,16,Primaria 2°,SuperSchool,67,1,66
2025-09-17,16,Primaria 2°,TopKids,53,12,41
2025-09-17,16,Primaria 2°,EduMax,209,5,204
2025-09-17,16,Primaria 2°,TopKids,101,3,98
2025-09-17,16,Primaria 2°,EduMax,64,8,56
2025-09-17,16,Primaria 2°,EduMax,231,11,220
2025-09-17,16,Primaria 2°,TopKids,175,12,163
2025-09-17,16,Primaria 2°,TopKids,247,8,239
2025-09-17,16,Primaria 2°,TopKids,240,17,223
2025-09-17,16,Primaria 2°,EduMax,162,13,149
2025-09-17,16,Primaria 3°,EduMax,257,19,238
2025-09-17,16,Primaria 3°,TopKids,99,13,86
2025-09-17,16,Primaria 3°,TopKids,209,21,188
2025-09-17,16,Primaria 3°,EduMax,129,18,111
2025-09-17,16,Primaria 3°,EduMax,201,23,178
2025-09-17,16,Primaria 3°,EduMax,112,22,90
2025-09-17,16,Primaria 3°,TopKids,233,21,212
2025-09-17,16,Primaria 3°,EduMax,122,2,120
2025-09-17,16,Primaria 4°,EduMax,237,23,214
2025-09-17,16,Primaria 4°,SuperSchool,198,6,192
2025-09-17,16,Primaria 4°,SuperSchool,107,6,101
2025-09-17,16,Primaria 4°,EduMax,252,17,235
2025-09-17,16,Primaria 4°,TopKids,239,24,215
2025-09-17,16,Primaria 4°,EduMax,104,16,88
2025-09-17,16,Primaria 4°,SuperSchool,121,19,102
2025-09-17,16,Primaria 4°,TopKids,261,1,260
2025-09-17,16,Primaria 4°,EduMax,117,12,105
2025-09-17,16,Primaria 4°,SuperSchool,198,19,179
2025-09-17,16,Primaria 5°,EduMax,229,22,207
2025-09-17,16,Primaria 5°,TopKids,52,1,51
2025-09-17,16,Primaria 5°,SuperSchool,56,9,47
2025-09-17,16,Primaria 5°,TopKids,50,8,42
2025-09-17,16,Primaria 5°,EduMax,212,17,195
2025-09-17,16,Primaria 5°,TopKids,173,11,162
2025-09-17,16,Primaria 6°,SuperSchool,252,3,249
2025-09-17,16,Primaria 6°,SuperSchool,229,6,223
2025-09-17,16,Primaria 6°,EduMax,160,2,158
2025-09-17,16,Primaria 6°,TopKids,205,2,203
2025-09-17,16,Primaria 6°,SuperSchool,159,2,157
2025-09-17,16,Primaria 6°,SuperSchool,193,8,185
2025-09-17,16,Primaria 6°,SuperSchool,252,13,239
2025-09-17,16,Primaria 6°,TopKids,53,23,30
2025-09-17,16,Primaria 6°,SuperSchool,59,2,57
2025-09-18,9,Preescolar,SuperSchool,65,4,61
2025-09-18,9,Preescolar,EduMax,229,19,210
2025-09-18,9,Preescolar,SuperSchool,249,20,229
2025-09-18,9,Preescolar,TopKids,89,14,75
2025-09-18,9,Preescolar,EduMax,67,8,59
2025-09-18,9,Preescolar,TopKids,271,4,267
2025-09-18,9,Kínder,TopKids,153,9,144
2025-09-18,9,Kínder,SuperSchool,130,7,123
2025-09-18,9,Kínder,EduMax,201,21,180
2025-09-18,9,Kínder,SuperSchool,67,14,53
2025-09-18,9,Kínder,TopKids,131,13,118
2025-09-18,9,Kínder,TopKids,113,2,111
2025-09-18,9,Kínder,TopKids,77,10,67
2025-09-18,9,Kínder,SuperSchool,79,21,58
2025-09-18,9,Primaria 1°,SuperSchool,85,20,65
2025-09-18,9,Primaria 1°,EduMax,128,14,114
2025-09-18,9,Primaria 1°,TopKids,259,10,249
2025-09-18,9,Primaria 1°,EduMax,200,20,180
2025-09-18,9,Primaria 1°,EduMax,218,16,202
2025-09-18,9,Primaria 1°,SuperSchool,228,1,227
2025-09-18,9,Primaria 1°,SuperSchool,299,24,275
2025-09-18,9,Primaria 1°,SuperSchool,120,24,96
2025-09-18,9,Primaria 1°,TopKids,252,12,240
2025-09-18,9,Primaria 2°,SuperSchool,264,17,247
2025-09-18,9,Primaria 2°,TopKids,167,2,165
2025-09-18,9,Primaria 2°,EduMax,86,10,76
2025-09-18,9,Primaria 2°,EduMax,236,11,225
2025-09-18,9,Primaria 2°,TopKids,59,11,48
2025-09-18,9,Primaria 3°,SuperSchool,219,8,211
2025-09-18,9,Primaria 3°,TopKids,133,24,109
2025-09-18,9,Primaria 3°,TopKids,100,7,93
2025-09-18,9,Primaria 3°,SuperSchool,157,21,136
2025-09-18,9,Primaria 3°,EduMax,80,12,68
2025-09-18,9,Primaria 3°,SuperSchool,190,17,173
2025-09-18,9,Primaria 3°,TopKids,58,20,38
2025-09-18,9,Primaria 3°,SuperSchool,258,19,239
2025-09-18,9,Primaria 3°,TopKids,121,8,113
2025-09-18,9,Primaria 3°,SuperSchool,111,15,96
2025-09-18,9,Primaria 4°,EduMax,273,16,257
2025-09-18,9,Primaria 4°,TopKids,112,10,102
2025-09-18,9,Primaria 4°,EduMax,219,24,195
2025-09-18,9,Primaria 4°,TopKids,243,9,234
2025-09-18,9,Primaria 4°,SuperSchool,123,18,105
2025-09-18,9,Primaria 4°,TopKids,82,12,70
2025-09-18,9,Primaria 4°,SuperSchool,173,11,162
2025-09-18,9,Primaria 4°,EduMax,287,15,272
2025-09-18,9,Primaria 4°,EduMax,138,4,134
2025-09-18,9,Primaria 4°,TopKids,254,19,235
2025-09-18,9,Primaria 4°,SuperSchool,232,12,220
2025-09-18,9,Primaria 5°,SuperSchool,291,23,268
2025-09-18,9,Primaria 5°,TopKids,196,3,193
2025-09-18,9,Primaria 5°,TopKids,53,18,35
2025-09-18,9,Primaria 5°,SuperSchool,84,11,73
2025-09-18,9,Primaria 5°,EduMax,144,3,141
2025-09-18,9,Primaria 5°,SuperSchool,113,7,106
2025-09-18,9,Primaria 6°,SuperSchool,260,3,257
2025-09-18,9,Primaria 6°,SuperSchool,121,20,101
2025-09-18,9,Primaria 6°,SuperSchool,212,20,192
2025-09-18,9,Primaria 6°,SuperSchool,94,13,81
2025-09-18,9,Primaria 6°,EduMax,235,6,229
2025-09-18,9,Primaria 6°,EduMax,256,2,254
2025-09-18,9,Primaria 6°,SuperSchool,261,16,245
2025-09-18,9,Primaria 6°,TopKids,113,17,96
2025-09-18,10,Preescolar,TopKids,296,1,295
2025-09-18,10,Preescolar,SuperSchool,89,3,86
2025-09-18,10,Preescolar,EduMax,169,24,145
2025-09-18,10,Preescolar,EduMax,141,14,127
2025-09-18,10,Preescolar,EduMax,262,14,248
2025-09-18,10,Preescolar,TopKids,252,12,240
2025-09-18,10,Preescolar,TopKids,170,1,169
2025-09-18,10,Preescolar,SuperSchool,95,18,77
2025-09-18,10,Preescolar,SuperSchool,299,22,277
2025-09-18,10,Preescolar,EduMax,181,22,159
2025-09-18,10,Preescolar,EduMax,53,23,30
2025-09-18,10,Preescolar,SuperSchool,289,16,273
2025-09-18,10,Preescolar,SuperSchool,267,10,257
2025-09-18,10,Preescolar,TopKids,122,23,99
2025-09-18,10,Preescolar,TopKids,273,17,256
2025-09-18,10,Preescolar,TopKids,76,24,52
2025-09-18,10,Preescolar,SuperSchool,132,10,122
2025-09-18,10,Kínder,EduMax,52,7,45
2025-09-18,10,Kínder,EduMax,202,13,189
2025-09-18,10,Kínder,TopKids,259,7,252
2025-09-18,10,Kínder,TopKids,131,7,124
2025-09-18,10,Kínder,SuperSchool,90,12,78
2025-09-18,10,Kínder,TopKids,82,2,80
2025-09-18,10,Kínder,EduMax,287,23,264
2025-09-18,10,Kínder,EduMax,112,11,101
2025-09-18,10,Kínder,SuperSchool,260,8,252
2025-09-18,10,Kínder,SuperSchool,214,21,193
2025-09-18,10,Kínder,TopKids,173,23,150
2025-09-18,10,Kínder,EduMax,192,22,170
2025-09-18,10,Kínder,SuperSchool,146,22,124
2025-09-18,10,Kínder,SuperSchool,78,17,61
2025-09-18,10,Primaria 1°,TopKids,258,19,239
2025-09-18,10,Primaria 1°,SuperSchool,189,23,166
2025-09-18,10,Primaria 1°,EduMax,124,4,120
2025-09-18,10,Primaria 1°,SuperSchool,137,18,119
2025-09-18,10,Primaria 1°,TopKids,108,9,99
2025-09-18,10,Primaria 1°,SuperSchool,119,19,100
2025-09-18,10,Primaria 1°,SuperSchool,217,6,211
2025-09-18,10,Primaria 1°,TopKids,190,2,188
2025-09-18,10,Primaria 1°,SuperSchool,230,15,215
2025-09-18,10,Primaria 1°,TopKids,282,10,272
2025-09-18,10,Primaria 1°,SuperSchool,241,23,218
2025-09-18,10,Primaria 1°,TopKids,138,7,131
2025-09-18,10,Primaria 1°,EduMax,84,2,82
2025-09-18,10,Primaria 1°,TopKids,155,8,147
2025-09-18,10,Primaria 1°,SuperSchool,135,9,126
2025-09-18,10,Primaria 1°,TopKids,71,22,49
2025-09-18,10,Primaria 1°,TopKids,67,17,50
2025-09-18,10,Primaria 2°,EduMax,276,3,273
2025-09-18,10,Primaria 2°,SuperSchool,66,18,48
2025-09-18,10,Primaria 2°,TopKids,66,24,42
2025-09-18,10,Primaria 2°,EduMax,202,1,201
2025-09-18,10,Primaria 2°,TopKids,63,15,48
2025-09-18,10,Primaria 2°,SuperSchool,284,18,266
2025-09-18,10,Primaria 2°,SuperSchool,258,9,249
2025-09-18,10,Primaria 2°,SuperSchool,201,14,187
2025-09-18,10,Primaria 2°,TopKids,197,20,177
2025-09-18,10,Primaria 2°,EduMax,117,16,101
2025-09-18,10,Primaria 2°,SuperSchool,221,21,200
2025-09-18,10,Primaria 2°,SuperSchool,188,24,164
2025-09-18,10,Primaria 2°,SuperSchool,221,22,199
2025-09-18,10,Primaria 2°,EduMax,220,11,209
2025-09-18,10,Primaria 2°,SuperSchool,210,17,193
2025-09-18,10,Primaria 3°,EduMax,214,4,210
2025-09-18,10,Primaria 3°,EduMax,227,21,206
2025-09-18,10,Primaria 3°,SuperSchool,87,15,72
2025-09-18,10,Primaria 3°,SuperSchool,215,24,191
2025-09-18,10,Primaria 3°,EduMax,142,7,135
2025-09-18,10,Primaria 4°,EduMax,139,8,131
2025-09-18,10,Primaria 4°,SuperSchool,207,24,183
2025-09-18,10,Primaria 4°,EduMax,182,4,178
2025-09-18,10,Primaria 4°,TopKids,283,9,274
2025-09-18,10,Primaria 4°,TopKids,82,19,63
2025-09-18,10,Primaria 4°,SuperSchool,80,12,68
2025-09-18,10,Primaria 4°,TopKids,286,22,264
2025-09-18,10,Primaria 4°,TopKids,238,2,236
2025-09-18,10,Primaria 4°,EduMax,134,4,130
2025-09-18,10,Primaria 4°,SuperSchool,149,14,135
2025-09-18,10,Primaria 4°,SuperSchool,67,6,61
2025-09-18,10,Primaria 4°,SuperSchool,251,18,233
2025-09-18,10,Primaria 4°,TopKids,241,2,239
2025-09-18,10,Primaria 4°,TopKids,180,8,172
2025-09-18,10,Primaria 4°,TopKids,188,14,174
2025-09-18,10,Primaria 4°,EduMax,66,15,51
2025-09-18,10,Primaria 4°,EduMax,220,8,212
2025-09-18,10,Primaria 4°,TopKids,197,12,185
2025-09-18,10,Primaria 5°,TopKids,239,16,223
2025-09-18,10,Primaria 5°,EduMax,231,22,209
2025-09-18,10,Primaria 5°,TopKids,117,24,93
2025-09-18,10,Primaria 5°,EduMax,90,15,75
2025-09-18,10,Primaria 5°,EduMax,63,12,51
2025-09-18,10,Primaria 5°,SuperSchool,112,17,95
2025-09-18,10,Primaria 5°,SuperSchool,121,10,111
2025-09-18,10,Primaria 5°,EduMax,254,7,247
2025-09-18,10,Primaria 5°,TopKids,137,15,122
2025-09-18,10,Primaria 6°,SuperSchool,248,5,243
2025-09-18,10,Primaria 6°,SuperSchool,162,8,154
2025-09-18,10,Primaria 6°,TopKids,216,2,214
2025-09-18,10,Primaria 6°,TopKids,189,12,177
2025-09-18,10,Primaria 6°,TopKids,77,3,74
2025-09-18,10,Primaria 6°,TopKids,267,6,261
2025-09-18,10,Primaria 6°,EduMax,196,21,175
2025-09-18,10,Primaria 6°,SuperSchool,296,9,287
2025-09-18,10,Primaria 6°,EduMax,59,10,49
2025-09-18,10,Primaria 6°,SuperSchool,131,22,109
2025-09-18,10,Primaria 6°,EduMax,184,8,176
2025-09-18,10,Primaria 6°,TopKids,103,6,97
2025-09-18,11,Preescolar,TopKids,282,11,271
2025-09-18,11,Preescolar,EduMax,92,5,87
2025-09-18,11,Preescolar,TopKids,162,18,144
2025-09-18,11,Preescolar,EduMax,191,10,181
2025-09-18,11,Preescolar,SuperSchool,60,2,58
2025-09-18,11,Preescolar,EduMax,70,1,69
2025-09-18,11,Preescolar,EduMax,95,11,84
2025-09-18,11,Kínder,EduMax,69,21,48
2025-09-18,11,Kínder,SuperSchool,278,14,264
2025-09-18,11,Kínder,EduMax,106,5,101
2025-09-18,11,Kínder,EduMax,201,16,185
2025-09-18,11,Kínder,TopKids,96,6,90
2025-09-18,11,Kínder,TopKids,229,13,216
2025-09-18,11,Kínder,TopKids,286,8,278
2025-09-18,11,Kínder,EduMax,209,22,187
2025-09-18,11,Kínder,SuperSchool,54,8,46
2025-09-18,11,Kínder,TopKids,174,18,156
2025-09-18,11,Kínder,EduMax,260,12,248
2025-09-18,11,Kínder,SuperSchool,221,13,208
2025-09-18,11,Kínder,TopKids,187,16,171
2025-09-18,11,Kínder,SuperSchool,269,12,257
2025-09-18,11,Kínder,TopKids,65,23,42
2025-09-18,11,Primaria 1°,TopKids,70,2,68
2025-09-18,11,Primaria 1°,TopKids,257,11,246
2025-09-18,11,Primaria 1°,EduMax,172,9,163
2025-09-18,11,Primaria 1°,EduMax,131,13,118
2025-09-18,11,Primaria 1°,SuperSchool,121,10,111
2025-09-18,11,Primaria 1°,TopKids,130,24,106
2025-09-18,11,Primaria 1°,SuperSchool,50,16,34
2025-09-18,11,Primaria 1°,EduMax,220,1,219
2025-09-18,11,Primaria 1°,EduMax,125,16,109
2025-09-18,11,Primaria 1°,EduMax,60,18,42
2025-09-18,11,Primaria 1°,EduMax,145,17,128
2025-09-18,11,Primaria 1°,SuperSchool,69,21,48
2025-09-18,11,Primaria 1°,EduMax,105,15,90
2025-09-18,11,Primaria 1°,TopKids,67,17,50
2025-09-18,11,Primaria 1°,EduMax,94,6,88
2025-09-18,11,Primaria 1°,TopKids,143,20,123
2025-09-18,11,Primaria 1°,TopKids,239,18,221
2025-09-18,11,Primaria 2°,SuperSchool,166,14,152
2025-09-18,11,Primaria 2°,SuperSchool,190,6,184
2025-09-18,11,Primaria 2°,EduMax,274,1,273
2025-09-18,11,Primaria 2°,EduMax,227,16,211
2025-09-18,11,Primaria 2°,TopKids,76,6,70
2025-09-18,11,Primaria 3°,SuperSchool,240,1,239
2025-09-18,11,Primaria 3°,TopKids,77,10,67
2025-09-18,11,Primaria 3°,EduMax,117,6,111
2025-09-18,11,Primaria 3°,SuperSchool,292,9,283
2025-09-18,11,Primaria 3°,EduMax,165,23,142
2025-09-18,11,Primaria 3°,TopKids,246,22,224
2025-09-18,11,Primaria 3°,SuperSchool,289,22,267
2025-09-18,11,Primaria 3°,EduMax,218,11,207
2025-09-18,11,Primaria 3°,EduMax,163,2,161
2025-09-18,11,Primaria 3°,EduMax,296,4,292
2025-09-18,11,Primaria 3°,SuperSchool,82,4,78
2025-09-18,11,Primaria 3°,EduMax,113,19,94
2025-09-18,11,Primaria 3°,EduMax,227,10,217
2025-09-18,11,Primaria 3°,SuperSchool,271,22,249
2025-09-18,11,Primaria 4°,EduMax,114,5,109
2025-09-18,11,Primaria 4°,TopKids,160,24,136
2025-09-18,11,Primaria 4°,TopKids,223,7,216
2025-09-18,11,Primaria 4°,SuperSchool,189,17,172
2025-09-18,11,Primaria 4°,EduMax,243,17,226
2025-09-18,11,Primaria 4°,TopKids,123,15,108
2025-09-18,11,Primaria 4°,SuperSchool,265,11,254
2025-09-18,11,Primaria 4°,TopKids,75,12,63
2025-09-18,11,Primaria 4°,TopKids,106,15,91
2025-09-18,11,Primaria 4°,SuperSchool,214,5,209
2025-09-18,11,Primaria 4°,SuperSchool,175,2,173
2025-09-18,11,Primaria 5°,EduMax,74,9,65
2025-09-18,11,Primaria 5°,SuperSchool,143,5,138
2025-09-18,11,Primaria 5°,SuperSchool,243,22,221
2025-09-18,11,Primaria 5°,SuperSchool,170,8,162
2025-09-18,11,Primaria 5°,EduMax,133,6,127
2025-09-18,11,Primaria 6°,EduMax,202,10,192
2025-09-18,11,Primaria 6°,EduMax,144,11,133
2025-09-18,11,Primaria 6°,SuperSchool,205,24,181
2025-09-18,11,Primaria 6°,TopKids,90,5,85
2025-09-18,11,Primaria 6°,SuperSchool,188,8,180
2025-09-18,11,Primaria 6°,SuperSchool,273,5,268
2025-09-18,11,Primaria 6°,EduMax,58,6,52
2025-09-18,11,Primaria 6°,TopKids,145,10,135
2025-09-18,11,Primaria 6°,TopKids,280,18,262
2025-09-18,11,Primaria 6°,TopKids,189,11,178
2025-09-18,11,Primaria 6°,EduMax,76,21,55
2025-09-18,11,Primaria 6°,EduMax,62,13,49
2025-09-18,11,Primaria 6°,TopKids,74,13,61
2025-09-18,11,Primaria 6°,SuperSchool,113,6,107
2025-09-18,11,Primaria 6°,TopKids,205,20,185
2025-09-18,12,Preescolar,SuperSchool,53,20,33
2025-09-18,12,Preescolar,SuperSchool,263,24,239
2025-09-18,12,Preescolar,SuperSchool,182,4,178
2025-09-18,12,Preescolar,SuperSchool,194,24,170
2025-09-18,12,Preescolar,SuperSchool,59,18,41
2025-09-18,12,Preescolar,TopKids,63,5,58
2025-09-18,12,Preescolar,TopKids,205,5,200
2025-09-18,12,Preescolar,EduMax,189,10,179
2025-09-18,12,Kínder,TopKids,242,3,239
2025-09-18,12,Kínder,TopKids,143,11,132
2025-09-18,12,Kínder,SuperSchool,59,2,57
2025-09-18,12,Kínder,TopKids,133,11,122
2025-09-18,12,Kínder,TopKids,70,11,59
2025-09-18,12,Kínder,SuperSchool,264,12,252
2025-09-18,12,Kínder,TopKids,259,24,235
2025-09-18,12,Kínder,EduMax,86,15,71
2025-09-18,12,Kínder,SuperSchool,163,6,157
2025-09-18,12,Kínder,EduMax,270,11,259
2025-09-18,12,Kínder,SuperSchool,252,16,236
2025-09-18,12,Kínder,EduMax,114,23,91
2025-09-18,12,Primaria 1°,TopKids,73,6,67
2025-09-18,12,Primaria 1°,TopKids,228,8,220
2025-09-18,12,Primaria 1°,EduMax,115,19,96
2025-09-18,12,Primaria 1°,TopKids,263,14,249
2025-09-18,12,Primaria 1°,EduMax,232,4,228
2025-09-18,12,Primaria 1°,TopKids,143,22,121
2025-09-18,12,Primaria 1°,TopKids,289,8,281
2025-09-18,12,Primaria 1°,TopKids,256,20,236
2025-09-18,12,Primaria 1°,SuperSchool,295,1,294
2025-09-18,12,Primaria 1°,SuperSchool,260,18,242
2025-09-18,12,Primaria 1°,TopKids,88,11,77
2025-09-18,12,Primaria 1°,TopKids,79,20,59
2025-09-18,12,Primaria 1°,EduMax,192,23,169
2025-09-18,12,Primaria 1°,SuperSchool,226,3,223
2025-09-18,12,Primaria 1°,EduMax,284,13,271
2025-09-18,12,Primaria 1°,EduMax,55,14,41
2025-09-18,12,Primaria 2°,SuperSchool,66,14,52
2025-09-18,12,Primaria 2°,SuperSchool,287,4,283
2025-09-18,12,Primaria 2°,EduMax,181,14,167
2025-09-18,12,Primaria 2°,EduMax,205,7,198
2025-09-18,12,Primaria 2°,EduMax,150,7,143
2025-09-18,12,Primaria 2°,SuperSchool,140,15,125
2025-09-18,12,Primaria 2°,SuperSchool,105,7,98
2025-09-18,12,Primaria 2°,TopKids,219,18,201
2025-09-18,12,Primaria 2°,TopKids,71,14,57
2025-09-18,12,Primaria 2°,TopKids,238,24,214
2025-09-18,12,Primaria 2°,EduMax,101,3,98
2025-09-18,12,Primaria 2°,TopKids,80,21,59
2025-09-18,12,Primaria 2°,SuperSchool,170,3,167
2025-09-18,12,Primaria 2°,TopKids,234,20,214
2025-09-18,12,Primaria 2°,EduMax,133,18,115
2025-09-18,12,Primaria 3°,TopKids,238,19,219
2025-09-18,12,Primaria 3°,SuperSchool,153,11,142
2025-09-18,12,Primaria 3°,SuperSchool,150,13,137
2025-09-18,12,Primaria 3°,SuperSchool,225,12,213
2025-09-18,12,Primaria 3°,EduMax,166,21,145
2025-09-18,12,Primaria 3°,SuperSchool,108,6,102
2025-09-18,12,Primaria 3°,SuperSchool,202,8,194
2025-09-18,12,Primaria 3°,TopKids,179,6,173
2025-09-18,12,Primaria 3°,EduMax,110,2,108
2025-09-18,12,Primaria 3°,TopKids,132,13,119
2025-09-18,12,Primaria 3°,SuperSchool,294,8,286
2025-09-18,12,Primaria 3°,SuperSchool,200,5,195
2025-09-18,12,Primaria 3°,SuperSchool,193,16,177
2025-09-18,12,Primaria 3°,SuperSchool,170,11,159
2025-09-18,12,Primaria 3°,EduMax,190,3,187
2025-09-18,12,Primaria 3°,EduMax,156,11,145
2025-09-18,12,Primaria 4°,EduMax,109,3,106
2025-09-18,12,Primaria 4°,SuperSchool,202,2,200
2025-09-18,12,Primaria 4°,TopKids,54,5,49
2025-09-18,12,Primaria 4°,SuperSchool,289,17,272
2025-09-18,12,Primaria 4°,EduMax,120,2,118
2025-09-18,12,Primaria 4°,EduMax,63,18,45
2025-09-18,12,Primaria 4°,SuperSchool,285,17,268
2025-09-18,12,Primaria 4°,SuperSchool,119,5,114
2025-09-18,12,Primaria 4°,SuperSchool,134,22,112
2025-09-18,12,Primaria 5°,TopKids,234,18,216
2025-09-18,12,Primaria 5°,TopKids,246,6,240
2025-09-18,12,Primaria 5°,TopKids,276,3,273
2025-09-18,12,Primaria 5°,SuperSchool,74,2,72
2025-09-18,12,Primaria 5°,SuperSchool,51,16,35
2025-09-18,12,Primaria 5°,TopKids,140,4,136
2025-09-18,12,Primaria 5°,TopKids,143,3,140
2025-09-18,12,Primaria 5°,EduMax,158,6,152
2025-09-18,12,Primaria 5°,SuperSchool,276,24,252
2025-09-18,12,Primaria 5°,TopKids,168,18,150
2025-09-18,12,Primaria 5°,EduMax,150,23,127
2025-09-18,12,Primaria 6°,EduMax,93,1,92
2025-09-18,12,Primaria 6°,TopKids,265,2,263
2025-09-18,12,Primaria 6°,SuperSchool,204,20,184
2025-09-18,12,Primaria 6°,TopKids,161,19,142
2025-09-18,12,Primaria 6°,SuperSchool,147,6,141
2025-09-18,13,Preescolar,SuperSchool,152,21,131
2025-09-18,13,Preescolar,SuperSchool,119,9,110
2025-09-18,13,Preescolar,TopKids,207,10,197
2025-09-18,13,Preescolar,TopKids,50,10,40
2025-09-18,13,Preescolar,SuperSchool,257,19,238
2025-09-18,13,Preescolar,EduMax,160,14,146
2025-09-18,13,Preescolar,TopKids,245,8,237
2025-09-18,13,Preescolar,SuperSchool,261,15,246
2025-09-18,13,Preescolar,TopKids,157,3,154
2025-09-18,13,Preescolar,TopKids,268,5,263
2025-09-18,13,Preescolar,SuperSchool,203,8,195
2025-09-18,13,Preescolar,TopKids,164,12,152
2025-09-18,13,Kínder,TopKids,78,14,64
2025-09-18,13,Kínder,EduMax,267,22,245
2025-09-18,13,Kínder,SuperSchool,157,9,148
2025-09-18,13,Kínder,EduMax,253,6,247
2025-09-18,13,Kínder,EduMax,204,22,182
2025-09-18,13,Kínder,TopKids,101,6,95
2025-09-18,13,Kínder,EduMax,226,17,209
2025-09-18,13,Kínder,SuperSchool,200,17,183
2025-09-18,13,Primaria 1°,EduMax,156,8,148
2025-09-18,13,Primaria 1°,EduMax,63,19,44
2025-09-18,13,Primaria 1°,EduMax,195,15,180
2025-09-18,13,Primaria 1°,EduMax,131,20,111
2025-09-18,13,Primaria 1°,SuperSchool,266,17,249
2025-09-18,13,Primaria 1°,SuperSchool,266,4,262
2025-09-18,13,Primaria 1°,TopKids,97,7,90
2025-09-18,13,Primaria 1°,TopKids,193,6,187
2025-09-18,13,Primaria 1°,SuperSchool,229,10,219
2025-09-18,13,Primaria 2°,TopKids,64,12,52
2025-09-18,13,Primaria 2°,TopKids,97,23,74
2025-09-18,13,Primaria 2°,EduMax,248,14,234
2025-09-18,13,Primaria 2°,SuperSchool,103,6,97
2025-09-18,13,Primaria 2°,TopKids,222,22,200
2025-09-18,13,Primaria 2°,SuperSchool,67,12,55
2025-09-18,13,Primaria 2°,EduMax,135,9,126
2025-09-18,13,Primaria 2°,EduMax,106,21,85
2025-09-18,13,Primaria 2°,TopKids,250,10,240
2025-09-18,13,Primaria 2°,EduMax,179,14,165
2025-09-18,13,Primaria 2°,SuperSchool,220,13,207
2025-09-18,13,Primaria 2°,EduMax,166,7,159
2025-09-18,13,Primaria 2°,TopKids,280,12,268
2025-09-18,13,Primaria 2°,TopKids,56,5,51
2025-09-18,13,Primaria 2°,TopKids,152,22,130
2025-09-18,13,Primaria 2°,TopKids,166,2,164
2025-09-18,13,Primaria 2°,SuperSchool,115,19,96
2025-09-18,13,Primaria 2°,SuperSchool,211,14,197
2025-09-18,13,Primaria 3°,SuperSchool,189,19,170
2025-09-18,13,Primaria 3°,TopKids,215,10,205
2025-09-18,13,Primaria 3°,EduMax,148,9,139
2025-09-18,13,Primaria 3°,TopKids,278,24,254
2025-09-18,13,Primaria 3°,EduMax,248,19,229
2025-09-18,13,Primaria 3°,SuperSchool,251,11,240
2025-09-18,13,Primaria 3°,EduMax,204,19,185
2025-09-18,13,Primaria 3°,TopKids,225,22,203
2025-09-18,13,Primaria 3°,EduMax,125,24,101
2025-09-18,13,Primaria 3°,EduMax,163,14,149
2025-09-18,13,Primaria 3°,EduMax,270,16,254
2025-09-18,13,Primaria 3°,EduMax,247,1,246
2025-09-18,13,Primaria 3°,SuperSchool,151,6,145
2025-09-18,13,Primaria 3°,EduMax,189,9,180
2025-09-18,13,Primaria 3°,TopKids,280,3,277
2025-09-18,13,Primaria 3°,TopKids,275,18,257
2025-09-18,13,Primaria 3°,SuperSchool,50,1,49
2025-09-18,13,Primaria 3°,EduMax,60,3,57
2025-09-18,13,Primaria 3°,EduMax,251,12,239
2025-09-18,13,Primaria 4°,TopKids,162,17,145
2025-09-18,13,Primaria 4°,SuperSchool,114,17,97
2025-09-18,13,Primaria 4°,TopKids,244,10,234
2025-09-18,13,Primaria 4°,EduMax,81,16,65
2025-09-18,13,Primaria 4°,TopKids,75,8,67
2025-09-18,13,Primaria 4°,TopKids,123,24,99
2025-09-18,13,Primaria 4°,EduMax,186,5,181
2025-09-18,13,Primaria 4°,TopKids,277,1,276
2025-09-18,13,Primaria 4°,TopKids,61,16,45
2025-09-18,13,Primaria 4°,SuperSchool,190,9,181
2025-09-18,13,Primaria 5°,EduMax,217,1,216
2025-09-18,13,Primaria 5°,TopKids,214,7,207
2025-09-18,13,Primaria 5°,SuperSchool,230,3,227
2025-09-18,13,Primaria 5°,TopKids,151,12,139
2025-09-18,13,Primaria 5°,TopKids,66,18,48
2025-09-18,13,Primaria 5°,SuperSchool,198,17,181
2025-09-18,13,Primaria 5°,TopKids,125,16,109
2025-09-18,13,Primaria 5°,SuperSchool,250,15,235
2025-09-18,13,Primaria 5°,SuperSchool,72,11,61
2025-09-18,13,Primaria 5°,EduMax,114,16,98
2025-09-18,13,Primaria 5°,EduMax,62,20,42
2025-09-18,13,Primaria 5°,EduMax,257,3,254
2025-09-18,13,Primaria 5°,EduMax,81,23,58
2025-09-18,13,Primaria 5°,SuperSchool,220,13,207
2025-09-18,13,Primaria 6°,EduMax,244,1,243
2025-09-18,13,Primaria 6°,SuperSchool,96,22,74
2025-09-18,13,Primaria 6°,TopKids,149,12,137
2025-09-18,13,Primaria 6°,SuperSchool,93,14,79
2025-09-18,13,Primaria 6°,TopKids,247,14,233
2025-09-18,13,Primaria 6°,TopKids,108,2,106
2025-09-18,13,Primaria 6°,TopKids,198,18,180
2025-09-18,13,Primaria 6°,EduMax,101,16,85
2025-09-18,13,Primaria 6°,EduMax,196,20,176
2025-09-18,13,Primaria 6°,EduMax,81,12,69
2025-09-18,13,Primaria 6°,EduMax,251,9,242
2025-09-18,13,Primaria 6°,TopKids,82,14,68
2025-09-18,14,Preescolar,TopKids,259,21,238
2025-09-18,14,Preescolar,EduMax,85,20,65
2025-09-18,14,Preescolar,SuperSchool,217,19,198
2025-09-18,14,Preescolar,EduMax,247,16,231
2025-09-18,14,Preescolar,EduMax,264,9,255
2025-09-18,14,Preescolar,TopKids,276,14,262
2025-09-18,14,Preescolar,SuperSchool,198,21,177
2025-09-18,14,Preescolar,EduMax,178,13,165
2025-09-18,14,Preescolar,SuperSchool,205,3,202
2025-09-18,14,Preescolar,EduMax,165,23,142
2025-09-18,14,Preescolar,EduMax,247,12,235
2025-09-18,14,Preescolar,EduMax,111,7,104
2025-09-18,14,Kínder,EduMax,225,7,218
2025-09-18,14,Kínder,SuperSchool,105,3,102
2025-09-18,14,Kínder,SuperSchool,229,9,220
2025-09-18,14,Kínder,TopKids,280,23,257
2025-09-18,14,Kínder,TopKids,114,2,112
2025-09-18,14,Kínder,TopKids,146,15,131
2025-09-18,14,Kínder,EduMax,214,21,193
2025-09-18,14,Kínder,SuperSchool,96,7,89
2025-09-18,14,Kínder,EduMax,209,24,185
2025-09-18,14,Kínder,EduMax,224,15,209
2025-09-18,14,Kínder,SuperSchool,269,19,250
2025-09-18,14,Kínder,SuperSchool,107,7,100
2025-09-18,14,Kínder,EduMax,288,13,275
2025-09-18,14,Kínder,TopKids,113,18,95
2025-09-18,14,Kínder,TopKids,245,18,227
2025-09-18,14,Kínder,TopKids,65,14,51
2025-09-18,14,Primaria 1°,EduMax,184,13,171
2025-09-18,14,Primaria 1°,EduMax,219,13,206
2025-09-18,14,Primaria 1°,EduMax,111,11,100
2025-09-18,14,Primaria 1°,SuperSchool,151,11,140
2025-09-18,14,Primaria 1°,TopKids,100,17,83
2025-09-18,14,Primaria 1°,SuperSchool,116,1,115
2025-09-18,14,Primaria 1°,TopKids,287,18,269
2025-09-18,14,Primaria 1°,TopKids,297,8,289
2025-09-18,14,Primaria 1°,EduMax,129,15,114
2025-09-18,14,Primaria 1°,EduMax,51,16,35
2025-09-18,14,Primaria 1°,TopKids,270,10,260
2025-09-18,14,Primaria 1°,TopKids,188,19,169
2025-09-18,14,Primaria 1°,TopKids,209,10,199
2025-09-18,14,Primaria 1°,EduMax,290,24,266
2025-09-18,14,Primaria 1°,TopKids,146,7,139
2025-09-18,14,Primaria 1°,TopKids,102,18,84
2025-09-18,14,Primaria 1°,SuperSchool,143,2,141
2025-09-18,14,Primaria 1°,SuperSchool,167,2,165
2025-09-18,14,Primaria 2°,EduMax,110,24,86
2025-09-18,14,Primaria 2°,EduMax,230,20,210
2025-09-18,14,Primaria 2°,EduMax,167,21,146
2025-09-18,14,Primaria 2°,EduMax,272,20,252
2025-09-18,14,Primaria 2°,EduMax,106,8,98
2025-09-18,14,Primaria 2°,EduMax,66,5,61
2025-09-18,14,Primaria 2°,TopKids,116,24,92
2025-09-18,14,Primaria 2°,SuperSchool,163,10,153
2025-09-18,14,Primaria 2°,EduMax,259,13,246
2025-09-18,14,Primaria 2°,EduMax,194,14,180
2025-09-18,14,Primaria 2°,EduMax,132,18,114
2025-09-18,14,Primaria 2°,TopKids,185,18,167
2025-09-18,14,Primaria 2°,SuperSchool,92,17,75
2025-09-18,14,Primaria 2°,EduMax,260,18,242
2025-09-18,14,Primaria 2°,EduMax,226,8,218
2025-09-18,14,Primaria 2°,TopKids,98,21,77
2025-09-18,14,Primaria 2°,TopKids,270,6,264
2025-09-18,14,Primaria 3°,TopKids,257,12,245
2025-09-18,14,Primaria 3°,TopKids,60,7,53
2025-09-18,14,Primaria 3°,EduMax,100,5,95
2025-09-18,14,Primaria 3°,SuperSchool,234,24,210
2025-09-18,14,Primaria 3°,TopKids,149,1,148
2025-09-18,14,Primaria 3°,EduMax,66,14,52
2025-09-18,14,Primaria 3°,EduMax,167,5,162
2025-09-18,14,Primaria 3°,TopKids,135,24,111
2025-09-18,14,Primaria 3°,TopKids,184,11,173
2025-09-18,14,Primaria 3°,EduMax,127,3,124
2025-09-18,14,Primaria 3°,EduMax,162,4,158
2025-09-18,14,Primaria 4°,SuperSchool,219,7,212
2025-09-18,14,Primaria 4°,TopKids,198,21,177
2025-09-18,14,Primaria 4°,EduMax,50,4,46
2025-09-18,14,Primaria 4°,TopKids,59,13,46
2025-09-18,14,Primaria 4°,TopKids,196,22,174
2025-09-18,14,Primaria 4°,EduMax,143,18,125
2025-09-18,14,Primaria 4°,SuperSchool,175,9,166
2025-09-18,14,Primaria 4°,TopKids,61,24,37
2025-09-18,14,Primaria 4°,EduMax,175,2,173
2025-09-18,14,Primaria 4°,EduMax,163,6,157
2025-09-18,14,Primaria 5°,SuperSchool,107,18,89
2025-09-18,14,Primaria 5°,EduMax,262,14,248
2025-09-18,14,Primaria 5°,EduMax,60,19,41
2025-09-18,14,Primaria 5°,EduMax,143,3,140
2025-09-18,14,Primaria 5°,SuperSchool,54,22,32
2025-09-18,14,Primaria 5°,EduMax,268,7,261
2025-09-18,14,Primaria 6°,TopKids,261,6,255
2025-09-18,14,Primaria 6°,SuperSchool,130,14,116
2025-09-18,14,Primaria 6°,SuperSchool,128,23,105
2025-09-18,14,Primaria 6°,EduMax,211,12,199
2025-09-18,14,Primaria 6°,TopKids,56,7,49
2025-09-18,14,Primaria 6°,TopKids,202,7,195
2025-09-18,14,Primaria 6°,EduMax,285,10,275
2025-09-18,14,Primaria 6°,TopKids,214,23,191
2025-09-18,14,Primaria 6°,TopKids,87,20,67
2025-09-18,14,Primaria 6°,EduMax,206,13,193
2025-09-18,14,Primaria 6°,SuperSchool,95,5,90
2025-09-18,14,Primaria 6°,TopKids,52,14,38
2025-09-18,14,Primaria 6°,TopKids,298,23,275
2025-09-18,14,Primaria 6°,SuperSchool,290,9,281
2025-09-18,14,Primaria 6°,TopKids,99,21,78
2025-09-18,14,Primaria 6°,TopKids,225,18,207
2025-09-18,14,Primaria 6°,TopKids,106,4,102
2025-09-18,15,Preescolar,EduMax,73,24,49
2025-09-18,15,Preescolar,SuperSchool,238,11,227
2025-09-18,15,Preescolar,SuperSchool,173,6,167
2025-09-18,15,Preescolar,SuperSchool,275,22,253
2025-09-18,15,Preescolar,EduMax,145,13,132
2025-09-18,15,Preescolar,SuperSchool,148,24,124
2025-09-18,15,Preescolar,EduMax,195,11,184
2025-09-18,15,Kínder,EduMax,275,3,272
2025-09-18,15,Kínder,SuperSchool,136,16,120
2025-09-18,15,Kínder,EduMax,114,10,104
2025-09-18,15,Kínder,EduMax,108,17,91
2025-09-18,15,Kínder,TopKids,157,20,137
2025-09-18,15,Kínder,SuperSchool,289,24,265
2025-09-18,15,Kínder,EduMax,128,23,105
2025-09-18,15,Primaria 1°,SuperSchool,119,18,101
2025-09-18,15,Primaria 1°,SuperSchool,196,22,174
2025-09-18,15,Primaria 1°,TopKids,173,5,168
2025-09-18,15,Primaria 1°,EduMax,116,7,109
2025-09-18,15,Primaria 1°,TopKids,205,1,204
2025-09-18,15,Primaria 1°,EduMax,158,13,145
2025-09-18,15,Primaria 1°,TopKids,100,7,93
2025-09-18,15,Primaria 2°,EduMax,100,18,82
2025-09-18,15,Primaria 2°,EduMax,281,8,273
2025-09-18,15,Primaria 2°,TopKids,90,13,77
2025-09-18,15,Primaria 2°,SuperSchool,108,13,95
2025-09-18,15,Primaria 2°,EduMax,216,7,209
2025-09-18,15,Primaria 3°,EduMax,274,14,260
2025-09-18,15,Primaria 3°,EduMax,272,13,259
2025-09-18,15,Primaria 3°,SuperSchool,166,20,146
2025-09-18,15,Primaria 3°,EduMax,204,21,183
2025-09-18,15,Primaria 3°,SuperSchool,212,15,197
2025-09-18,15,Primaria 3°,EduMax,168,10,158
2025-09-18,15,Primaria 3°,TopKids,77,8,69
2025-09-18,15,Primaria 3°,SuperSchool,218,1,217
2025-09-18,15,Primaria 4°,TopKids,57,5,52
2025-09-18,15,Primaria 4°,EduMax,235,9,226
2025-09-18,15,Primaria 4°,SuperSchool,210,19,191
2025-09-18,15,Primaria 4°,EduMax,255,14,241
2025-09-18,15,Primaria 4°,TopKids,165,11,154
2025-09-18,15,Primaria 4°,EduMax,227,10,217
2025-09-18,15,Primaria 4°,SuperSchool,168,14,154
2025-09-18,15,Primaria 4°,SuperSchool,205,10,195
2025-09-18,15,Primaria 4°,EduMax,216,24,192
2025-09-18,15,Primaria 4°,TopKids,181,14,167
2025-09-18,15,Primaria 4°,SuperSchool,149,6,143
2025-09-18,15,Primaria 4°,EduMax,147,1,146
2025-09-18,15,Primaria 4°,TopKids,194,4,190
2025-09-18,15,Primaria 4°,SuperSchool,99,13,86
2025-09-18,15,Primaria 4°,TopKids,108,11,97
2025-09-18,15,Primaria 4°,TopKids,133,1,132
2025-09-18,15,Primaria 4°,SuperSchool,107,4,103
2025-09-18,15,Primaria 5°,EduMax,254,14,240
2025-09-18,15,Primaria 5°,SuperSchool,174,20,154
2025-09-18,15,Primaria 5°,EduMax,240,22,218
2025-09-18,15,Primaria 5°,EduMax,295,4,291
2025-09-18,15,Primaria 5°,SuperSchool,139,8,131
2025-09-18,15,Primaria 5°,SuperSchool,209,12,197
2025-09-18,15,Primaria 5°,SuperSchool,203,4,199
2025-09-18,15,Primaria 5°,EduMax,287,2,285
2025-09-18,15,Primaria 5°,SuperSchool,201,8,193
2025-09-18,15,Primaria 5°,TopKids,216,13,203
2025-09-18,15,Primaria 5°,SuperSchool,208,11,197
2025-09-18,15,Primaria 5°,TopKids,292,10,282
2025-09-18,15,Primaria 5°,TopKids,97,8,89
2025-09-18,15,Primaria 5°,EduMax,159,17,142
2025-09-18,15,Primaria 5°,SuperSchool,284,1,283
2025-09-18,15,Primaria 6°,SuperSchool,169,24,145
2025-09-18,15,Primaria 6°,SuperSchool,245,24,221
2025-09-18,15,Primaria 6°,TopKids,133,1,132
2025-09-18,15,Primaria 6°,TopKids,94,3,91
2025-09-18,15,Primaria 6°,EduMax,200,1,199
2025-09-18,15,Primaria 6°,EduMax,111,15,96
2025-09-18,15,Primaria 6°,TopKids,53,20,33
2025-09-18,16,Preescolar,TopKids,108,7,101
2025-09-18,16,Preescolar,SuperSchool,118,14,104
2025-09-18,16,Preescolar,EduMax,279,23,256
2025-09-18,16,Preescolar,TopKids,157,7,150
2025-09-18,16,Preescolar,EduMax,167,16,151
2025-09-18,16,Preescolar,SuperSchool,280,23,257
2025-09-18,16,Preescolar,SuperSchool,287,2,285
2025-09-18,16,Preescolar,EduMax,208,13,195
2025-09-18,16,Preescolar,EduMax,184,19,165
2025-09-18,16,Preescolar,EduMax,55,12,43
2025-09-18,16,Preescolar,SuperSchool,211,17,194
2025-09-18,16,Preescolar,EduMax,125,20,105
2025-09-18,16,Preescolar,SuperSchool,235,14,221
2025-09-18,16,Preescolar,TopKids,148,22,126
2025-09-18,16,Preescolar,SuperSchool,97,6,91
2025-09-18,16,Preescolar,TopKids,281,13,268
2025-09-18,16,Preescolar,EduMax,199,8,191
2025-09-18,16,Preescolar,TopKids,182,20,162
2025-09-18,16,Kínder,SuperSchool,167,8,159
2025-09-18,16,Kínder,TopKids,175,20,155
2025-09-18,16,Kínder,TopKids,228,21,207
2025-09-18,16,Kínder,TopKids,289,12,277
2025-09-18,16,Kínder,TopKids,106,9,97
2025-09-18,16,Primaria 1°,EduMax,206,14,192
2025-09-18,16,Primaria 1°,TopKids,250,5,245
2025-09-18,16,Primaria 1°,TopKids,138,1,137
2025-09-18,16,Primaria 1°,EduMax,158,4,154
2025-09-18,16,Primaria 1°,EduMax,90,7,83
2025-09-18,16,Primaria 1°,TopKids,158,2,156
2025-09-18,16,Primaria 1°,TopKids,236,4,232
2025-09-18,16,Primaria 1°,SuperSchool,103,18,85
2025-09-18,16,Primaria 1°,SuperSchool,244,2,242
2025-09-18,16,Primaria 1°,EduMax,97,21,76
2025-09-18,16,Primaria 1°,EduMax,177,19,158
2025-09-18,16,Primaria 2°,TopKids,111,15,96
2025-09-18,16,Primaria 2°,SuperSchool,116,19,97
2025-09-18,16,Primaria 2°,EduMax,224,20,204
2025-09-18,16,Primaria 2°,SuperSchool,296,7,289
2025-09-18,16,Primaria 2°,SuperSchool,282,7,275
2025-09-18,16,Primaria 2°,EduMax,278,9,269
2025-09-18,16,Primaria 2°,EduMax,76,6,70
2025-09-18,16,Primaria 3°,TopKids,177,12,165
2025-09-18,16,Primaria 3°,SuperSchool,146,15,131
2025-09-18,16,Primaria 3°,EduMax,250,10,240
2025-09-18,16,Primaria 3°,TopKids,97,15,82
2025-09-18,16,Primaria 3°,TopKids,275,8,267
2025-09-18,16,Primaria 3°,EduMax,161,23,138
2025-09-18,16,Primaria 3°,SuperSchool,209,3,206
2025-09-18,16,Primaria 3°,SuperSchool,145,13,132
2025-09-18,16,Primaria 3°,SuperSchool,143,5,138
2025-09-18,16,Primaria 3°,SuperSchool,212,13,199
2025-09-18,16,Primaria 3°,SuperSchool,224,4,220
2025-09-18,16,Primaria 3°,EduMax,266,18,248
2025-09-18,16,Primaria 4°,EduMax,50,4,46
2025-09-18,16,Primaria 4°,EduMax,252,15,237
2025-09-18,16,Primaria 4°,TopKids,145,15,130
2025-09-18,16,Primaria 4°,TopKids,180,19,161
2025-09-18,16,Primaria 4°,TopKids,197,24,173
2025-09-18,16,Primaria 4°,EduMax,148,8,140
2025-09-18,16,Primaria 4°,EduMax,122,24,98
2025-09-18,16,Primaria 4°,TopKids,201,9,192
2025-09-18,16,Primaria 4°,TopKids,265,1,264
2025-09-18,16,Primaria 4°,EduMax,272,10,262
2025-09-18,16,Primaria 4°,SuperSchool,213,10,203
2025-09-18,16,Primaria 5°,EduMax,97,18,79
2025-09-18,16,Primaria 5°,SuperSchool,125,21,104
2025-09-18,16,Primaria 5°,TopKids,58,24,34
2025-09-18,16,Primaria 5°,EduMax,246,5,241
2025-09-18,16,Primaria 5°,TopKids,132,22,110
2025-09-18,16,Primaria 5°,EduMax,131,15,116
2025-09-18,16,Primaria 5°,SuperSchool,146,7,139
2025-09-18,16,Primaria 6°,SuperSchool,89,5,84
2025-09-18,16,Primaria 6°,TopKids,246,5,241
2025-09-18,16,Primaria 6°,TopKids,113,7,106
2025-09-18,16,Primaria 6°,EduMax,79,17,62
2025-09-18,16,Primaria 6°,TopKids,101,5,96
2025-09-18,16,Primaria 6°,TopKids,82,9,73
2025-09-18,16,Primaria 6°,TopKids,173,12,161
2025-09-19,9,Preescolar,EduMax,124,1,123
2025-09-19,9,Preescolar,SuperSchool,197,5,192
2025-09-19,9,Preescolar,TopKids,73,22,51
2025-09-19,9,Preescolar,TopKids,155,12,143
2025-09-19,9,Preescolar,EduMax,196,10,186
2025-09-19,9,Preescolar,EduMax,273,12,261
2025-09-19,9,Preescolar,EduMax,134,19,115
2025-09-19,9,Preescolar,SuperSchool,228,21,207
2025-09-19,9,Preescolar,EduMax,121,23,98
2025-09-19,9,Preescolar,TopKids,149,16,133
2025-09-19,9,Preescolar,TopKids,189,18,171
2025-09-19,9,Preescolar,EduMax,149,16,133
2025-09-19,9,Preescolar,EduMax,68,16,52
2025-09-19,9,Preescolar,TopKids,102,3,99
2025-09-19,9,Kínder,TopKids,116,13,103
2025-09-19,9,Kínder,EduMax,100,9,91
2025-09-19,9,Kínder,TopKids,92,3,89
2025-09-19,9,Kínder,TopKids,193,3,190
2025-09-19,9,Kínder,SuperSchool,248,21,227
2025-09-19,9,Primaria 1°,EduMax,242,19,223
2025-09-19,9,Primaria 1°,EduMax,109,15,94
2025-09-19,9,Primaria 1°,TopKids,73,4,69
2025-09-19,9,Primaria 1°,SuperSchool,236,14,222
2025-09-19,9,Primaria 1°,EduMax,88,8,80
2025-09-19,9,Primaria 1°,EduMax,129,14,115
2025-09-19,9,Primaria 1°,SuperSchool,246,9,237
2025-09-19,9,Primaria 1°,TopKids,241,21,220
2025-09-19,9,Primaria 1°,EduMax,214,20,194
2025-09-19,9,Primaria 1°,EduMax,70,10,60
2025-09-19,9,Primaria 1°,SuperSchool,258,8,250
2025-09-19,9,Primaria 1°,SuperSchool,261,17,244
2025-09-19,9,Primaria 1°,EduMax,150,7,143
2025-09-19,9,Primaria 2°,SuperSchool,236,10,226
2025-09-19,9,Primaria 2°,TopKids,247,7,240
2025-09-19,9,Primaria 2°,TopKids,140,10,130
2025-09-19,9,Primaria 2°,SuperSchool,137,6,131
2025-09-19,9,Primaria 2°,EduMax,74,2,72
2025-09-19,9,Primaria 2°,EduMax,108,18,90
2025-09-19,9,Primaria 2°,EduMax,56,17,39
2025-09-19,9,Primaria 2°,SuperSchool,251,19,232
2025-09-19,9,Primaria 2°,SuperSchool,269,24,245
2025-09-19,9,Primaria 2°,SuperSchool,187,16,171
2025-09-19,9,Primaria 2°,SuperSchool,76,23,53
2025-09-19,9,Primaria 2°,SuperSchool,268,5,263
2025-09-19,9,Primaria 2°,SuperSchool,276,22,254
2025-09-19,9,Primaria 2°,TopKids,213,10,203
2025-09-19,9,Primaria 2°,EduMax,101,22,79
2025-09-19,9,Primaria 2°,SuperSchool,183,14,169
2025-09-19,9,Primaria 2°,TopKids,106,24,82
2025-09-19,9,Primaria 3°,EduMax,260,20,240
2025-09-19,9,Primaria 3°,EduMax,262,15,247
2025-09-19,9,Primaria 3°,SuperSchool,238,12,226
2025-09-19,9,Primaria 3°,SuperSchool,158,20,138
2025-09-19,9,Primaria 3°,SuperSchool,225,15,210
2025-09-19,9,Primaria 3°,TopKids,150,18,132
2025-09-19,9,Primaria 3°,SuperSchool,284,10,274
2025-09-19,9,Primaria 3°,TopKids,280,12,268
2025-09-19,9,Primaria 3°,EduMax,151,9,142
2025-09-19,9,Primaria 4°,EduMax,285,19,266
2025-09-19,9,Primaria 4°,TopKids,289,4,285
2025-09-19,9,Primaria 4°,TopKids,229,16,213
2025-09-19,9,Primaria 4°,TopKids,240,13,227
2025-09-19,9,Primaria 4°,TopKids,253,1,252
2025-09-19,9,Primaria 4°,TopKids,188,17,171
2025-09-19,9,Primaria 4°,EduMax,115,3,112
2025-09-19,9,Primaria 4°,EduMax,163,24,139
2025-09-19,9,Primaria 4°,SuperSchool,199,19,180
2025-09-19,9,Primaria 4°,SuperSchool,271,7,264
2025-09-19,9,Primaria 4°,SuperSchool,289,23,266
2025-09-19,9,Primaria 4°,EduMax,184,20,164
2025-09-19,9,Primaria 5°,EduMax,127,22,105
2025-09-19,9,Primaria 5°,SuperSchool,277,12,265
2025-09-19,9,Primaria 5°,SuperSchool,80,8,72
2025-09-19,9,Primaria 5°,TopKids,186,12,174
2025-09-19,9,Primaria 5°,SuperSchool,269,16,253
2025-09-19,9,Primaria 5°,TopKids,162,13,149
2025-09-19,9,Primaria 5°,EduMax,109,15,94
2025-09-19,9,Primaria 5°,SuperSchool,230,24,206
2025-09-19,9,Primaria 5°,SuperSchool,157,22,135
2025-09-19,9,Primaria 5°,TopKids,292,9,283
2025-09-19,9,Primaria 5°,EduMax,158,18,140
2025-09-19,9,Primaria 5°,SuperSchool,133,3,130
2025-09-19,9,Primaria 5°,TopKids,284,2,282
2025-09-19,9,Primaria 5°,EduMax,208,3,205
2025-09-19,9,Primaria 6°,SuperSchool,122,14,108
2025-09-19,9,Primaria 6°,TopKids,137,24,113
2025-09-19,9,Primaria 6°,EduMax,172,22,150
2025-09-19,9,Primaria 6°,EduMax,213,18,195
2025-09-19,9,Primaria 6°,EduMax,155,12,143
2025-09-19,9,Primaria 6°,TopKids,204,16,188
2025-09-19,9,Primaria 6°,SuperSchool,95,24,71
2025-09-19,9,Primaria 6°,SuperSchool,262,24,238
2025-09-19,9,Primaria 6°,EduMax,114,2,112
2025-09-19,9,Primaria 6°,EduMax,279,15,264
2025-09-19,9,Primaria 6°,SuperSchool,265,9,256
2025-09-19,9,Primaria 6°,TopKids,214,6,208
2025-09-19,9,Primaria 6°,TopKids,94,12,82
2025-09-19,9,Primaria 6°,TopKids,248,20,228
2025-09-19,10,Preescolar,EduMax,212,2,210
2025-09-19,10,Preescolar,EduMax,197,21,176
2025-09-19,10,Preescolar,SuperSchool,141,21,120
2025-09-19,10,Preescolar,EduMax,254,10,244
2025-09-19,10,Preescolar,SuperSchool,199,5,194
2025-09-19,10,Preescolar,SuperSchool,188,19,169
2025-09-19,10,Preescolar,TopKids,207,4,203
2025-09-19,10,Preescolar,EduMax,233,9,224
2025-09-19,10,Preescolar,TopKids,67,9,58
2025-09-19,10,Preescolar,EduMax,247,13,234
2025-09-19,10,Preescolar,EduMax,258,15,243
2025-09-19,10,Preescolar,SuperSchool,247,23,224
2025-09-19,10,Preescolar,TopKids,258,5,253
2025-09-19,10,Preescolar,TopKids,170,16,154
2025-09-19,10,Preescolar,EduMax,293,3,290
2025-09-19,10,Preescolar,SuperSchool,228,14,214
2025-09-19,10,Kínder,EduMax,226,8,218
2025-09-19,10,Kínder,SuperSchool,76,17,59
2025-09-19,10,Kínder,TopKids,122,4,118
2025-09-19,10,Kínder,EduMax,142,4,138
2025-09-19,10,Kínder,SuperSchool,150,2,148
2025-09-19,10,Kínder,TopKids,205,9,196
2025-09-19,10,Kínder,EduMax,58,1,57
2025-09-19,10,Kínder,SuperSchool,94,20,74
2025-09-19,10,Kínder,SuperSchool,191,10,181
2025-09-19,10,Kínder,SuperSchool,194,14,180
2025-09-19,10,Kínder,SuperSchool,292,3,289
2025-09-19,10,Kínder,TopKids,257,13,244
2025-09-19,10,Kínder,EduMax,252,11,241
2025-09-19,10,Kínder,SuperSchool,299,23,276
2025-09-19,10,Kínder,EduMax,180,14,166
2025-09-19,10,Kínder,SuperSchool,193,4,189
2025-09-19,10,Kínder,SuperSchool,117,13,104
2025-09-19,10,Kínder,EduMax,168,18,150
2025-09-19,10,Primaria 1°,EduMax,170,5,165
2025-09-19,10,Primaria 1°,SuperSchool,198,10,188
2025-09-19,10,Primaria 1°,TopKids,268,23,245
2025-09-19,10,Primaria 1°,EduMax,247,22,225
2025-09-19,10,Primaria 1°,TopKids,75,10,65
2025-09-19,10,Primaria 1°,SuperSchool,246,7,239
2025-09-19,10,Primaria 1°,SuperSchool,153,1,152
2025-09-19,10,Primaria 1°,SuperSchool,147,16,131
2025-09-19,10,Primaria 1°,SuperSchool,208,15,193
2025-09-19,10,Primaria 1°,TopKids,252,16,236
2025-09-19,10,Primaria 1°,TopKids,56,17,39
2025-09-19,10,Primaria 1°,SuperSchool,148,15,133
2025-09-19,10,Primaria 2°,TopKids,252,2,250
2025-09-19,10,Primaria 2°,TopKids,235,15,220
2025-09-19,10,Primaria 2°,EduMax,134,7,127
2025-09-19,10,Primaria 2°,SuperSchool,219,18,201
2025-09-19,10,Primaria 2°,EduMax,87,22,65
2025-09-19,10,Primaria 2°,TopKids,59,17,42
2025-09-19,10,Primaria 2°,SuperSchool,164,20,144
2025-09-19,10,Primaria 2°,SuperSchool,223,7,216
2025-09-19,10,Primaria 2°,TopKids,105,7,98
2025-09-19,10,Primaria 2°,EduMax,215,8,207
2025-09-19,10,Primaria 2°,SuperSchool,227,10,217
2025-09-19,10,Primaria 2°,SuperSchool,139,21,118
2025-09-19,10,Primaria 2°,SuperSchool,50,7,43
2025-09-19,10,Primaria 2°,EduMax,267,9,258
2025-09-19,10,Primaria 2°,SuperSchool,75,10,65
2025-09-19,10,Primaria 2°,EduMax,91,7,84
2025-09-19,10,Primaria 2°,SuperSchool,297,15,282
2025-09-19,10,Primaria 3°,SuperSchool,204,11,193
2025-09-19,10,Primaria 3°,SuperSchool,196,18,178
2025-09-19,10,Primaria 3°,TopKids,160,6,154
2025-09-19,10,Primaria 3°,EduMax,244,10,234
2025-09-19,10,Primaria 3°,SuperSchool,193,4,189
2025-09-19,10,Primaria 3°,SuperSchool,167,18,149
2025-09-19,10,Primaria 3°,SuperSchool,262,4,258
2025-09-19,10,Primaria 3°,TopKids,197,19,178
2025-09-19,10,Primaria 3°,TopKids,165,13,152
2025-09-19,10,Primaria 3°,SuperSchool,170,24,146
2025-09-19,10,Primaria 3°,EduMax,205,6,199
2025-09-19,10,Primaria 3°,EduMax,151,22,129
2025-09-19,10,Primaria 3°,SuperSchool,74,17,57
2025-09-19,10,Primaria 3°,SuperSchool,246,17,229
2025-09-19,10,Primaria 4°,SuperSchool,197,2,195
2025-09-19,10,Primaria 4°,TopKids,58,8,50
2025-09-19,10,Primaria 4°,TopKids,158,24,134
2025-09-19,10,Primaria 4°,EduMax,277,11,266
2025-09-19,10,Primaria 4°,SuperSchool,155,16,139
2025-09-19,10,Primaria 4°,SuperSchool,177,18,159
2025-09-19,10,Primaria 4°,SuperSchool,164,21,143
2025-09-19,10,Primaria 4°,TopKids,110,12,98
2025-09-19,10,Primaria 4°,EduMax,237,18,219
2025-09-19,10,Primaria 4°,EduMax,293,1,292
2025-09-19,10,Primaria 4°,SuperSchool,110,3,107
2025-09-19,10,Primaria 4°,EduMax,199,18,181
2025-09-19,10,Primaria 4°,TopKids,100,1,99
2025-09-19,10,Primaria 4°,TopKids,161,10,151
2025-09-19,10,Primaria 5°,SuperSchool,277,11,266
2025-09-19,10,Primaria 5°,SuperSchool,292,11,281
2025-09-19,10,Primaria 5°,EduMax,256,2,254
2025-09-19,10,Primaria 5°,SuperSchool,200,12,188
2025-09-19,10,Primaria 5°,EduMax,175,1,174
2025-09-19,10,Primaria 5°,SuperSchool,202,3,199
2025-09-19,10,Primaria 5°,TopKids,114,11,103
2025-09-19,10,Primaria 5°,EduMax,239,11,228
2025-09-19,10,Primaria 6°,EduMax,228,12,216
2025-09-19,10,Primaria 6°,TopKids,254,17,237
2025-09-19,10,Primaria 6°,TopKids,117,6,111
2025-09-19,10,Primaria 6°,TopKids,284,22,262
2025-09-19,10,Primaria 6°,EduMax,176,14,162
2025-09-19,10,Primaria 6°,TopKids,137,21,116
2025-09-19,11,Preescolar,EduMax,97,3,94
2025-09-19,11,Preescolar,EduMax,121,24,97
2025-09-19,11,Preescolar,TopKids,286,24,262
2025-09-19,11,Preescolar,SuperSchool,129,1,128
2025-09-19,11,Preescolar,SuperSchool,255,8,247
2025-09-19,11,Kínder,TopKids,71,7,64
2025-09-19,11,Kínder,TopKids,253,23,230
2025-09-19,11,Kínder,SuperSchool,103,18,85
2025-09-19,11,Kínder,EduMax,158,3,155
2025-09-19,11,Kínder,TopKids,132,8,124
2025-09-19,11,Kínder,TopKids,204,5,199
2025-09-19,11,Kínder,SuperSchool,276,1,275
2025-09-19,11,Kínder,SuperSchool,187,10,177
2025-09-19,11,Kínder,TopKids,68,20,48
2025-09-19,11,Kínder,SuperSchool,192,10,182
2025-09-19,11,Kínder,TopKids,128,6,122
2025-09-19,11,Kínder,EduMax,98,13,85
2025-09-19,11,Kínder,SuperSchool,128,7,121
2025-09-19,11,Kínder,TopKids,199,11,188
2025-09-19,11,Kínder,EduMax,133,19,114
2025-09-19,11,Primaria 1°,EduMax,59,18,41
2025-09-19,11,Primaria 1°,SuperSchool,218,3,215
2025-09-19,11,Primaria 1°,TopKids,169,23,146
2025-09-19,11,Primaria 1°,SuperSchool,76,6,70
2025-09-19,11,Primaria 1°,EduMax,186,10,176
2025-09-19,11,Primaria 1°,EduMax,116,6,110
2025-09-19,11,Primaria 1°,EduMax,286,14,272
2025-09-19,11,Primaria 1°,EduMax,109,19,90
2025-09-19,11,Primaria 1°,TopKids,136,5,131
2025-09-19,11,Primaria 1°,TopKids,271,1,270
2025-09-19,11,Primaria 1°,EduMax,215,19,196
2025-09-19,11,Primaria 1°,SuperSchool,250,7,243
2025-09-19,11,Primaria 1°,SuperSchool,295,16,279
2025-09-19,11,Primaria 1°,SuperSchool,187,21,166
2025-09-19,11,Primaria 1°,SuperSchool,288,15,273
2025-09-19,11,Primaria 2°,EduMax,296,7,289
2025-09-19,11,Primaria 2°,TopKids,297,9,288
2025-09-19,11,Primaria 2°,EduMax,101,2,99
2025-09-19,11,Primaria 2°,SuperSchool,199,23,176
2025-09-19,11,Primaria 2°,EduMax,53,20,33
2025-09-19,11,Primaria 2°,TopKids,56,1,55
2025-09-19,11,Primaria 2°,TopKids,235,18,217
2025-09-19,11,Primaria 2°,EduMax,104,21,83
2025-09-19,11,Primaria 2°,SuperSchool,77,14,63
2025-09-19,11,Primaria 2°,TopKids,65,14,51
2025-09-19,11,Primaria 2°,TopKids,170,3,167
2025-09-19,11,Primaria 2°,EduMax,180,9,171
2025-09-19,11,Primaria 2°,SuperSchool,217,19,198
2025-09-19,11,Primaria 2°,SuperSchool,197,15,182
2025-09-19,11,Primaria 2°,TopKids,93,14,79
2025-09-19,11,Primaria 2°,EduMax,138,2,136
2025-09-19,11,Primaria 2°,SuperSchool,220,24,196
2025-09-19,11,Primaria 3°,TopKids,139,14,125
2025-09-19,11,Primaria 3°,SuperSchool,116,14,102
2025-09-19,11,Primaria 3°,TopKids,264,4,260
2025-09-19,11,Primaria 3°,SuperSchool,51,2,49
2025-09-19,11,Primaria 3°,SuperSchool,160,23,137
2025-09-19,11,Primaria 4°,SuperSchool,286,20,266
2025-09-19,11,Primaria 4°,TopKids,255,17,238
2025-09-19,11,Primaria 4°,EduMax,192,14,178
2025-09-19,11,Primaria 4°,TopKids,80,2,78
2025-09-19,11,Primaria 4°,SuperSchool,153,12,141
2025-09-19,11,Primaria 4°,TopKids,126,23,103
2025-09-19,11,Primaria 4°,EduMax,258,13,245
2025-09-19,11,Primaria 4°,TopKids,269,16,253
2025-09-19,11,Primaria 4°,EduMax,150,11,139
2025-09-19,11,Primaria 5°,SuperSchool,235,21,214
2025-09-19,11,Primaria 5°,TopKids,281,9,272
2025-09-19,11,Primaria 5°,EduMax,249,7,242
2025-09-19,11,Primaria 5°,TopKids,208,19,189
2025-09-19,11,Primaria 5°,TopKids,273,21,252
2025-09-19,11,Primaria 5°,TopKids,103,4,99
2025-09-19,11,Primaria 5°,TopKids,179,12,167
2025-09-19,11,Primaria 5°,EduMax,119,14,105
2025-09-19,11,Primaria 5°,EduMax,114,6,108
2025-09-19,11,Primaria 5°,EduMax,267,21,246
2025-09-19,11,Primaria 5°,TopKids,299,1,298
2025-09-19,11,Primaria 5°,SuperSchool,106,19,87
2025-09-19,11,Primaria 6°,EduMax,267,2,265
2025-09-19,11,Primaria 6°,TopKids,130,18,112
2025-09-19,11,Primaria 6°,EduMax,81,24,57
2025-09-19,11,Primaria 6°,EduMax,144,18,126
2025-09-19,11,Primaria 6°,SuperSchool,273,12,261
2025-09-19,11,Primaria 6°,TopKids,128,3,125
2025-09-19,11,Primaria 6°,SuperSchool,212,11,201
2025-09-19,11,Primaria 6°,SuperSchool,191,7,184
2025-09-19,11,Primaria 6°,EduMax,215,22,193
2025-09-19,11,Primaria 6°,EduMax,104,11,93
2025-09-19,11,Primaria 6°,TopKids,102,14,88
2025-09-19,11,Primaria 6°,SuperSchool,239,14,225
2025-09-19,11,Primaria 6°,TopKids,144,23,121
2025-09-19,11,Primaria 6°,SuperSchool,260,12,248
2025-09-19,11,Primaria 6°,TopKids,226,14,212
2025-09-19,11,Primaria 6°,SuperSchool,224,14,210
2025-09-19,11,Primaria 6°,TopKids,228,19,209
2025-09-19,12,Preescolar,TopKids,185,13,172
2025-09-19,12,Preescolar,SuperSchool,86,4,82
2025-09-19,12,Preescolar,SuperSchool,260,20,240
2025-09-19,12,Preescolar,EduMax,292,3,289
2025-09-19,12,Preescolar,TopKids,81,5,76
2025-09-19,12,Preescolar,SuperSchool,207,20,187
2025-09-19,12,Preescolar,EduMax,78,24,54
2025-09-19,12,Preescolar,SuperSchool,284,21,263
2025-09-19,12,Preescolar,SuperSchool,141,12,129
2025-09-19,12,Preescolar,EduMax,147,22,125
2025-09-19,12,Preescolar,EduMax,170,19,151
2025-09-19,12,Preescolar,EduMax,97,8,89
2025-09-19,12,Preescolar,EduMax,182,4,178
2025-09-19,12,Preescolar,SuperSchool,149,1,148
2025-09-19,12,Preescolar,TopKids,254,17,237
2025-09-19,12,Preescolar,EduMax,137,23,114
2025-09-19,12,Preescolar,SuperSchool,262,24,238
2025-09-19,12,Preescolar,EduMax,295,24,271
2025-09-19,12,Kínder,SuperSchool,201,12,189
2025-09-19,12,Kínder,EduMax,83,15,68
2025-09-19,12,Kínder,TopKids,294,4,290
2025-09-19,12,Kínder,SuperSchool,191,1,190
2025-09-19,12,Kínder,SuperSchool,173,18,155
2025-09-19,12,Kínder,TopKids,284,18,266
2025-09-19,12,Kínder,SuperSchool,297,10,287
2025-09-19,12,Kínder,EduMax,135,18,117
2025-09-19,12,Kínder,SuperSchool,269,7,262
2025-09-19,12,Kínder,TopKids,277,18,259
2025-09-19,12,Primaria 1°,EduMax,278,6,272
2025-09-19,12,Primaria 1°,TopKids,204,19,185
2025-09-19,12,Primaria 1°,EduMax,262,5,257
2025-09-19,12,Primaria 1°,SuperSchool,282,24,258
2025-09-19,12,Primaria 1°,EduMax,208,5,203
2025-09-19,12,Primaria 1°,TopKids,247,15,232
2025-09-19,12,Primaria 1°,TopKids,265,22,243
2025-09-19,12,Primaria 1°,EduMax,195,23,172
2025-09-19,12,Primaria 1°,SuperSchool,173,19,154
2025-09-19,12,Primaria 1°,SuperSchool,238,7,231
2025-09-19,12,Primaria 1°,EduMax,262,4,258
2025-09-19,12,Primaria 1°,EduMax,109,17,92
2025-09-19,12,Primaria 1°,TopKids,288,8,280
2025-09-19,12,Primaria 2°,EduMax,75,8,67
2025-09-19,12,Primaria 2°,EduMax,232,16,216
2025-09-19,12,Primaria 2°,TopKids,260,7,253
2025-09-19,12,Primaria 2°,SuperSchool,54,13,41
2025-09-19,12,Primaria 2°,EduMax,131,19,112
2025-09-19,12,Primaria 2°,TopKids,99,20,79
2025-09-19,12,Primaria 2°,SuperSchool,264,4,260
2025-09-19,12,Primaria 2°,SuperSchool,164,8,156
2025-09-19,12,Primaria 2°,SuperSchool,241,7,234
2025-09-19,12,Primaria 2°,SuperSchool,145,9,136
2025-09-19,12,Primaria 2°,EduMax,145,7,138
2025-09-19,12,Primaria 2°,SuperSchool,71,8,63
2025-09-19,12,Primaria 2°,EduMax,86,3,83
2025-09-19,12,Primaria 2°,SuperSchool,105,22,83
2025-09-19,12,Primaria 2°,SuperSchool,152,10,142
2025-09-19,12,Primaria 2°,SuperSchool,226,4,222
2025-09-19,12,Primaria 2°,SuperSchool,185,19,166
2025-09-19,12,Primaria 2°,EduMax,290,10,280
2025-09-19,12,Primaria 3°,EduMax,134,16,118
2025-09-19,12,Primaria 3°,EduMax,154,5,149
2025-09-19,12,Primaria 3°,EduMax,159,17,142
2025-09-19,12,Primaria 3°,TopKids,286,13,273
2025-09-19,12,Primaria 3°,TopKids,286,18,268
2025-09-19,12,Primaria 4°,TopKids,82,22,60
2025-09-19,12,Primaria 4°,SuperSchool,144,4,140
2025-09-19,12,Primaria 4°,SuperSchool,246,11,235
2025-09-19,12,Primaria 4°,EduMax,172,2,170
2025-09-19,12,Primaria 4°,SuperSchool,110,16,94
2025-09-19,12,Primaria 4°,TopKids,55,20,35
2025-09-19,12,Primaria 4°,SuperSchool,102,7,95
2025-09-19,12,Primaria 4°,TopKids,239,17,222
2025-09-19,12,Primaria 4°,EduMax,213,2,211
2025-09-19,12,Primaria 4°,EduMax,280,2,278
2025-09-19,12,Primaria 4°,EduMax,283,7,276
2025-09-19,12,Primaria 4°,SuperSchool,100,19,81
2025-09-19,12,Primaria 5°,EduMax,138,23,115
2025-09-19,12,Primaria 5°,SuperSchool,125,19,106
2025-09-19,12,Primaria 5°,EduMax,79,24,55
2025-09-19,12,Primaria 5°,SuperSchool,256,22,234
2025-09-19,12,Primaria 5°,TopKids,127,24,103
2025-09-19,12,Primaria 5°,SuperSchool,286,5,281
2025-09-19,12,Primaria 5°,EduMax,160,16,144
2025-09-19,12,Primaria 5°,TopKids,240,22,218
2025-09-19,12,Primaria 5°,EduMax,173,17,156
2025-09-19,12,Primaria 5°,TopKids,178,6,172
2025-09-19,12,Primaria 5°,TopKids,119,4,115
2025-09-19,12,Primaria 5°,SuperSchool,122,22,100
2025-09-19,12,Primaria 6°,TopKids,217,2,215
2025-09-19,12,Primaria 6°,SuperSchool,82,14,68
2025-09-19,12,Primaria 6°,EduMax,104,5,99
2025-09-19,12,Primaria 6°,SuperSchool,133,17,116
2025-09-19,12,Primaria 6°,EduMax,210,18,192
2025-09-19,12,Primaria 6°,TopKids,277,20,257
2025-09-19,12,Primaria 6°,EduMax,249,19,230
2025-09-19,12,Primaria 6°,TopKids,135,19,116
2025-09-19,12,Primaria 6°,EduMax,238,4,234
2025-09-19,12,Primaria 6°,EduMax,189,19,170
2025-09-19,12,Primaria 6°,SuperSchool,203,15,188
2025-09-19,12,Primaria 6°,EduMax,152,2,150
2025-09-19,12,Primaria 6°,SuperSchool,257,21,236
2025-09-19,12,Primaria 6°,TopKids,114,17,97
2025-09-19,13,Preescolar,TopKids,172,22,150
2025-09-19,13,Preescolar,TopKids,255,7,248
2025-09-19,13,Preescolar,EduMax,228,10,218
2025-09-19,13,Preescolar,SuperSchool,60,20,40
2025-09-19,13,Preescolar,SuperSchool,103,23,80
2025-09-19,13,Preescolar,SuperSchool,56,12,44
2025-09-19,13,Preescolar,EduMax,152,21,131
2025-09-19,13,Preescolar,EduMax,273,5,268
2025-09-19,13,Preescolar,TopKids,144,22,122
2025-09-19,13,Preescolar,SuperSchool,85,21,64
2025-09-19,13,Preescolar,SuperSchool,196,3,193
2025-09-19,13,Preescolar,SuperSchool,143,4,139
2025-09-19,13,Preescolar,SuperSchool,211,10,201
2025-09-19,13,Preescolar,SuperSchool,122,8,114
2025-09-19,13,Preescolar,EduMax,252,19,233
2025-09-19,13,Kínder,EduMax,228,17,211
2025-09-19,13,Kínder,TopKids,199,17,182
2025-09-19,13,Kínder,EduMax,288,16,272
2025-09-19,13,Kínder,SuperSchool,281,23,258
2025-09-19,13,Kínder,TopKids,168,21,147
2025-09-19,13,Kínder,TopKids,181,7,174
2025-09-19,13,Kínder,TopKids,271,3,268
2025-09-19,13,Kínder,SuperSchool,211,1,210
2025-09-19,13,Kínder,TopKids,137,6,131
2025-09-19,13,Kínder,EduMax,174,4,170
2025-09-19,13,Primaria 1°,SuperSchool,150,11,139
2025-09-19,13,Primaria 1°,SuperSchool,130,14,116
2025-09-19,13,Primaria 1°,TopKids,127,1,126
2025-09-19,13,Primaria 1°,EduMax,280,11,269
2025-09-19,13,Primaria 1°,EduMax,70,3,67
2025-09-19,13,Primaria 1°,TopKids,77,2,75
2025-09-19,13,Primaria 1°,TopKids,285,12,273
2025-09-19,13,Primaria 1°,SuperSchool,223,11,212
2025-09-19,13,Primaria 1°,SuperSchool,186,18,168
2025-09-19,13,Primaria 1°,EduMax,158,4,154
2025-09-19,13,Primaria 1°,TopKids,149,4,145
2025-09-19,13,Primaria 1°,TopKids,84,19,65
2025-09-19,13,Primaria 1°,EduMax,272,3,269
2025-09-19,13,Primaria 1°,SuperSchool,149,4,145
2025-09-19,13,Primaria 2°,SuperSchool,86,15,71
2025-09-19,13,Primaria 2°,SuperSchool,264,12,252
2025-09-19,13,Primaria 2°,TopKids,288,6,282
2025-09-19,13,Primaria 2°,SuperSchool,118,21,97
2025-09-19,13,Primaria 2°,SuperSchool,205,21,184
2025-09-19,13,Primaria 2°,TopKids,141,11,130
2025-09-19,13,Primaria 3°,EduMax,159,14,145
2025-09-19,13,Primaria 3°,EduMax,298,22,276
2025-09-19,13,Primaria 3°,SuperSchool,90,17,73
2025-09-19,13,Primaria 3°,TopKids,128,2,126
2025-09-19,13,Primaria 3°,SuperSchool,92,22,70
2025-09-19,13,Primaria 3°,TopKids,279,15,264
2025-09-19,13,Primaria 3°,SuperSchool,101,4,97
2025-09-19,13,Primaria 3°,TopKids,195,7,188
2025-09-19,13,Primaria 3°,EduMax,212,12,200
2025-09-19,13,Primaria 3°,TopKids,218,10,208
2025-09-19,13,Primaria 3°,EduMax,242,12,230
2025-09-19,13,Primaria 3°,TopKids,205,24,181
2025-09-19,13,Primaria 3°,EduMax,195,1,194
2025-09-19,13,Primaria 3°,SuperSchool,227,23,204
2025-09-19,13,Primaria 3°,TopKids,258,13,245
2025-09-19,13,Primaria 3°,EduMax,155,14,141
2025-09-19,13,Primaria 3°,SuperSchool,104,6,98
2025-09-19,13,Primaria 3°,TopKids,64,21,43
2025-09-19,13,Primaria 3°,SuperSchool,228,22,206
2025-09-19,13,Primaria 4°,EduMax,84,4,80
2025-09-19,13,Primaria 4°,TopKids,209,12,197
2025-09-19,13,Primaria 4°,EduMax,79,9,70
2025-09-19,13,Primaria 4°,TopKids,129,1,128
2025-09-19,13,Primaria 4°,EduMax,94,23,71
2025-09-19,13,Primaria 4°,SuperSchool,261,3,258
2025-09-19,13,Primaria 4°,TopKids,243,11,232
2025-09-19,13,Primaria 4°,EduMax,225,8,217
2025-09-19,13,Primaria 4°,TopKids,230,4,226
2025-09-19,13,Primaria 4°,TopKids,166,4,162
2025-09-19,13,Primaria 4°,EduMax,191,15,176
2025-09-19,13,Primaria 4°,SuperSchool,290,5,285
2025-09-19,13,Primaria 4°,SuperSchool,157,19,138
2025-09-19,13,Primaria 4°,TopKids,103,9,94
2025-09-19,13,Primaria 4°,TopKids,145,4,141
2025-09-19,13,Primaria 4°,SuperSchool,219,1,218
2025-09-19,13,Primaria 5°,EduMax,270,13,257
2025-09-19,13,Primaria 5°,TopKids,121,17,104
2025-09-19,13,Primaria 5°,SuperSchool,263,1,262
2025-09-19,13,Primaria 5°,TopKids,133,4,129
2025-09-19,13,Primaria 5°,TopKids,258,13,245
2025-09-19,13,Primaria 5°,EduMax,186,14,172
2025-09-19,13,Primaria 5°,SuperSchool,299,3,296
2025-09-19,13,Primaria 5°,SuperSchool,114,20,94
2025-09-19,13,Primaria 5°,EduMax,175,16,159
2025-09-19,13,Primaria 5°,SuperSchool,191,1,190
2025-09-19,13,Primaria 5°,TopKids,259,1,258
2025-09-19,13,Primaria 5°,TopKids,298,5,293
2025-09-19,13,Primaria 5°,TopKids,279,24,255
2025-09-19,13,Primaria 5°,TopKids,286,23,263
2025-09-19,13,Primaria 6°,TopKids,299,15,284
2025-09-19,13,Primaria 6°,TopKids,121,22,99
2025-09-19,13,Primaria 6°,SuperSchool,204,13,191
2025-09-19,13,Primaria 6°,TopKids,75,3,72
2025-09-19,13,Primaria 6°,SuperSchool,258,14,244
2025-09-19,13,Primaria 6°,EduMax,278,12,266
2025-09-19,13,Primaria 6°,EduMax,58,16,42
2025-09-19,13,Primaria 6°,EduMax,292,1,291
2025-09-19,13,Primaria 6°,SuperSchool,281,6,275
2025-09-19,13,Primaria 6°,TopKids,70,14,56
2025-09-19,13,Primaria 6°,EduMax,106,23,83
2025-09-19,13,Primaria 6°,EduMax,97,22,75
2025-09-19,13,Primaria 6°,SuperSchool,138,16,122
2025-09-19,14,Preescolar,TopKids,289,10,279
2025-09-19,14,Preescolar,SuperSchool,285,5,280
2025-09-19,14,Preescolar,SuperSchool,157,3,154
2025-09-19,14,Preescolar,TopKids,77,10,67
2025-09-19,14,Preescolar,SuperSchool,164,11,153
2025-09-19,14,Preescolar,SuperSchool,289,10,279
2025-09-19,14,Preescolar,TopKids,145,3,142
2025-09-19,14,Preescolar,EduMax,177,12,165
2025-09-19,14,Preescolar,EduMax,282,19,263
2025-09-19,14,Preescolar,SuperSchool,94,7,87
2025-09-19,14,Preescolar,EduMax,109,20,89
2025-09-19,14,Preescolar,SuperSchool,152,6,146
2025-09-19,14,Preescolar,EduMax,80,19,61
2025-09-19,14,Preescolar,EduMax,53,15,38
2025-09-19,14,Preescolar,EduMax,82,18,64
2025-09-19,14,Kínder,SuperSchool,164,16,148
2025-09-19,14,Kínder,SuperSchool,83,19,64
2025-09-19,14,Kínder,TopKids,255,15,240
2025-09-19,14,Kínder,EduMax,190,20,170
2025-09-19,14,Kínder,SuperSchool,101,11,90
2025-09-19,14,Kínder,EduMax,147,17,130
2025-09-19,14,Kínder,TopKids,271,4,267
2025-09-19,14,Kínder,TopKids,108,22,86
2025-09-19,14,Kínder,SuperSchool,175,2,173
2025-09-19,14,Kínder,EduMax,237,20,217
2025-09-19,14,Kínder,TopKids,140,15,125
2025-09-19,14,Kínder,TopKids,215,22,193
2025-09-19,14,Primaria 1°,EduMax,111,14,97
2025-09-19,14,Primaria 1°,EduMax,206,7,199
2025-09-19,14,Primaria 1°,SuperSchool,279,24,255
2025-09-19,14,Primaria 1°,EduMax,183,20,163
2025-09-19,14,Primaria 1°,EduMax,219,4,215
2025-09-19,14,Primaria 1°,EduMax,71,1,70
2025-09-19,14,Primaria 1°,TopKids,95,18,77
2025-09-19,14,Primaria 1°,EduMax,154,10,144
2025-09-19,14,Primaria 1°,TopKids,245,21,224
2025-09-19,14,Primaria 1°,SuperSchool,91,13,78
2025-09-19,14,Primaria 1°,EduMax,189,24,165
2025-09-19,14,Primaria 1°,TopKids,132,9,123
2025-09-19,14,Primaria 1°,SuperSchool,71,8,63
2025-09-19,14,Primaria 1°,SuperSchool,269,9,260
2025-09-19,14,Primaria 1°,TopKids,271,21,250
2025-09-19,14,Primaria 1°,TopKids,252,15,237
2025-09-19,14,Primaria 1°,SuperSchool,148,3,145
2025-09-19,14,Primaria 1°,TopKids,235,23,212
2025-09-19,14,Primaria 1°,SuperSchool,86,20,66
2025-09-19,14,Primaria 2°,TopKids,285,18,267
2025-09-19,14,Primaria 2°,SuperSchool,249,14,235
2025-09-19,14,Primaria 2°,EduMax,225,20,205
2025-09-19,14,Primaria 2°,SuperSchool,154,2,152
2025-09-19,14,Primaria 2°,TopKids,99,21,78
2025-09-19,14,Primaria 2°,EduMax,122,11,111
2025-09-19,14,Primaria 2°,TopKids,232,17,215
2025-09-19,14,Primaria 2°,EduMax,100,1,99
2025-09-19,14,Primaria 2°,EduMax,71,3,68
2025-09-19,14,Primaria 2°,TopKids,127,18,109
2025-09-19,14,Primaria 2°,SuperSchool,299,2,297
2025-09-19,14,Primaria 2°,TopKids,194,9,185
2025-09-19,14,Primaria 3°,TopKids,210,21,189
2025-09-19,14,Primaria 3°,SuperSchool,241,14,227
2025-09-19,14,Primaria 3°,EduMax,226,7,219
2025-09-19,14,Primaria 3°,TopKids,80,9,71
2025-09-19,14,Primaria 3°,TopKids,213,10,203
2025-09-19,14,Primaria 3°,TopKids,160,13,147
2025-09-19,14,Primaria 3°,SuperSchool,90,5,85
2025-09-19,14,Primaria 3°,SuperSchool,55,16,39
2025-09-19,14,Primaria 3°,EduMax,196,19,177
2025-09-19,14,Primaria 3°,TopKids,214,1,213
2025-09-19,14,Primaria 3°,SuperSchool,250,21,229
2025-09-19,14,Primaria 3°,TopKids,91,24,67
2025-09-19,14,Primaria 3°,TopKids,134,12,122
2025-09-19,14,Primaria 3°,SuperSchool,227,21,206
2025-09-19,14,Primaria 3°,EduMax,265,1,264
2025-09-19,14,Primaria 3°,EduMax,277,17,260
2025-09-19,14,Primaria 4°,SuperSchool,51,15,36
2025-09-19,14,Primaria 4°,EduMax,120,4,116
2025-09-19,14,Primaria 4°,EduMax,227,11,216
2025-09-19,14,Primaria 4°,TopKids,52,18,34
2025-09-19,14,Primaria 4°,TopKids,210,13,197
2025-09-19,14,Primaria 4°,SuperSchool,214,4,210
2025-09-19,14,Primaria 4°,TopKids,68,13,55
2025-09-19,14,Primaria 4°,TopKids,274,18,256
2025-09-19,14,Primaria 4°,TopKids,143,7,136
2025-09-19,14,Primaria 5°,EduMax,229,10,219
2025-09-19,14,Primaria 5°,SuperSchool,57,2,55
2025-09-19,14,Primaria 5°,EduMax,230,18,212
2025-09-19,14,Primaria 5°,EduMax,241,2,239
2025-09-19,14,Primaria 5°,SuperSchool,229,12,217
2025-09-19,14,Primaria 5°,TopKids,128,2,126
2025-09-19,14,Primaria 5°,TopKids,203,12,191
2025-09-19,14,Primaria 6°,SuperSchool,144,8,136
2025-09-19,14,Primaria 6°,SuperSchool,269,8,261
2025-09-19,14,Primaria 6°,EduMax,101,14,87
2025-09-19,14,Primaria 6°,EduMax,67,5,62
2025-09-19,14,Primaria 6°,EduMax,241,15,226
2025-09-19,15,Preescolar,TopKids,175,17,158
2025-09-19,15,Preescolar,EduMax,268,24,244
2025-09-19,15,Preescolar,EduMax,100,16,84
2025-09-19,15,Preescolar,SuperSchool,101,13,88
2025-09-19,15,Preescolar,SuperSchool,146,17,129
2025-09-19,15,Preescolar,EduMax,173,17,156
2025-09-19,15,Preescolar,EduMax,176,7,169
2025-09-19,15,Kínder,EduMax,161,1,160
2025-09-19,15,Kínder,TopKids,239,11,228
2025-09-19,15,Kínder,EduMax,80,1,79
2025-09-19,15,Kínder,TopKids,297,3,294
2025-09-19,15,Kínder,TopKids,97,1,96
2025-09-19,15,Primaria 1°,TopKids,162,19,143
2025-09-19,15,Primaria 1°,EduMax,136,16,120
2025-09-19,15,Primaria 1°,SuperSchool,63,9,54
2025-09-19,15,Primaria 1°,SuperSchool,222,2,220
2025-09-19,15,Primaria 1°,EduMax,214,15,199
2025-09-19,15,Primaria 1°,EduMax,198,23,175
2025-09-19,15,Primaria 1°,SuperSchool,89,11,78
2025-09-19,15,Primaria 1°,EduMax,190,7,183
2025-09-19,15,Primaria 1°,TopKids,140,15,125
2025-09-19,15,Primaria 1°,SuperSchool,274,21,253
2025-09-19,15,Primaria 1°,SuperSchool,89,15,74
2025-09-19,15,Primaria 2°,SuperSchool,63,8,55
2025-09-19,15,Primaria 2°,TopKids,125,15,110
2025-09-19,15,Primaria 2°,EduMax,193,7,186
2025-09-19,15,Primaria 2°,EduMax,222,23,199
2025-09-19,15,Primaria 2°,EduMax,279,2,277
2025-09-19,15,Primaria 2°,EduMax,199,19,180
2025-09-19,15,Primaria 2°,EduMax,298,10,288
2025-09-19,15,Primaria 2°,TopKids,66,19,47
2025-09-19,15,Primaria 2°,EduMax,236,19,217
2025-09-19,15,Primaria 2°,EduMax,148,15,133
2025-09-19,15,Primaria 3°,SuperSchool,296,2,294
2025-09-19,15,Primaria 3°,EduMax,192,18,174
2025-09-19,15,Primaria 3°,SuperSchool,87,8,79
2025-09-19,15,Primaria 3°,EduMax,212,17,195
2025-09-19,15,Primaria 3°,EduMax,67,12,55
2025-09-19,15,Primaria 3°,TopKids,285,3,282
2025-09-19,15,Primaria 3°,SuperSchool,288,17,271
2025-09-19,15,Primaria 3°,SuperSchool,103,1,102
2025-09-19,15,Primaria 3°,SuperSchool,129,15,114
2025-09-19,15,Primaria 3°,TopKids,150,7,143
2025-09-19,15,Primaria 3°,TopKids,222,24,198
2025-09-19,15,Primaria 3°,SuperSchool,228,10,218
2025-09-19,15,Primaria 3°,TopKids,69,21,48
2025-09-19,15,Primaria 3°,TopKids,256,18,238
2025-09-19,15,Primaria 3°,TopKids,148,20,128
2025-09-19,15,Primaria 3°,EduMax,128,12,116
2025-09-19,15,Primaria 3°,TopKids,61,21,40
2025-09-19,15,Primaria 3°,EduMax,57,24,33
2025-09-19,15,Primaria 3°,SuperSchool,110,1,109
2025-09-19,15,Primaria 4°,EduMax,127,4,123
2025-09-19,15,Primaria 4°,EduMax,222,9,213
2025-09-19,15,Primaria 4°,SuperSchool,250,24,226
2025-09-19,15,Primaria 4°,TopKids,259,16,243
2025-09-19,15,Primaria 4°,TopKids,67,9,58
2025-09-19,15,Primaria 4°,EduMax,150,9,141
2025-09-19,15,Primaria 4°,SuperSchool,137,3,134
2025-09-19,15,Primaria 4°,EduMax,130,19,111
2025-09-19,15,Primaria 4°,EduMax,251,16,235
2025-09-19,15,Primaria 4°,EduMax,203,20,183
2025-09-19,15,Primaria 4°,SuperSchool,84,2,82
2025-09-19,15,Primaria 4°,EduMax,217,12,205
2025-09-19,15,Primaria 4°,SuperSchool,204,19,185
2025-09-19,15,Primaria 5°,EduMax,103,15,88
2025-09-19,15,Primaria 5°,TopKids,159,5,154
2025-09-19,15,Primaria 5°,SuperSchool,195,12,183
2025-09-19,15,Primaria 5°,TopKids,151,20,131
2025-09-19,15,Primaria 5°,SuperSchool,78,11,67
2025-09-19,15,Primaria 5°,TopKids,135,23,112
2025-09-19,15,Primaria 5°,TopKids,137,14,123
2025-09-19,15,Primaria 5°,SuperSchool,296,22,274
2025-09-19,15,Primaria 5°,TopKids,177,21,156
2025-09-19,15,Primaria 5°,TopKids,220,20,200
2025-09-19,15,Primaria 5°,TopKids,126,19,107
2025-09-19,15,Primaria 5°,EduMax,213,20,193
2025-09-19,15,Primaria 5°,EduMax,146,8,138
2025-09-19,15,Primaria 6°,SuperSchool,196,5,191
2025-09-19,15,Primaria 6°,EduMax,93,12,81
2025-09-19,15,Primaria 6°,EduMax,272,20,252
2025-09-19,15,Primaria 6°,TopKids,160,7,153
2025-09-19,15,Primaria 6°,EduMax,111,5,106
2025-09-19,15,Primaria 6°,TopKids,51,22,29
2025-09-19,15,Primaria 6°,SuperSchool,95,20,75
2025-09-19,15,Primaria 6°,EduMax,144,1,143
2025-09-19,15,Primaria 6°,TopKids,156,13,143
2025-09-19,16,Preescolar,SuperSchool,241,4,237
2025-09-19,16,Preescolar,TopKids,156,23,133
2025-09-19,16,Preescolar,SuperSchool,191,21,170
2025-09-19,16,Preescolar,EduMax,182,23,159
2025-09-19,16,Preescolar,EduMax,230,5,225
2025-09-19,16,Preescolar,SuperSchool,52,9,43
2025-09-19,16,Preescolar,SuperSchool,188,18,170
2025-09-19,16,Preescolar,EduMax,232,6,226
2025-09-19,16,Preescolar,SuperSchool,190,22,168
2025-09-19,16,Preescolar,EduMax,59,15,44
2025-09-19,16,Preescolar,EduMax,96,14,82
2025-09-19,16,Preescolar,TopKids,132,21,111
2025-09-19,16,Preescolar,EduMax,178,20,158
2025-09-19,16,Preescolar,TopKids,168,23,145
2025-09-19,16,Preescolar,TopKids,230,4,226
2025-09-19,16,Preescolar,SuperSchool,262,22,240
2025-09-19,16,Kínder,TopKids,182,16,166
2025-09-19,16,Kínder,SuperSchool,207,1,206
2025-09-19,16,Kínder,SuperSchool,131,4,127
2025-09-19,16,Kínder,TopKids,288,23,265
2025-09-19,16,Kínder,EduMax,119,7,112
2025-09-19,16,Kínder,TopKids,287,15,272
2025-09-19,16,Kínder,SuperSchool,289,22,267
2025-09-19,16,Kínder,TopKids,108,6,102
2025-09-19,16,Kínder,EduMax,298,6,292
2025-09-19,16,Kínder,EduMax,266,4,262
2025-09-19,16,Kínder,TopKids,119,10,109
2025-09-19,16,Kínder,SuperSchool,164,24,140
2025-09-19,16,Kínder,SuperSchool,279,14,265
2025-09-19,16,Kínder,TopKids,132,19,113
2025-09-19,16,Primaria 1°,EduMax,259,12,247
2025-09-19,16,Primaria 1°,SuperSchool,232,3,229
2025-09-19,16,Primaria 1°,TopKids,251,21,230
2025-09-19,16,Primaria 1°,TopKids,221,3,218
2025-09-19,16,Primaria 1°,EduMax,226,3,223
2025-09-19,16,Primaria 1°,TopKids,204,17,187
2025-09-19,16,Primaria 1°,TopKids,293,10,283
2025-09-19,16,Primaria 1°,TopKids,263,20,243
2025-09-19,16,Primaria 1°,TopKids,84,22,62
2025-09-19,16,Primaria 1°,TopKids,101,5,96
2025-09-19,16,Primaria 1°,EduMax,90,18,72
2025-09-19,16,Primaria 2°,TopKids,85,8,77
2025-09-19,16,Primaria 2°,TopKids,119,24,95
2025-09-19,16,Primaria 2°,SuperSchool,261,23,238
2025-09-19,16,Primaria 2°,SuperSchool,154,8,146
2025-09-19,16,Primaria 2°,EduMax,152,18,134
2025-09-19,16,Primaria 2°,EduMax,244,17,227
2025-09-19,16,Primaria 2°,EduMax,212,5,207
2025-09-19,16,Primaria 2°,SuperSchool,286,6,280
2025-09-19,16,Primaria 2°,EduMax,264,5,259
2025-09-19,16,Primaria 2°,SuperSchool,204,24,180
2025-09-19,16,Primaria 2°,SuperSchool,122,3,119
2025-09-19,16,Primaria 2°,TopKids,279,4,275
2025-09-19,16,Primaria 2°,EduMax,79,16,63
2025-09-19,16,Primaria 2°,SuperSchool,247,14,233
2025-09-19,16,Primaria 2°,EduMax,265,4,261
2025-09-19,16,Primaria 2°,TopKids,226,5,221
2025-09-19,16,Primaria 2°,EduMax,289,8,281
2025-09-19,16,Primaria 3°,SuperSchool,92,23,69
2025-09-19,16,Primaria 3°,EduMax,114,9,105
2025-09-19,16,Primaria 3°,SuperSchool,209,5,204
2025-09-19,16,Primaria 3°,EduMax,108,14,94
2025-09-19,16,Primaria 3°,SuperSchool,229,13,216
2025-09-19,16,Primaria 3°,EduMax,250,24,226
2025-09-19,16,Primaria 3°,EduMax,85,10,75
2025-09-19,16,Primaria 3°,SuperSchool,236,4,232
2025-09-19,16,Primaria 3°,SuperSchool,129,11,118
2025-09-19,16,Primaria 3°,TopKids,291,1,290
2025-09-19,16,Primaria 4°,EduMax,122,9,113
2025-09-19,16,Primaria 4°,TopKids,182,21,161
2025-09-19,16,Primaria 4°,EduMax,165,6,159
2025-09-19,16,Primaria 4°,SuperSchool,265,24,241
2025-09-19,16,Primaria 4°,TopKids,167,1,166
2025-09-19,16,Primaria 4°,SuperSchool,264,21,243
2025-09-19,16,Primaria 4°,TopKids,115,16,99
2025-09-19,16,Primaria 4°,EduMax,250,18,232
2025-09-19,16,Primaria 4°,TopKids,176,9,167
2025-09-19,16,Primaria 5°,TopKids,176,23,153
2025-09-19,16,Primaria 5°,SuperSchool,237,6,231
2025-09-19,16,Primaria 5°,TopKids,147,17,130
2025-09-19,16,Primaria 5°,SuperSchool,127,13,114
2025-09-19,16,Primaria 5°,EduMax,220,16,204
2025-09-19,16,Primaria 5°,EduMax,197,3,194
2025-09-19,16,Primaria 5°,SuperSchool,287,17,270
2025-09-19,16,Primaria 5°,TopKids,253,2,251
2025-09-19,16,Primaria 5°,EduMax,125,21,104
2025-09-19,16,Primaria 5°,SuperSchool,77,23,54
2025-09-19,16,Primaria 5°,SuperSchool,148,6,142
2025-09-19,16,Primaria 5°,TopKids,285,8,277
2025-09-19,16,Primaria 5°,EduMax,191,23,168
2025-09-19,16,Primaria 5°,SuperSchool,116,11,105
2025-09-19,16,Primaria 5°,TopKids,218,24,194
2025-09-19,16,Primaria 5°,TopKids,158,18,140
2025-09-19,16,Primaria 6°,EduMax,203,2,201
2025-09-19,16,Primaria 6°,EduMax,280,15,265
2025-09-19,16,Primaria 6°,EduMax,125,20,105
2025-09-19,16,Primaria 6°,SuperSchool,167,9,158
2025-09-19,16,Primaria 6°,TopKids,68,22,46
2025-09-19,16,Primaria 6°,EduMax,169,23,146
2025-09-19,16,Primaria 6°,TopKids,144,1,143
2025-09-19,16,Primaria 6°,EduMax,256,11,245
2025-09-19,16,Primaria 6°,EduMax,195,1,194
2025-09-19,16,Primaria 6°,TopKids,181,22,159
2025-09-19,16,Primaria 6°,SuperSchool,277,18,259
2025-09-19,16,Primaria 6°,SuperSchool,280,14,266
2025-09-19,16,Primaria 6°,TopKids,86,13,73
2025-09-19,16,Primaria 6°,SuperSchool,99,22,77
2025-09-19,16,Primaria 6°,SuperSchool,150,6,144
2025-09-19,16,Primaria 6°,EduMax,147,15,132
2025-09-19,16,Primaria 6°,SuperSchool,76,16,60
2025-09-19,16,Primaria 6°,SuperSchool,206,8,198
2025-09-19,16,Primaria 6°,SuperSchool,184,6,178
2025-09-22,9,Preescolar,TopKids,214,15,199
2025-09-22,9,Preescolar,EduMax,293,16,277
2025-09-22,9,Preescolar,SuperSchool,60,23,37
2025-09-22,9,Preescolar,EduMax,82,17,65
2025-09-22,9,Preescolar,SuperSchool,179,17,162
2025-09-22,9,Preescolar,SuperSchool,181,12,169
2025-09-22,9,Preescolar,SuperSchool,283,10,273
2025-09-22,9,Preescolar,TopKids,156,7,149
2025-09-22,9,Preescolar,EduMax,260,18,242
2025-09-22,9,Preescolar,EduMax,184,14,170
2025-09-22,9,Preescolar,EduMax,188,1,187
2025-09-22,9,Preescolar,EduMax,197,5,192
2025-09-22,9,Kínder,EduMax,180,18,162
2025-09-22,9,Kínder,EduMax,235,4,231
2025-09-22,9,Kínder,TopKids,113,22,91
2025-09-22,9,Kínder,EduMax,206,16,190
2025-09-22,9,Kínder,TopKids,68,20,48
2025-09-22,9,Kínder,EduMax,256,5,251
2025-09-22,9,Kínder,TopKids,220,9,211
2025-09-22,9,Kínder,SuperSchool,284,21,263
2025-09-22,9,Primaria 1°,TopKids,242,9,233
2025-09-22,9,Primaria 1°,SuperSchool,211,4,207
2025-09-22,9,Primaria 1°,EduMax,279,9,270
2025-09-22,9,Primaria 1°,EduMax,202,1,201
2025-09-22,9,Primaria 1°,TopKids,71,22,49
2025-09-22,9,Primaria 1°,SuperSchool,71,16,55
2025-09-22,9,Primaria 1°,EduMax,222,8,214
2025-09-22,9,Primaria 1°,SuperSchool,118,10,108
2025-09-22,9,Primaria 1°,TopKids,60,22,38
2025-09-22,9,Primaria 1°,EduMax,205,5,200
2025-09-22,9,Primaria 1°,SuperSchool,142,14,128
2025-09-22,9,Primaria 1°,TopKids,162,8,154
2025-09-22,9,Primaria 1°,TopKids,118,16,102
2025-09-22,9,Primaria 1°,SuperSchool,126,8,118
2025-09-22,9,Primaria 1°,EduMax,139,24,115
2025-09-22,9,Primaria 1°,SuperSchool,58,6,52
2025-09-22,9,Primaria 1°,EduMax,120,17,103
2025-09-22,9,Primaria 1°,EduMax,157,1,156
2025-09-22,9,Primaria 2°,EduMax,96,24,72
2025-09-22,9,Primaria 2°,TopKids,237,21,216
2025-09-22,9,Primaria 2°,TopKids,155,16,139
2025-09-22,9,Primaria 2°,SuperSchool,271,12,259
2025-09-22,9,Primaria 2°,EduMax,288,16,272
2025-09-22,9,Primaria 2°,SuperSchool,55,13,42
2025-09-22,9,Primaria 2°,SuperSchool,254,5,249
2025-09-22,9,Primaria 2°,TopKids,285,10,275
2025-09-22,9,Primaria 2°,SuperSchool,194,6,188
2025-09-22,9,Primaria 2°,EduMax,276,18,258
2025-09-22,9,Primaria 2°,TopKids,120,9,111
2025-09-22,9,Primaria 2°,TopKids,80,19,61
2025-09-22,9,Primaria 2°,TopKids,292,17,275
2025-09-22,9,Primaria 2°,SuperSchool,234,6,228
2025-09-22,9,Primaria 2°,SuperSchool,298,1,297
2025-09-22,9,Primaria 2°,TopKids,64,3,61
2025-09-22,9,Primaria 3°,EduMax,213,8,205
2025-09-22,9,Primaria 3°,EduMax,85,21,64
2025-09-22,9,Primaria 3°,EduMax,123,12,111
2025-09-22,9,Primaria 3°,SuperSchool,221,23,198
2025-09-22,9,Primaria 3°,EduMax,93,19,74
2025-09-22,9,Primaria 4°,TopKids,135,19,116
2025-09-22,9,Primaria 4°,TopKids,184,21,163
2025-09-22,9,Primaria 4°,SuperSchool,190,9,181
2025-09-22,9,Primaria 4°,TopKids,163,15,148
2025-09-22,9,Primaria 4°,TopKids,96,10,86
2025-09-22,9,Primaria 4°,EduMax,99,15,84
2025-09-22,9,Primaria 4°,SuperSchool,158,17,141
2025-09-22,9,Primaria 4°,SuperSchool,216,11,205
2025-09-22,9,Primaria 4°,SuperSchool,64,1,63
2025-09-22,9,Primaria 4°,EduMax,103,11,92
2025-09-22,9,Primaria 4°,SuperSchool,111,19,92
2025-09-22,9,Primaria 4°,EduMax,291,18,273
2025-09-22,9,Primaria 4°,TopKids,293,7,286
2025-09-22,9,Primaria 4°,EduMax,139,1,138
2025-09-22,9,Primaria 4°,EduMax,133,9,124
2025-09-22,9,Primaria 4°,TopKids,209,6,203
2025-09-22,9,Primaria 4°,TopKids,131,1,130
2025-09-22,9,Primaria 5°,SuperSchool,209,16,193
2025-09-22,9,Primaria 5°,EduMax,99,19,80
2025-09-22,9,Primaria 5°,SuperSchool,68,3,65
2025-09-22,9,Primaria 5°,TopKids,194,11,183
2025-09-22,9,Primaria 5°,SuperSchool,290,12,278
2025-09-22,9,Primaria 5°,SuperSchool,77,20,57
2025-09-22,9,Primaria 5°,SuperSchool,211,16,195
2025-09-22,9,Primaria 5°,TopKids,103,2,101
2025-09-22,9,Primaria 5°,EduMax,269,17,252
2025-09-22,9,Primaria 5°,EduMax,294,20,274
2025-09-22,9,Primaria 5°,SuperSchool,134,5,129
2025-09-22,9,Primaria 5°,TopKids,94,5,89
2025-09-22,9,Primaria 5°,EduMax,101,5,96
2025-09-22,9,Primaria 5°,TopKids,60,22,38
2025-09-22,9,Primaria 6°,EduMax,268,3,265
2025-09-22,9,Primaria 6°,TopKids,283,2,281
2025-09-22,9,Primaria 6°,SuperSchool,66,3,63
2025-09-22,9,Primaria 6°,TopKids,89,16,73
2025-09-22,9,Primaria 6°,TopKids,295,19,276
2025-09-22,9,Primaria 6°,SuperSchool,100,4,96
2025-09-22,9,Primaria 6°,SuperSchool,260,4,256
2025-09-22,9,Primaria 6°,TopKids,216,20,196
2025-09-22,9,Primaria 6°,SuperSchool,234,22,212
2025-09-22,9,Primaria 6°,SuperSchool,88,4,84
2025-09-22,9,Primaria 6°,SuperSchool,192,23,169
2025-09-22,10,Preescolar,EduMax,141,17,124
2025-09-22,10,Preescolar,SuperSchool,88,17,71
2025-09-22,10,Preescolar,EduMax,256,20,236
2025-09-22,10,Preescolar,SuperSchool,163,19,144
2025-09-22,10,Preescolar,EduMax,287,20,267
2025-09-22,10,Preescolar,TopKids,182,7,175
2025-09-22,10,Preescolar,SuperSchool,207,19,188
2025-09-22,10,Preescolar,EduMax,253,17,236
2025-09-22,10,Preescolar,SuperSchool,180,8,172
2025-09-22,10,Preescolar,SuperSchool,230,23,207
2025-09-22,10,Preescolar,SuperSchool,294,14,280
2025-09-22,10,Preescolar,TopKids,223,4,219
2025-09-22,10,Preescolar,TopKids,176,15,161
2025-09-22,10,Kínder,SuperSchool,53,17,36
2025-09-22,10,Kínder,SuperSchool,72,3,69
2025-09-22,10,Kínder,EduMax,198,16,182
2025-09-22,10,Kínder,TopKids,234,5,229
2025-09-22,10,Kínder,EduMax,248,20,228
2025-09-22,10,Kínder,SuperSchool,243,12,231
2025-09-22,10,Primaria 1°,SuperSchool,182,16,166
2025-09-22,10,Primaria 1°,EduMax,141,8,133
2025-09-22,10,Primaria 1°,EduMax,121,18,103
2025-09-22,10,Primaria 1°,TopKids,257,22,235
2025-09-22,10,Primaria 1°,TopKids,126,22,104
2025-09-22,10,Primaria 1°,SuperSchool,112,18,94
2025-09-22,10,Primaria 1°,SuperSchool,78,1,77
2025-09-22,10,Primaria 1°,SuperSchool,122,21,101
2025-09-22,10,Primaria 1°,EduMax,205,18,187
2025-09-22,10,Primaria 1°,TopKids,146,20,126
2025-09-22,10,Primaria 1°,TopKids,115,19,96
2025-09-22,10,Primaria 1°,EduMax,137,19,118
2025-09-22,10,Primaria 1°,EduMax,247,23,224
2025-09-22,10,Primaria 1°,TopKids,234,11,223
2025-09-22,10,Primaria 2°,SuperSchool,239,22,217
2025-09-22,10,Primaria 2°,TopKids,52,19,33
2025-09-22,10,Primaria 2°,SuperSchool,92,6,86
2025-09-22,10,Primaria 2°,SuperSchool,282,5,277
2025-09-22,10,Primaria 2°,EduMax,233,7,226
2025-09-22,10,Primaria 2°,SuperSchool,212,11,201
2025-09-22,10,Primaria 2°,EduMax,70,10,60
2025-09-22,10,Primaria 2°,SuperSchool,142,3,139
2025-09-22,10,Primaria 2°,TopKids,229,9,220
2025-09-22,10,Primaria 2°,SuperSchool,156,9,147
2025-09-22,10,Primaria 2°,SuperSchool,58,14,44
2025-09-22,10,Primaria 2°,SuperSchool,170,15,155
2025-09-22,10,Primaria 2°,TopKids,285,11,274
2025-09-22,10,Primaria 2°,SuperSchool,291,24,267
2025-09-22,10,Primaria 3°,SuperSchool,230,10,220
2025-09-22,10,Primaria 3°,TopKids,108,3,105
2025-09-22,10,Primaria 3°,SuperSchool,107,20,87
2025-09-22,10,Primaria 3°,TopKids,281,2,279
2025-09-22,10,Primaria 3°,EduMax,262,6,256
2025-09-22,10,Primaria 3°,TopKids,229,7,222
2025-09-22,10,Primaria 3°,EduMax,213,8,205
2025-09-22,10,Primaria 3°,EduMax,239,10,229
2025-09-22,10,Primaria 3°,TopKids,216,5,211
2025-09-22,10,Primaria 3°,EduMax,252,18,234
2025-09-22,10,Primaria 3°,TopKids,101,5,96
2025-09-22,10,Primaria 3°,TopKids,52,10,42
2025-09-22,10,Primaria 3°,TopKids,246,5,241
2025-09-22,10,Primaria 4°,EduMax,220,19,201
2025-09-22,10,Primaria 4°,TopKids,258,22,236
2025-09-22,10,Primaria 4°,TopKids,295,20,275
2025-09-22,10,Primaria 4°,TopKids,291,9,282
2025-09-22,10,Primaria 4°,EduMax,98,24,74
2025-09-22,10,Primaria 4°,EduMax,80,23,57
2025-09-22,10,Primaria 4°,TopKids,284,6,278
2025-09-22,10,Primaria 4°,TopKids,268,17,251
2025-09-22,10,Primaria 4°,EduMax,158,5,153
2025-09-22,10,Primaria 4°,TopKids,192,2,190
2025-09-22,10,Primaria 4°,SuperSchool,296,24,272
2025-09-22,10,Primaria 5°,TopKids,261,24,237
2025-09-22,10,Primaria 5°,TopKids,276,23,253
2025-09-22,10,Primaria 5°,EduMax,258,5,253
2025-09-22,10,Primaria 5°,EduMax,255,14,241
2025-09-22,10,Primaria 5°,TopKids,109,20,89
2025-09-22,10,Primaria 5°,SuperSchool,103,9,94
2025-09-22,10,Primaria 5°,EduMax,253,8,245
2025-09-22,10,Primaria 5°,SuperSchool,193,6,187
2025-09-22,10,Primaria 5°,EduMax,84,9,75
2025-09-22,10,Primaria 6°,TopKids,70,7,63
2025-09-22,10,Primaria 6°,EduMax,207,22,185
2025-09-22,10,Primaria 6°,EduMax,232,3,229
2025-09-22,10,Primaria 6°,SuperSchool,246,19,227
2025-09-22,10,Primaria 6°,TopKids,283,9,274
2025-09-22,10,Primaria 6°,SuperSchool,225,9,216
2025-09-22,10,Primaria 6°,EduMax,86,4,82
2025-09-22,11,Preescolar,SuperSchool,227,16,211
2025-09-22,11,Preescolar,TopKids,287,23,264
2025-09-22,11,Preescolar,SuperSchool,185,11,174
2025-09-22,11,Preescolar,SuperSchool,159,9,150
2025-09-22,11,Preescolar,EduMax,89,17,72
2025-09-22,11,Preescolar,EduMax,254,13,241
2025-09-22,11,Preescolar,SuperSchool,100,2,98
2025-09-22,11,Preescolar,EduMax,209,18,191
2025-09-22,11,Kínder,TopKids,193,19,174
2025-09-22,11,Kínder,TopKids,232,14,218
2025-09-22,11,Kínder,SuperSchool,229,7,222
2025-09-22,11,Kínder,TopKids,82,2,80
2025-09-22,11,Kínder,TopKids,241,21,220
2025-09-22,11,Kínder,SuperSchool,257,17,240
2025-09-22,11,Kínder,SuperSchool,67,16,51
2025-09-22,11,Kínder,TopKids,180,10,170
2025-09-22,11,Primaria 1°,SuperSchool,294,1,293
2025-09-22,11,Primaria 1°,TopKids,220,13,207
2025-09-22,11,Primaria 1°,TopKids,76,9,67
2025-09-22,11,Primaria 1°,SuperSchool,173,6,167
2025-09-22,11,Primaria 1°,SuperSchool,268,15,253
2025-09-22,11,Primaria 1°,EduMax,267,22,245
2025-09-22,11,Primaria 2°,TopKids,107,16,91
2025-09-22,11,Primaria 2°,EduMax,108,12,96
2025-09-22,11,Primaria 2°,TopKids,192,15,177
2025-09-22,11,Primaria 2°,EduMax,255,8,247
2025-09-22,11,Primaria 2°,SuperSchool,269,2,267
2025-09-22,11,Primaria 2°,TopKids,238,8,230
2025-09-22,11,Primaria 2°,TopKids,97,8,89
2025-09-22,11,Primaria 2°,SuperSchool,293,4,289
2025-09-22,11,Primaria 2°,EduMax,117,19,98
2025-09-22,11,Primaria 2°,EduMax,78,19,59
2025-09-22,11,Primaria 2°,TopKids,156,23,133
2025-09-22,11,Primaria 2°,SuperSchool,294,2,292
2025-09-22,11,Primaria 2°,EduMax,69,18,51
2025-09-22,11,Primaria 2°,TopKids,289,24,265
2025-09-22,11,Primaria 2°,SuperSchool,139,3,136
2025-09-22,11,Primaria 3°,TopKids,109,3,106
2025-09-22,11,Primaria 3°,SuperSchool,240,18,222
2025-09-22,11,Primaria 3°,TopKids,297,4,293
2025-09-22,11,Primaria 3°,SuperSchool,98,12,86
2025-09-22,11,Primaria 3°,TopKids,121,17,104
2025-09-22,11,Primaria 3°,EduMax,231,20,211
2025-09-22,11,Primaria 3°,TopKids,153,1,152
2025-09-22,11,Primaria 3°,SuperSchool,194,20,174
2025-09-22,11,Primaria 3°,EduMax,270,10,260
2025-09-22,11,Primaria 3°,SuperSchool,211,20,191
2025-09-22,11,Primaria 3°,TopKids,180,1,179
2025-09-22,11,Primaria 3°,SuperSchool,99,8,91
2025-09-22,11,Primaria 3°,EduMax,79,1,78
2025-09-22,11,Primaria 3°,EduMax,130,10,120
2025-09-22,11,Primaria 3°,SuperSchool,71,10,61
2025-09-22,11,Primaria 3°,EduMax,274,16,258
2025-09-22,11,Primaria 4°,TopKids,258,9,249
2025-09-22,11,Primaria 4°,TopKids,89,4,85
2025-09-22,11,Primaria 4°,TopKids,147,2,145
2025-09-22,11,Primaria 4°,SuperSchool,268,19,249
2025-09-22,11,Primaria 4°,SuperSchool,113,23,90
2025-09-22,11,Primaria 4°,TopKids,211,16,195
2025-09-22,11,Primaria 4°,EduMax,141,14,127
2025-09-22,11,Primaria 4°,EduMax,188,14,174
2025-09-22,11,Primaria 4°,SuperSchool,65,6,59
2025-09-22,11,Primaria 4°,SuperSchool,222,4,218
2025-09-22,11,Primaria 4°,SuperSchool,53,16,37
2025-09-22,11,Primaria 5°,SuperSchool,244,21,223
2025-09-22,11,Primaria 5°,EduMax,268,18,250
2025-09-22,11,Primaria 5°,SuperSchool,175,3,172
2025-09-22,11,Primaria 5°,SuperSchool,72,11,61
2025-09-22,11,Primaria 5°,SuperSchool,272,3,269
2025-09-22,11,Primaria 5°,TopKids,114,15,99
2025-09-22,11,Primaria 6°,TopKids,275,15,260
2025-09-22,11,Primaria 6°,EduMax,74,4,70
2025-09-22,11,Primaria 6°,SuperSchool,239,9,230
2025-09-22,11,Primaria 6°,SuperSchool,144,22,122
2025-09-22,11,Primaria 6°,EduMax,287,9,278
2025-09-22,11,Primaria 6°,EduMax,282,13,269
2025-09-22,11,Primaria 6°,SuperSchool,170,23,147
2025-09-22,11,Primaria 6°,EduMax,173,5,168
2025-09-22,11,Primaria 6°,SuperSchool,82,23,59
2025-09-22,11,Primaria 6°,SuperSchool,99,2,97
2025-09-22,11,Primaria 6°,TopKids,205,22,183
2025-09-22,12,Preescolar,EduMax,280,9,271
2025-09-22,12,Preescolar,EduMax,277,14,263
2025-09-22,12,Preescolar,SuperSchool,210,3,207
2025-09-22,12,Preescolar,SuperSchool,145,20,125
2025-09-22,12,Preescolar,EduMax,71,21,50
2025-09-22,12,Preescolar,SuperSchool,286,14,272
2025-09-22,12,Preescolar,TopKids,163,2,161
2025-09-22,12,Preescolar,TopKids,245,9,236
2025-09-22,12,Preescolar,TopKids,71,21,50
2025-09-22,12,Preescolar,SuperSchool,282,17,265
2025-09-22,12,Preescolar,TopKids,218,7,211
2025-09-22,12,Preescolar,TopKids,273,8,265
2025-09-22,12,Preescolar,TopKids,82,4,78
2025-09-22,12,Preescolar,SuperSchool,242,4,238
2025-09-22,12,Preescolar,SuperSchool,171,12,159
2025-09-22,12,Kínder,EduMax,97,5,92
2025-09-22,12,Kínder,SuperSchool,202,13,189
2025-09-22,12,Kínder,SuperSchool,61,3,58
2025-09-22,12,Kínder,TopKids,297,20,277
2025-09-22,12,Kínder,TopKids,272,24,248
2025-09-22,12,Kínder,TopKids,91,16,75
2025-09-22,12,Kínder,EduMax,130,13,117
2025-09-22,12,Kínder,EduMax,157,5,152
2025-09-22,12,Kínder,EduMax,212,16,196
2025-09-22,12,Kínder,TopKids,63,22,41
2025-09-22,12,Kínder,EduMax,167,13,154
2025-09-22,12,Kínder,TopKids,287,10,277
2025-09-22,12,Kínder,TopKids,195,7,188
2025-09-22,12,Primaria 1°,EduMax,174,22,152
2025-09-22,12,Primaria 1°,SuperSchool,211,8,203
2025-09-22,12,Primaria 1°,TopKids,160,6,154
2025-09-22,12,Primaria 1°,SuperSchool,286,5,281
2025-09-22,12,Primaria 1°,SuperSchool,263,3,260
2025-09-22,12,Primaria 1°,SuperSchool,96,24,72
2025-09-22,12,Primaria 1°,SuperSchool,194,17,177
2025-09-22,12,Primaria 1°,SuperSchool,99,20,79
2025-09-22,12,Primaria 1°,EduMax,182,13,169
2025-09-22,12,Primaria 1°,TopKids,88,4,84
2025-09-22,12,Primaria 1°,SuperSchool,66,8,58
2025-09-22,12,Primaria 2°,TopKids,298,16,282
2025-09-22,12,Primaria 2°,EduMax,108,1,107
2025-09-22,12,Primaria 2°,EduMax,185,3,182
2025-09-22,12,Primaria 2°,SuperSchool,172,19,153
2025-09-22,12,Primaria 2°,TopKids,241,20,221
2025-09-22,12,Primaria 2°,EduMax,172,23,149
2025-09-22,12,Primaria 2°,TopKids,248,16,232
2025-09-22,12,Primaria 2°,SuperSchool,69,13,56
2025-09-22,12,Primaria 2°,SuperSchool,59,9,50
2025-09-22,12,Primaria 2°,TopKids,157,1,156
2025-09-22,12,Primaria 2°,EduMax,127,23,104
2025-09-22,12,Primaria 2°,SuperSchool,71,23,48
2025-09-22,12,Primaria 2°,EduMax,75,17,58
2025-09-22,12,Primaria 2°,TopKids,199,12,187
2025-09-22,12,Primaria 2°,TopKids,219,20,199
2025-09-22,12,Primaria 3°,EduMax,113,13,100
2025-09-22,12,Primaria 3°,EduMax,190,8,182
2025-09-22,12,Primaria 3°,EduMax,275,19,256
2025-09-22,12,Primaria 3°,TopKids,83,12,71
2025-09-22,12,Primaria 3°,TopKids,77,19,58
2025-09-22,12,Primaria 4°,EduMax,155,16,139
2025-09-22,12,Primaria 4°,TopKids,76,19,57
2025-09-22,12,Primaria 4°,EduMax,172,3,169
2025-09-22,12,Primaria 4°,SuperSchool,269,8,261
2025-09-22,12,Primaria 4°,SuperSchool,163,22,141
2025-09-22,12,Primaria 4°,TopKids,178,9,169
2025-09-22,12,Primaria 5°,TopKids,113,8,105
2025-09-22,12,Primaria 5°,EduMax,201,23,178
2025-09-22,12,Primaria 5°,SuperSchool,276,9,267
2025-09-22,12,Primaria 5°,SuperSchool,81,1,80
2025-09-22,12,Primaria 5°,EduMax,219,14,205
2025-09-22,12,Primaria 5°,TopKids,283,9,274
2025-09-22,12,Primaria 5°,EduMax,201,9,192
2025-09-22,12,Primaria 5°,EduMax,196,19,177
2025-09-22,12,Primaria 5°,SuperSchool,51,10,41
2025-09-22,12,Primaria 5°,SuperSchool,152,6,146
2025-09-22,12,Primaria 5°,EduMax,115,8,107
2025-09-22,12,Primaria 5°,TopKids,99,4,95
2025-09-22,12,Primaria 5°,EduMax,144,17,127
2025-09-22,12,Primaria 5°,TopKids,298,14,284
2025-09-22,12,Primaria 5°,EduMax,185,14,171
2025-09-22,12,Primaria 5°,TopKids,92,9,83
2025-09-22,12,Primaria 5°,TopKids,130,17,113
2025-09-22,12,Primaria 5°,EduMax,105,17,88
2025-09-22,12,Primaria 6°,TopKids,76,9,67
2025-09-22,12,Primaria 6°,EduMax,279,4,275
2025-09-22,12,Primaria 6°,EduMax,269,20,249
2025-09-22,12,Primaria 6°,EduMax,283,4,279
2025-09-22,12,Primaria 6°,TopKids,90,12,78
2025-09-22,12,Primaria 6°,SuperSchool,193,22,171
2025-09-22,12,Primaria 6°,TopKids,66,1,65
2025-09-22,12,Primaria 6°,TopKids,138,12,126
2025-09-22,13,Preescolar,TopKids,54,15,39
2025-09-22,13,Preescolar,SuperSchool,74,3,71
2025-09-22,13,Preescolar,TopKids,112,19,93
2025-09-22,13,Preescolar,TopKids,244,20,224
2025-09-22,13,Preescolar,EduMax,113,22,91
2025-09-22,13,Preescolar,TopKids,246,10,236
2025-09-22,13,Preescolar,EduMax,126,18,108
2025-09-22,13,Preescolar,EduMax,129,2,127
2025-09-22,13,Kínder,EduMax,277,19,258
2025-09-22,13,Kínder,SuperSchool,110,5,105
2025-09-22,13,Kínder,SuperSchool,243,15,228
2025-09-22,13,Kínder,TopKids,169,6,163
2025-09-22,13,Kínder,SuperSchool,200,18,182
2025-09-22,13,Kínder,EduMax,81,12,69
2025-09-22,13,Kínder,EduMax,141,22,119
2025-09-22,13,Kínder,TopKids,165,18,147
2025-09-22,13,Kínder,TopKids,235,6,229
2025-09-22,13,Kínder,TopKids,239,17,222
2025-09-22,13,Kínder,TopKids,252,14,238
2025-09-22,13,Kínder,TopKids,124,19,105
2025-09-22,13,Kínder,SuperSchool,53,12,41
2025-09-22,13,Kínder,TopKids,189,17,172
2025-09-22,13,Kínder,TopKids,184,21,163
2025-09-22,13,Kínder,SuperSchool,278,12,266
2025-09-22,13,Kínder,TopKids,103,15,88
2025-09-22,13,Kínder,SuperSchool,105,9,96
2025-09-22,13,Primaria 1°,EduMax,129,15,114
2025-09-22,13,Primaria 1°,EduMax,62,24,38
2025-09-22,13,Primaria 1°,SuperSchool,225,1,224
2025-09-22,13,Primaria 1°,SuperSchool,155,16,139
2025-09-22,13,Primaria 1°,SuperSchool,70,2,68
2025-09-22,13,Primaria 2°,SuperSchool,231,1,230
2025-09-22,13,Primaria 2°,TopKids,90,23,67
2025-09-22,13,Primaria 2°,EduMax,210,8,202
2025-09-22,13,Primaria 2°,SuperSchool,78,8,70
2025-09-22,13,Primaria 2°,SuperSchool,139,23,116
2025-09-22,13,Primaria 2°,EduMax,232,20,212
2025-09-22,13,Primaria 2°,TopKids,220,20,200
2025-09-22,13,Primaria 2°,EduMax,279,7,272
2025-09-22,13,Primaria 3°,TopKids,139,18,121
2025-09-22,13,Primaria 3°,TopKids,227,17,210
2025-09-22,13,Primaria 3°,SuperSchool,64,11,53
2025-09-22,13,Primaria 3°,TopKids,258,19,239
2025-09-22,13,Primaria 3°,TopKids,89,17,72
2025-09-22,13,Primaria 3°,TopKids,271,14,257
2025-09-22,13,Primaria 4°,EduMax,154,18,136
2025-09-22,13,Primaria 4°,EduMax,229,16,213
2025-09-22,13,Primaria 4°,SuperSchool,98,16,82
2025-09-22,13,Primaria 4°,EduMax,228,11,217
2025-09-22,13,Primaria 4°,EduMax,292,7,285
2025-09-22,13,Primaria 4°,SuperSchool,221,2,219
2025-09-22,13,Primaria 4°,TopKids,231,21,210
2025-09-22,13,Primaria 4°,TopKids,58,12,46
2025-09-22,13,Primaria 4°,TopKids,299,5,294
2025-09-22,13,Primaria 4°,SuperSchool,214,8,206
2025-09-22,13,Primaria 5°,TopKids,105,9,96
2025-09-22,13,Primaria 5°,SuperSchool,112,24,88
2025-09-22,13,Primaria 5°,EduMax,230,20,210
2025-09-22,13,Primaria 5°,EduMax,81,15,66
2025-09-22,13,Primaria 5°,SuperSchool,143,4,139
2025-09-22,13,Primaria 5°,EduMax,200,23,177
2025-09-22,13,Primaria 5°,SuperSchool,245,5,240
2025-09-22,13,Primaria 6°,TopKids,150,3,147
2025-09-22,13,Primaria 6°,EduMax,106,23,83
2025-09-22,13,Primaria 6°,SuperSchool,114,1,113
2025-09-22,13,Primaria 6°,TopKids,58,13,45
2025-09-22,13,Primaria 6°,SuperSchool,144,21,123
2025-09-22,13,Primaria 6°,TopKids,254,21,233
2025-09-22,13,Primaria 6°,EduMax,164,5,159
2025-09-22,13,Primaria 6°,EduMax,260,3,257
2025-09-22,13,Primaria 6°,EduMax,88,23,65
2025-09-22,13,Primaria 6°,EduMax,56,7,49
2025-09-22,13,Primaria 6°,EduMax,192,10,182
2025-09-22,13,Primaria 6°,SuperSchool,256,2,254
2025-09-22,13,Primaria 6°,TopKids,164,5,159
2025-09-22,13,Primaria 6°,TopKids,56,21,35
2025-09-22,13,Primaria 6°,EduMax,221,10,211
2025-09-22,14,Preescolar,EduMax,55,20,35
2025-09-22,14,Preescolar,SuperSchool,191,9,182
2025-09-22,14,Preescolar,TopKids,146,21,125
2025-09-22,14,Preescolar,SuperSchool,190,2,188
2025-09-22,14,Preescolar,TopKids,288,16,272
2025-09-22,14,Preescolar,TopKids,222,20,202
2025-09-22,14,Preescolar,SuperSchool,299,14,285
2025-09-22,14,Preescolar,TopKids,194,17,177
2025-09-22,14,Preescolar,SuperSchool,261,20,241
2025-09-22,14,Preescolar,TopKids,64,13,51
2025-09-22,14,Preescolar,TopKids,265,20,245
2025-09-22,14,Preescolar,TopKids,183,18,165
2025-09-22,14,Preescolar,EduMax,98,21,77
2025-09-22,14,Preescolar,SuperSchool,60,18,42
2025-09-22,14,Kínder,TopKids,144,24,120
2025-09-22,14,Kínder,SuperSchool,73,1,72
2025-09-22,14,Kínder,TopKids,271,20,251
2025-09-22,14,Kínder,SuperSchool,190,16,174
2025-09-22,14,Kínder,TopKids,122,18,104
2025-09-22,14,Kínder,TopKids,62,7,55
2025-09-22,14,Kínder,TopKids,285,18,267
2025-09-22,14,Primaria 1°,TopKids,73,1,72
2025-09-22,14,Primaria 1°,SuperSchool,230,22,208
2025-09-22,14,Primaria 1°,TopKids,196,12,184
2025-09-22,14,Primaria 1°,EduMax,223,13,210
2025-09-22,14,Primaria 1°,SuperSchool,125,8,117
2025-09-22,14,Primaria 1°,EduMax,131,7,124
2025-09-22,14,Primaria 1°,TopKids,64,10,54
2025-09-22,14,Primaria 1°,SuperSchool,69,16,53
2025-09-22,14,Primaria 1°,TopKids,261,4,257
2025-09-22,14,Primaria 1°,EduMax,155,8,147
2025-09-22,14,Primaria 1°,SuperSchool,84,24,60
2025-09-22,14,Primaria 1°,TopKids,199,23,176
2025-09-22,14,Primaria 1°,SuperSchool,137,20,117
2025-09-22,14,Primaria 2°,SuperSchool,213,18,195
2025-09-22,14,Primaria 2°,SuperSchool,146,1,145
2025-09-22,14,Primaria 2°,SuperSchool,131,9,122
2025-09-22,14,Primaria 2°,EduMax,272,7,265
2025-09-22,14,Primaria 2°,TopKids,256,14,242
2025-09-22,14,Primaria 2°,EduMax,280,8,272
2025-09-22,14,Primaria 2°,SuperSchool,72,11,61
2025-09-22,14,Primaria 2°,TopKids,147,15,132
2025-09-22,14,Primaria 2°,TopKids,172,18,154
2025-09-22,14,Primaria 2°,TopKids,132,7,125
2025-09-22,14,Primaria 2°,EduMax,121,23,98
2025-09-22,14,Primaria 2°,EduMax,62,6,56
2025-09-22,14,Primaria 2°,SuperSchool,219,24,195
2025-09-22,14,Primaria 2°,SuperSchool,292,11,281
2025-09-22,14,Primaria 2°,TopKids,68,5,63
2025-09-22,14,Primaria 2°,SuperSchool,150,1,149
2025-09-22,14,Primaria 2°,SuperSchool,282,7,275
2025-09-22,14,Primaria 2°,SuperSchool,203,10,193
2025-09-22,14,Primaria 2°,EduMax,102,3,99
2025-09-22,14,Primaria 3°,SuperSchool,246,11,235
2025-09-22,14,Primaria 3°,SuperSchool,274,2,272
2025-09-22,14,Primaria 3°,EduMax,109,20,89
2025-09-22,14,Primaria 3°,EduMax,167,8,159
2025-09-22,14,Primaria 3°,EduMax,78,19,59
2025-09-22,14,Primaria 3°,EduMax,139,14,125
2025-09-22,14,Primaria 4°,EduMax,165,8,157
2025-09-22,14,Primaria 4°,SuperSchool,170,14,156
2025-09-22,14,Primaria 4°,SuperSchool,279,14,265
2025-09-22,14,Primaria 4°,TopKids,192,2,190
2025-09-22,14,Primaria 4°,EduMax,111,10,101
2025-09-22,14,Primaria 4°,SuperSchool,198,7,191
2025-09-22,14,Primaria 4°,EduMax,266,5,261
2025-09-22,14,Primaria 4°,SuperSchool,248,18,230
2025-09-22,14,Primaria 4°,SuperSchool,221,24,197
2025-09-22,14,Primaria 4°,EduMax,66,10,56
2025-09-22,14,Primaria 4°,TopKids,205,21,184
2025-09-22,14,Primaria 4°,SuperSchool,200,15,185
2025-09-22,14,Primaria 4°,TopKids,177,16,161
2025-09-22,14,Primaria 4°,EduMax,287,20,267
2025-09-22,14,Primaria 5°,EduMax,178,11,167
2025-09-22,14,Primaria 5°,SuperSchool,144,12,132
2025-09-22,14,Primaria 5°,TopKids,118,10,108
2025-09-22,14,Primaria 5°,EduMax,98,10,88
2025-09-22,14,Primaria 5°,TopKids,268,18,250
2025-09-22,14,Primaria 6°,TopKids,58,2,56
2025-09-22,14,Primaria 6°,EduMax,109,12,97
2025-09-22,14,Primaria 6°,SuperSchool,224,13,211
2025-09-22,14,Primaria 6°,SuperSchool,78,2,76
2025-09-22,14,Primaria 6°,TopKids,64,14,50
2025-09-22,14,Primaria 6°,SuperSchool,129,2,127
2025-09-22,14,Primaria 6°,SuperSchool,170,9,161
2025-09-22,14,Primaria 6°,SuperSchool,233,20,213
2025-09-22,14,Primaria 6°,EduMax,170,2,168
2025-09-22,14,Primaria 6°,SuperSchool,123,23,100
2025-09-22,15,Preescolar,TopKids,67,24,43
2025-09-22,15,Preescolar,TopKids,101,22,79
2025-09-22,15,Preescolar,SuperSchool,188,9,179
2025-09-22,15,Preescolar,TopKids,237,16,221
2025-09-22,15,Preescolar,SuperSchool,230,6,224
2025-09-22,15,Preescolar,SuperSchool,112,15,97
2025-09-22,15,Preescolar,TopKids,103,18,85
2025-09-22,15,Preescolar,TopKids,274,14,260
2025-09-22,15,Preescolar,SuperSchool,83,2,81
2025-09-22,15,Preescolar,EduMax,155,16,139
2025-09-22,15,Kínder,EduMax,207,23,184
2025-09-22,15,Kínder,TopKids,100,19,81
2025-09-22,15,Kínder,SuperSchool,264,19,245
2025-09-22,15,Kínder,TopKids,126,19,107
2025-09-22,15,Kínder,SuperSchool,95,8,87
2025-09-22,15,Kínder,SuperSchool,200,8,192
2025-09-22,15,Kínder,SuperSchool,298,21,277
2025-09-22,15,Primaria 1°,SuperSchool,118,21,97
2025-09-22,15,Primaria 1°,EduMax,295,23,272
2025-09-22,15,Primaria 1°,TopKids,256,23,233
2025-09-22,15,Primaria 1°,TopKids,220,2,218
2025-09-22,15,Primaria 1°,EduMax,154,17,137
2025-09-22,15,Primaria 1°,TopKids,221,6,215
2025-09-22,15,Primaria 1°,TopKids,115,24,91
2025-09-22,15,Primaria 1°,TopKids,160,6,154
2025-09-22,15,Primaria 1°,SuperSchool,90,9,81
2025-09-22,15,Primaria 1°,SuperSchool,99,13,86
2025-09-22,15,Primaria 1°,EduMax,238,23,215
2025-09-22,15,Primaria 1°,SuperSchool,240,17,223
2025-09-22,15,Primaria 1°,EduMax,296,21,275
2025-09-22,15,Primaria 1°,TopKids,250,23,227
2025-09-22,15,Primaria 1°,TopKids,137,9,128
2025-09-22,15,Primaria 1°,SuperSchool,251,20,231
2025-09-22,15,Primaria 1°,EduMax,181,1,180
2025-09-22,15,Primaria 2°,EduMax,78,12,66
2025-09-22,15,Primaria 2°,TopKids,177,13,164
2025-09-22,15,Primaria 2°,EduMax,186,17,169
2025-09-22,15,Primaria 2°,TopKids,108,6,102
2025-09-22,15,Primaria 2°,EduMax,297,18,279
2025-09-22,15,Primaria 2°,EduMax,175,4,171
2025-09-22,15,Primaria 2°,SuperSchool,82,20,62
2025-09-22,15,Primaria 2°,EduMax,116,20,96
2025-09-22,15,Primaria 2°,TopKids,119,7,112
2025-09-22,15,Primaria 2°,TopKids,272,7,265
2025-09-22,15,Primaria 3°,SuperSchool,164,12,152
2025-09-22,15,Primaria 3°,SuperSchool,146,18,128
2025-09-22,15,Primaria 3°,EduMax,169,20,149
2025-09-22,15,Primaria 3°,EduMax,267,3,264
2025-09-22,15,Primaria 3°,EduMax,185,16,169
2025-09-22,15,Primaria 4°,SuperSchool,213,1,212
2025-09-22,15,Primaria 4°,SuperSchool,139,23,116
2025-09-22,15,Primaria 4°,EduMax,220,4,216
2025-09-22,15,Primaria 4°,SuperSchool,161,9,152
2025-09-22,15,Primaria 4°,EduMax,206,14,192
2025-09-22,15,Primaria 4°,EduMax,211,1,210
2025-09-22,15,Primaria 5°,EduMax,292,23,269
2025-09-22,15,Primaria 5°,TopKids,71,15,56
2025-09-22,15,Primaria 5°,SuperSchool,276,15,261
2025-09-22,15,Primaria 5°,SuperSchool,150,4,146
2025-09-22,15,Primaria 5°,TopKids,243,5,238
2025-09-22,15,Primaria 5°,EduMax,147,15,132
2025-09-22,15,Primaria 5°,EduMax,175,18,157
2025-09-22,15,Primaria 5°,TopKids,282,19,263
2025-09-22,15,Primaria 6°,EduMax,202,17,185
2025-09-22,15,Primaria 6°,SuperSchool,101,17,84
2025-09-22,15,Primaria 6°,SuperSchool,215,5,210
2025-09-22,15,Primaria 6°,TopKids,86,11,75
2025-09-22,15,Primaria 6°,TopKids,124,12,112
2025-09-22,16,Preescolar,EduMax,84,7,77
2025-09-22,16,Preescolar,EduMax,167,16,151
2025-09-22,16,Preescolar,TopKids,63,17,46
2025-09-22,16,Preescolar,TopKids,209,11,198
2025-09-22,16,Preescolar,SuperSchool,151,17,134
2025-09-22,16,Preescolar,SuperSchool,219,18,201
2025-09-22,16,Preescolar,TopKids,184,23,161
2025-09-22,16,Preescolar,EduMax,125,11,114
2025-09-22,16,Preescolar,SuperSchool,244,2,242
2025-09-22,16,Preescolar,EduMax,272,22,250
2025-09-22,16,Preescolar,EduMax,204,15,189
2025-09-22,16,Preescolar,SuperSchool,171,3,168
2025-09-22,16,Preescolar,SuperSchool,147,10,137
2025-09-22,16,Preescolar,TopKids,58,20,38
2025-09-22,16,Preescolar,TopKids,281,17,264
2025-09-22,16,Preescolar,TopKids,188,16,172
2025-09-22,16,Kínder,EduMax,239,24,215
2025-09-22,16,Kínder,EduMax,265,4,261
2025-09-22,16,Kínder,EduMax,197,8,189
2025-09-22,16,Kínder,TopKids,126,4,122
2025-09-22,16,Kínder,SuperSchool,127,15,112
2025-09-22,16,Kínder,TopKids,265,23,242
2025-09-22,16,Kínder,SuperSchool,201,15,186
2025-09-22,16,Kínder,EduMax,209,3,206
2025-09-22,16,Kínder,EduMax,145,5,140
2025-09-22,16,Kínder,SuperSchool,288,1,287
2025-09-22,16,Kínder,SuperSchool,289,17,272
2025-09-22,16,Kínder,EduMax,128,14,114
2025-09-22,16,Kínder,SuperSchool,144,2,142
2025-09-22,16,Kínder,TopKids,105,12,93
2025-09-22,16,Kínder,EduMax,201,2,199
2025-09-22,16,Kínder,TopKids,253,9,244
2025-09-22,16,Kínder,EduMax,159,6,153
2025-09-22,16,Kínder,SuperSchool,92,19,73
2025-09-22,16,Primaria 1°,SuperSchool,148,3,145
2025-09-22,16,Primaria 1°,SuperSchool,209,21,188
2025-09-22,16,Primaria 1°,EduMax,272,8,264
2025-09-22,16,Primaria 1°,TopKids,277,3,274
2025-09-22,16,Primaria 1°,TopKids,236,2,234
2025-09-22,16,Primaria 1°,SuperSchool,221,2,219
2025-09-22,16,Primaria 1°,EduMax,256,16,240
2025-09-22,16,Primaria 1°,EduMax,269,22,247
2025-09-22,16,Primaria 1°,TopKids,295,22,273
2025-09-22,16,Primaria 2°,SuperSchool,268,23,245
2025-09-22,16,Primaria 2°,EduMax,140,9,131
2025-09-22,16,Primaria 2°,EduMax,66,22,44
2025-09-22,16,Primaria 2°,EduMax,140,7,133
2025-09-22,16,Primaria 2°,EduMax,218,6,212
2025-09-22,16,Primaria 2°,EduMax,167,20,147
2025-09-22,16,Primaria 2°,SuperSchool,148,15,133
2025-09-22,16,Primaria 2°,SuperSchool,75,24,51
2025-09-22,16,Primaria 3°,TopKids,76,17,59
2025-09-22,16,Primaria 3°,SuperSchool,243,6,237
2025-09-22,16,Primaria 3°,TopKids,202,16,186
2025-09-22,16,Primaria 3°,SuperSchool,183,23,160
2025-09-22,16,Primaria 3°,TopKids,170,5,165
2025-09-22,16,Primaria 3°,SuperSchool,58,13,45
2025-09-22,16,Primaria 3°,TopKids,289,8,281
2025-09-22,16,Primaria 3°,EduMax,150,13,137
2025-09-22,16,Primaria 3°,TopKids,81,7,74
2025-09-22,16,Primaria 3°,SuperSchool,275,19,256
2025-09-22,16,Primaria 3°,EduMax,239,14,225
2025-09-22,16,Primaria 3°,SuperSchool,149,17,132
2025-09-22,16,Primaria 4°,SuperSchool,65,24,41
2025-09-22,16,Primaria 4°,EduMax,185,15,170
2025-09-22,16,Primaria 4°,EduMax,163,10,153
2025-09-22,16,Primaria 4°,TopKids,73,17,56
2025-09-22,16,Primaria 4°,SuperSchool,295,21,274
2025-09-22,16,Primaria 4°,EduMax,160,23,137
2025-09-22,16,Primaria 4°,EduMax,251,1,250
2025-09-22,16,Primaria 4°,TopKids,279,13,266
2025-09-22,16,Primaria 4°,EduMax,84,12,72
2025-09-22,16,Primaria 4°,TopKids,209,22,187
2025-09-22,16,Primaria 4°,TopKids,183,9,174
2025-09-22,16,Primaria 4°,SuperSchool,217,5,212
2025-09-22,16,Primaria 4°,EduMax,180,4,176
2025-09-22,16,Primaria 4°,TopKids,123,8,115
2025-09-22,16,Primaria 5°,SuperSchool,233,19,214
2025-09-22,16,Primaria 5°,TopKids,92,24,68
2025-09-22,16,Primaria 5°,TopKids,274,23,251
2025-09-22,16,Primaria 5°,EduMax,260,1,259
2025-09-22,16,Primaria 5°,TopKids,204,12,192
2025-09-22,16,Primaria 5°,EduMax,160,7,153
2025-09-22,16,Primaria 5°,EduMax,131,16,115
2025-09-22,16,Primaria 5°,EduMax,191,21,170
2025-09-22,16,Primaria 5°,TopKids,268,6,262
2025-09-22,16,Primaria 5°,TopKids,123,12,111
2025-09-22,16,Primaria 5°,SuperSchool,141,17,124
2025-09-22,16,Primaria 5°,EduMax,188,6,182
2025-09-22,16,Primaria 5°,TopKids,115,22,93
2025-09-22,16,Primaria 6°,SuperSchool,206,9,197
2025-09-22,16,Primaria 6°,TopKids,253,16,237
2025-09-22,16,Primaria 6°,SuperSchool,132,2,130
2025-09-22,16,Primaria 6°,TopKids,143,5,138
2025-09-22,16,Primaria 6°,TopKids,141,17,124
2025-09-22,16,Primaria 6°,EduMax,241,24,217
2025-09-22,16,Primaria 6°,TopKids,119,3,116
2025-09-22,16,Primaria 6°,SuperSchool,70,15,55
2025-09-22,16,Primaria 6°,SuperSchool,282,9,273
2025-09-22,16,Primaria 6°,SuperSchool,248,2,246
2025-09-22,16,Primaria 6°,EduMax,55,10,45
2025-09-23,9,Preescolar,EduMax,180,16,164
2025-09-23,9,Preescolar,SuperSchool,97,23,74
2025-09-23,9,Preescolar,TopKids,182,24,158
2025-09-23,9,Preescolar,SuperSchool,215,18,197
2025-09-23,9,Preescolar,SuperSchool,56,17,39
2025-09-23,9,Kínder,SuperSchool,282,24,258
2025-09-23,9,Kínder,TopKids,138,14,124
2025-09-23,9,Kínder,SuperSchool,184,17,167
2025-09-23,9,Kínder,TopKids,90,19,71
2025-09-23,9,Kínder,SuperSchool,262,13,249
2025-09-23,9,Kínder,SuperSchool,158,14,144
2025-09-23,9,Kínder,EduMax,158,23,135
2025-09-23,9,Kínder,EduMax,231,2,229
2025-09-23,9,Kínder,TopKids,51,16,35
2025-09-23,9,Kínder,EduMax,55,16,39
2025-09-23,9,Kínder,SuperSchool,94,10,84
2025-09-23,9,Kínder,TopKids,293,9,284
2025-09-23,9,Kínder,EduMax,70,16,54
2025-09-23,9,Kínder,TopKids,295,2,293
2025-09-23,9,Primaria 1°,EduMax,170,20,150
2025-09-23,9,Primaria 1°,TopKids,214,8,206
2025-09-23,9,Primaria 1°,EduMax,264,15,249
2025-09-23,9,Primaria 1°,SuperSchool,84,24,60
2025-09-23,9,Primaria 1°,EduMax,224,4,220
2025-09-23,9,Primaria 1°,TopKids,170,9,161
2025-09-23,9,Primaria 1°,EduMax,235,13,222
2025-09-23,9,Primaria 1°,TopKids,218,4,214
2025-09-23,9,Primaria 1°,SuperSchool,286,10,276
2025-09-23,9,Primaria 1°,EduMax,289,19,270
2025-09-23,9,Primaria 1°,EduMax,171,7,164
2025-09-23,9,Primaria 1°,TopKids,158,15,143
2025-09-23,9,Primaria 1°,TopKids,131,2,129
2025-09-23,9,Primaria 1°,EduMax,197,7,190
2025-09-23,9,Primaria 1°,EduMax,109,2,107
2025-09-23,9,Primaria 1°,SuperSchool,244,3,241
2025-09-23,9,Primaria 1°,TopKids,274,19,255
2025-09-23,9,Primaria 2°,EduMax,204,6,198
2025-09-23,9,Primaria 2°,SuperSchool,261,6,255
2025-09-23,9,Primaria 2°,SuperSchool,142,21,121
2025-09-23,9,Primaria 2°,EduMax,274,16,258
2025-09-23,9,Primaria 2°,EduMax,269,18,251
2025-09-23,9,Primaria 2°,EduMax,106,10,96
2025-09-23,9,Primaria 2°,EduMax,278,2,276
2025-09-23,9,Primaria 2°,SuperSchool,146,1,145
2025-09-23,9,Primaria 2°,EduMax,75,7,68
2025-09-23,9,Primaria 2°,TopKids,240,16,224
2025-09-23,9,Primaria 2°,TopKids,207,9,198
2025-09-23,9,Primaria 2°,SuperSchool,99,7,92
2025-09-23,9,Primaria 2°,EduMax,123,20,103
2025-09-23,9,Primaria 2°,EduMax,284,18,266
2025-09-23,9,Primaria 2°,TopKids,255,13,242
2025-09-23,9,Primaria 2°,SuperSchool,209,10,199
2025-09-23,9,Primaria 2°,TopKids,292,17,275
2025-09-23,9,Primaria 2°,TopKids,283,22,261
2025-09-23,9,Primaria 2°,TopKids,120,18,102
2025-09-23,9,Primaria 3°,EduMax,243,13,230
2025-09-23,9,Primaria 3°,SuperSchool,157,5,152
2025-09-23,9,Primaria 3°,TopKids,51,11,40
2025-09-23,9,Primaria 3°,TopKids,89,4,85
2025-09-23,9,Primaria 3°,TopKids,223,9,214
2025-09-23,9,Primaria 3°,EduMax,63,3,60
2025-09-23,9,Primaria 3°,TopKids,158,14,144
2025-09-23,9,Primaria 3°,SuperSchool,180,15,165
2025-09-23,9,Primaria 3°,SuperSchool,110,2,108
2025-09-23,9,Primaria 3°,SuperSchool,298,10,288
2025-09-23,9,Primaria 3°,TopKids,167,15,152
2025-09-23,9,Primaria 3°,TopKids,230,12,218
2025-09-23,9,Primaria 3°,SuperSchool,129,8,121
2025-09-23,9,Primaria 3°,SuperSchool,150,24,126
2025-09-23,9,Primaria 3°,TopKids,281,18,263
2025-09-23,9,Primaria 4°,TopKids,290,4,286
2025-09-23,9,Primaria 4°,EduMax,197,20,177
2025-09-23,9,Primaria 4°,SuperSchool,127,1,126
2025-09-23,9,Primaria 4°,SuperSchool,264,13,251
2025-09-23,9,Primaria 4°,EduMax,230,18,212
2025-09-23,9,Primaria 4°,EduMax,219,4,215
2025-09-23,9,Primaria 4°,TopKids,160,4,156
2025-09-23,9,Primaria 4°,TopKids,61,13,48
2025-09-23,9,Primaria 4°,EduMax,153,4,149
2025-09-23,9,Primaria 5°,EduMax,232,5,227
2025-09-23,9,Primaria 5°,SuperSchool,296,4,292
2025-09-23,9,Primaria 5°,TopKids,90,12,78
2025-09-23,9,Primaria 5°,TopKids,214,2,212
2025-09-23,9,Primaria 5°,TopKids,94,7,87
2025-09-23,9,Primaria 5°,SuperSchool,217,20,197
2025-09-23,9,Primaria 5°,TopKids,285,18,267
2025-09-23,9,Primaria 5°,EduMax,145,16,129
2025-09-23,9,Primaria 5°,EduMax,183,18,165
2025-09-23,9,Primaria 5°,SuperSchool,131,24,107
2025-09-23,9,Primaria 5°,SuperSchool,180,9,171
2025-09-23,9,Primaria 5°,TopKids,265,22,243
2025-09-23,9,Primaria 5°,TopKids,240,19,221
2025-09-23,9,Primaria 6°,SuperSchool,82,11,71
2025-09-23,9,Primaria 6°,TopKids,237,23,214
2025-09-23,9,Primaria 6°,EduMax,286,22,264
2025-09-23,9,Primaria 6°,EduMax,239,15,224
2025-09-23,9,Primaria 6°,SuperSchool,123,8,115
2025-09-23,10,Preescolar,SuperSchool,132,18,114
2025-09-23,10,Preescolar,TopKids,118,14,104
2025-09-23,10,Preescolar,SuperSchool,210,11,199
2025-09-23,10,Preescolar,EduMax,240,12,228
2025-09-23,10,Preescolar,TopKids,153,22,131
2025-09-23,10,Preescolar,EduMax,119,3,116
2025-09-23,10,Preescolar,TopKids,193,17,176
2025-09-23,10,Preescolar,TopKids,95,1,94
2025-09-23,10,Preescolar,EduMax,93,20,73
2025-09-23,10,Kínder,EduMax,289,15,274
2025-09-23,10,Kínder,SuperSchool,210,13,197
2025-09-23,10,Kínder,EduMax,180,24,156
2025-09-23,10,Kínder,TopKids,120,8,112
2025-09-23,10,Kínder,SuperSchool,227,10,217
2025-09-23,10,Kínder,TopKids,168,21,147
2025-09-23,10,Kínder,SuperSchool,109,10,99
2025-09-23,10,Kínder,SuperSchool,114,21,93
2025-09-23,10,Kínder,TopKids,118,15,103
2025-09-23,10,Kínder,EduMax,75,11,64
2025-09-23,10,Kínder,TopKids,162,21,141
2025-09-23,10,Primaria 1°,EduMax,119,22,97
2025-09-23,10,Primaria 1°,SuperSchool,262,24,238
2025-09-23,10,Primaria 1°,EduMax,258,21,237
2025-09-23,10,Primaria 1°,TopKids,221,23,198
2025-09-23,10,Primaria 1°,EduMax,85,2,83
2025-09-23,10,Primaria 1°,EduMax,215,22,193
2025-09-23,10,Primaria 1°,SuperSchool,252,23,229
2025-09-23,10,Primaria 1°,TopKids,174,21,153
2025-09-23,10,Primaria 1°,SuperSchool,93,4,89
2025-09-23,10,Primaria 1°,TopKids,260,11,249
2025-09-23,10,Primaria 1°,TopKids,254,13,241
2025-09-23,10,Primaria 1°,TopKids,289,13,276
2025-09-23,10,Primaria 1°,TopKids,268,11,257
2025-09-23,10,Primaria 1°,SuperSchool,249,10,239
2025-09-23,10,Primaria 1°,EduMax,143,22,121
2025-09-23,10,Primaria 1°,EduMax,98,7,91
2025-09-23,10,Primaria 1°,EduMax,251,20,231
2025-09-23,10,Primaria 1°,TopKids,135,13,122
2025-09-23,10,Primaria 2°,TopKids,56,20,36
2025-09-23,10,Primaria 2°,TopKids,91,12,79
2025-09-23,10,Primaria 2°,SuperSchool,61,12,49
2025-09-23,10,Primaria 2°,EduMax,52,8,44
2025-09-23,10,Primaria 2°,SuperSchool,111,13,98
2025-09-23,10,Primaria 2°,SuperSchool,73,4,69
2025-09-23,10,Primaria 2°,EduMax,117,11,106
2025-09-23,10,Primaria 2°,EduMax,274,13,261
2025-09-23,10,Primaria 2°,SuperSchool,76,22,54
2025-09-23,10,Primaria 2°,SuperSchool,228,16,212
2025-09-23,10,Primaria 2°,EduMax,155,5,150
2025-09-23,10,Primaria 3°,EduMax,228,14,214
2025-09-23,10,Primaria 3°,TopKids,220,3,217
2025-09-23,10,Primaria 3°,SuperSchool,83,6,77
2025-09-23,10,Primaria 3°,SuperSchool,237,14,223
2025-09-23,10,Primaria 3°,SuperSchool,121,17,104
2025-09-23,10,Primaria 3°,SuperSchool,196,9,187
2025-09-23,10,Primaria 3°,TopKids,291,1,290
2025-09-23,10,Primaria 3°,SuperSchool,158,12,146
2025-09-23,10,Primaria 3°,SuperSchool,219,19,200
2025-09-23,10,Primaria 3°,EduMax,88,14,74
2025-09-23,10,Primaria 3°,EduMax,87,9,78
2025-09-23,10,Primaria 3°,SuperSchool,96,1,95
2025-09-23,10,Primaria 3°,EduMax,151,23,128
2025-09-23,10,Primaria 3°,TopKids,243,10,233
2025-09-23,10,Primaria 3°,EduMax,100,23,77
2025-09-23,10,Primaria 3°,SuperSchool,188,4,184
2025-09-23,10,Primaria 3°,EduMax,151,3,148
2025-09-23,10,Primaria 3°,SuperSchool,260,3,257
2025-09-23,10,Primaria 3°,EduMax,259,12,247
2025-09-23,10,Primaria 4°,SuperSchool,189,24,165
2025-09-23,10,Primaria 4°,SuperSchool,216,9,207
2025-09-23,10,Primaria 4°,TopKids,181,24,157
2025-09-23,10,Primaria 4°,EduMax,172,19,153
2025-09-23,10,Primaria 4°,SuperSchool,259,10,249
2025-09-23,10,Primaria 4°,EduMax,297,12,285
2025-09-23,10,Primaria 4°,TopKids,197,8,189
2025-09-23,10,Primaria 4°,TopKids,210,4,206
2025-09-23,10,Primaria 4°,EduMax,263,4,259
2025-09-23,10,Primaria 4°,TopKids,185,9,176
2025-09-23,10,Primaria 4°,TopKids,259,3,256
2025-09-23,10,Primaria 4°,SuperSchool,114,7,107
2025-09-23,10,Primaria 4°,EduMax,256,23,233
2025-09-23,10,Primaria 4°,SuperSchool,264,5,259
2025-09-23,10,Primaria 4°,TopKids,255,14,241
2025-09-23,10,Primaria 4°,SuperSchool,231,6,225
2025-09-23,10,Primaria 5°,TopKids,79,16,63
2025-09-23,10,Primaria 5°,TopKids,208,22,186
2025-09-23,10,Primaria 5°,SuperSchool,52,3,49
2025-09-23,10,Primaria 5°,EduMax,135,21,114
2025-09-23,10,Primaria 5°,TopKids,157,16,141
2025-09-23,10,Primaria 5°,EduMax,53,20,33
2025-09-23,10,Primaria 5°,EduMax,94,13,81
2025-09-23,10,Primaria 6°,EduMax,143,9,134
2025-09-23,10,Primaria 6°,TopKids,188,3,185
2025-09-23,10,Primaria 6°,SuperSchool,221,5,216
2025-09-23,10,Primaria 6°,EduMax,235,19,216
2025-09-23,10,Primaria 6°,EduMax,66,4,62
2025-09-23,10,Primaria 6°,SuperSchool,239,17,222
2025-09-23,10,Primaria 6°,EduMax,249,11,238
2025-09-23,10,Primaria 6°,EduMax,228,6,222
2025-09-23,10,Primaria 6°,TopKids,97,10,87
2025-09-23,10,Primaria 6°,SuperSchool,103,1,102
2025-09-23,10,Primaria 6°,SuperSchool,228,9,219
2025-09-23,10,Primaria 6°,SuperSchool,240,16,224
2025-09-23,10,Primaria 6°,EduMax,233,6,227
2025-09-23,10,Primaria 6°,SuperSchool,252,22,230
2025-09-23,10,Primaria 6°,TopKids,160,5,155
2025-09-23,10,Primaria 6°,TopKids,293,4,289
2025-09-23,10,Primaria 6°,TopKids,162,12,150
2025-09-23,10,Primaria 6°,EduMax,137,23,114
2025-09-23,10,Primaria 6°,SuperSchool,213,18,195
2025-09-23,11,Preescolar,SuperSchool,66,5,61
2025-09-23,11,Preescolar,SuperSchool,296,18,278
2025-09-23,11,Preescolar,EduMax,107,23,84
2025-09-23,11,Preescolar,SuperSchool,121,19,102
2025-09-23,11,Preescolar,EduMax,280,24,256
2025-09-23,11,Kínder,EduMax,269,21,248
2025-09-23,11,Kínder,SuperSchool,80,1,79
2025-09-23,11,Kínder,SuperSchool,110,10,100
2025-09-23,11,Kínder,SuperSchool,175,18,157
2025-09-23,11,Kínder,EduMax,242,13,229
2025-09-23,11,Kínder,EduMax,72,7,65
2025-09-23,11,Kínder,TopKids,205,8,197
2025-09-23,11,Kínder,SuperSchool,179,11,168
2025-09-23,11,Kínder,SuperSchool,265,12,253
2025-09-23,11,Kínder,TopKids,123,15,108
2025-09-23,11,Kínder,EduMax,170,5,165
2025-09-23,11,Kínder,TopKids,218,18,200
2025-09-23,11,Kínder,EduMax,188,14,174
2025-09-23,11,Primaria 1°,TopKids,53,7,46
2025-09-23,11,Primaria 1°,SuperSchool,226,17,209
2025-09-23,11,Primaria 1°,TopKids,104,12,92
2025-09-23,11,Primaria 1°,TopKids,211,8,203
2025-09-23,11,Primaria 1°,TopKids,75,2,73
2025-09-23,11,Primaria 2°,EduMax,242,18,224
2025-09-23,11,Primaria 2°,SuperSchool,57,8,49
2025-09-23,11,Primaria 2°,EduMax,133,14,119
2025-09-23,11,Primaria 2°,SuperSchool,107,20,87
2025-09-23,11,Primaria 2°,TopKids,128,19,109
2025-09-23,11,Primaria 2°,SuperSchool,106,3,103
2025-09-23,11,Primaria 2°,SuperSchool,228,17,211
2025-09-23,11,Primaria 2°,SuperSchool,101,16,85
2025-09-23,11,Primaria 2°,EduMax,125,7,118
2025-09-23,11,Primaria 2°,EduMax,76,24,52
2025-09-23,11,Primaria 2°,SuperSchool,188,22,166
2025-09-23,11,Primaria 2°,EduMax,225,10,215
2025-09-23,11,Primaria 3°,SuperSchool,153,5,148
2025-09-23,11,Primaria 3°,SuperSchool,190,10,180
2025-09-23,11,Primaria 3°,EduMax,203,21,182
2025-09-23,11,Primaria 3°,TopKids,221,12,209
2025-09-23,11,Primaria 3°,TopKids,220,20,200
2025-09-23,11,Primaria 3°,TopKids,107,12,95
2025-09-23,11,Primaria 3°,EduMax,91,20,71
2025-09-23,11,Primaria 3°,EduMax,237,1,236
2025-09-23,11,Primaria 3°,EduMax,258,4,254
2025-09-23,11,Primaria 3°,EduMax,234,9,225
2025-09-23,11,Primaria 3°,TopKids,216,21,195
2025-09-23,11,Primaria 3°,EduMax,66,3,63
2025-09-23,11,Primaria 4°,EduMax,54,4,50
2025-09-23,11,Primaria 4°,TopKids,215,6,209
2025-09-23,11,Primaria 4°,SuperSchool,261,9,252
2025-09-23,11,Primaria 4°,SuperSchool,192,20,172
2025-09-23,11,Primaria 4°,EduMax,79,10,69
2025-09-23,11,Primaria 5°,EduMax,236,24,212
2025-09-23,11,Primaria 5°,EduMax,190,19,171
2025-09-23,11,Primaria 5°,TopKids,111,7,104
2025-09-23,11,Primaria 5°,EduMax,276,5,271
2025-09-23,11,Primaria 5°,EduMax,247,17,230
2025-09-23,11,Primaria 5°,SuperSchool,201,13,188
2025-09-23,11,Primaria 5°,SuperSchool,206,24,182
2025-09-23,11,Primaria 5°,EduMax,147,14,133
2025-09-23,11,Primaria 5°,TopKids,182,8,174
2025-09-23,11,Primaria 5°,TopKids,186,16,170
2025-09-23,11,Primaria 5°,SuperSchool,231,15,216
2025-09-23,11,Primaria 5°,SuperSchool,193,12,181
2025-09-23,11,Primaria 5°,EduMax,285,15,270
2025-09-23,11,Primaria 5°,SuperSchool,210,20,190
2025-09-23,11,Primaria 5°,EduMax,276,8,268
2025-09-23,11,Primaria 5°,TopKids,222,10,212
2025-09-23,11,Primaria 5°,TopKids,258,11,247
2025-09-23,11,Primaria 5°,TopKids,96,12,84
2025-09-23,11,Primaria 6°,EduMax,61,4,57
2025-09-23,11,Primaria 6°,TopKids,259,13,246
2025-09-23,11,Primaria 6°,SuperSchool,242,24,218
2025-09-23,11,Primaria 6°,SuperSchool,162,20,142
2025-09-23,11,Primaria 6°,EduMax,113,9,104
2025-09-23,11,Primaria 6°,EduMax,167,17,150
2025-09-23,12,Preescolar,TopKids,213,18,195
2025-09-23,12,Preescolar,TopKids,128,1,127
2025-09-23,12,Preescolar,EduMax,137,1,136
2025-09-23,12,Preescolar,TopKids,156,6,150
2025-09-23,12,Preescolar,SuperSchool,240,14,226
2025-09-23,12,Kínder,EduMax,175,17,158
2025-09-23,12,Kínder,SuperSchool,194,14,180
2025-09-23,12,Kínder,TopKids,57,24,33
2025-09-23,12,Kínder,TopKids,93,2,91
2025-09-23,12,Kínder,TopKids,230,13,217
2025-09-23,12,Kínder,SuperSchool,131,1,130
2025-09-23,12,Kínder,SuperSchool,70,12,58
2025-09-23,12,Kínder,TopKids,105,6,99
2025-09-23,12,Kínder,EduMax,179,20,159
2025-09-23,12,Kínder,TopKids,190,14,176
2025-09-23,12,Kínder,EduMax,125,13,112
2025-09-23,12,Kínder,TopKids,191,18,173
2025-09-23,12,Primaria 1°,TopKids,149,6,143
2025-09-23,12,Primaria 1°,EduMax,167,6,161
2025-09-23,12,Primaria 1°,TopKids,105,24,81
2025-09-23,12,Primaria 1°,EduMax,62,7,55
2025-09-23,12,Primaria 1°,SuperSchool,198,6,192
2025-09-23,12,Primaria 1°,EduMax,191,3,188
2025-09-23,12,Primaria 1°,TopKids,220,13,207
2025-09-23,12,Primaria 1°,TopKids,61,23,38
2025-09-23,12,Primaria 1°,EduMax,262,22,240
2025-09-23,12,Primaria 1°,EduMax,197,5,192
2025-09-23,12,Primaria 1°,SuperSchool,104,11,93
2025-09-23,12,Primaria 1°,SuperSchool,109,10,99
2025-09-23,12,Primaria 1°,EduMax,118,22,96
2025-09-23,12,Primaria 1°,SuperSchool,133,24,109
2025-09-23,12,Primaria 1°,EduMax,96,16,80
2025-09-23,12,Primaria 1°,SuperSchool,283,24,259
2025-09-23,12,Primaria 1°,TopKids,121,2,119
2025-09-23,12,Primaria 1°,EduMax,88,23,65
2025-09-23,12,Primaria 2°,EduMax,232,6,226
2025-09-23,12,Primaria 2°,TopKids,126,12,114
2025-09-23,12,Primaria 2°,TopKids,107,17,90
2025-09-23,12,Primaria 2°,SuperSchool,140,24,116
2025-09-23,12,Primaria 2°,TopKids,191,3,188
2025-09-23,12,Primaria 3°,TopKids,298,14,284
2025-09-23,12,Primaria 3°,TopKids,266,15,251
2025-09-23,12,Primaria 3°,SuperSchool,278,13,265
2025-09-23,12,Primaria 3°,TopKids,158,11,147
2025-09-23,12,Primaria 3°,SuperSchool,53,17,36
2025-09-23,12,Primaria 3°,TopKids,268,18,250
2025-09-23,12,Primaria 3°,EduMax,183,12,171
2025-09-23,12,Primaria 3°,SuperSchool,234,24,210
2025-09-23,12,Primaria 3°,SuperSchool,132,12,120
2025-09-23,12,Primaria 4°,TopKids,211,12,199
2025-09-23,12,Primaria 4°,TopKids,246,22,224
2025-09-23,12,Primaria 4°,SuperSchool,129,9,120
2025-09-23,12,Primaria 4°,SuperSchool,214,1,213
2025-09-23,12,Primaria 4°,SuperSchool,50,15,35
2025-09-23,12,Primaria 4°,SuperSchool,186,18,168
2025-09-23,12,Primaria 4°,EduMax,134,12,122
2025-09-23,12,Primaria 4°,EduMax,280,7,273
2025-09-23,12,Primaria 4°,TopKids,247,3,244
2025-09-23,12,Primaria 5°,SuperSchool,69,4,65
2025-09-23,12,Primaria 5°,SuperSchool,127,17,110
2025-09-23,12,Primaria 5°,TopKids,234,3,231
2025-09-23,12,Primaria 5°,SuperSchool,158,21,137
2025-09-23,12,Primaria 5°,EduMax,206,24,182
2025-09-23,12,Primaria 5°,TopKids,125,9,116
2025-09-23,12,Primaria 6°,SuperSchool,50,4,46
2025-09-23,12,Primaria 6°,TopKids,55,15,40
2025-09-23,12,Primaria 6°,EduMax,150,8,142
2025-09-23,12,Primaria 6°,TopKids,118,21,97
2025-09-23,12,Primaria 6°,TopKids,262,20,242
2025-09-23,12,Primaria 6°,EduMax,58,2,56
2025-09-23,12,Primaria 6°,SuperSchool,181,12,169
2025-09-23,12,Primaria 6°,TopKids,298,19,279
2025-09-23,12,Primaria 6°,TopKids,299,7,292
2025-09-23,12,Primaria 6°,SuperSchool,237,2,235
2025-09-23,12,Primaria 6°,TopKids,177,8,169
2025-09-23,12,Primaria 6°,EduMax,209,11,198
2025-09-23,12,Primaria 6°,EduMax,273,9,264
2025-09-23,12,Primaria 6°,TopKids,288,21,267
2025-09-23,13,Preescolar,EduMax,60,15,45
2025-09-23,13,Preescolar,TopKids,199,5,194
2025-09-23,13,Preescolar,EduMax,111,15,96
2025-09-23,13,Preescolar,SuperSchool,160,23,137
2025-09-23,13,Preescolar,TopKids,110,6,104
2025-09-23,13,Preescolar,EduMax,177,5,172
2025-09-23,13,Preescolar,EduMax,175,1,174
2025-09-23,13,Preescolar,TopKids,193,17,176
2025-09-23,13,Preescolar,SuperSchool,172,15,157
2025-09-23,13,Preescolar,EduMax,59,8,51
2025-09-23,13,Preescolar,TopKids,145,9,136
2025-09-23,13,Preescolar,TopKids,264,19,245
2025-09-23,13,Preescolar,EduMax,261,3,258
2025-09-23,13,Preescolar,SuperSchool,208,11,197
2025-09-23,13,Preescolar,TopKids,281,10,271
2025-09-23,13,Kínder,SuperSchool,91,10,81
2025-09-23,13,Kínder,EduMax,214,5,209
2025-09-23,13,Kínder,TopKids,261,20,241
2025-09-23,13,Kínder,SuperSchool,279,13,266
2025-09-23,13,Kínder,SuperSchool,254,16,238
2025-09-23,13,Kínder,TopKids,51,5,46
2025-09-23,13,Kínder,EduMax,155,11,144
2025-09-23,13,Kínder,TopKids,298,24,274
2025-09-23,13,Kínder,SuperSchool,222,13,209
2025-09-23,13,Kínder,SuperSchool,211,5,206
2025-09-23,13,Kínder,TopKids,139,5,134
2025-09-23,13,Kínder,EduMax,195,8,187
2025-09-23,13,Kínder,SuperSchool,232,20,212
2025-09-23,13,Kínder,SuperSchool,115,10,105
2025-09-23,13,Kínder,SuperSchool,69,6,63
2025-09-23,13,Kínder,SuperSchool,65,3,62
2025-09-23,13,Kínder,TopKids,149,1,148
2025-09-23,13,Primaria 1°,EduMax,73,19,54
2025-09-23,13,Primaria 1°,EduMax,285,18,267
2025-09-23,13,Primaria 1°,SuperSchool,293,23,270
2025-09-23,13,Primaria 1°,TopKids,170,13,157
2025-09-23,13,Primaria 1°,TopKids,100,13,87
2025-09-23,13,Primaria 1°,TopKids,68,21,47
2025-09-23,13,Primaria 1°,EduMax,215,3,212
2025-09-23,13,Primaria 1°,EduMax,225,9,216
2025-09-23,13,Primaria 1°,SuperSchool,136,9,127
2025-09-23,13,Primaria 1°,SuperSchool,132,15,117
2025-09-23,13,Primaria 1°,EduMax,149,24,125
2025-09-23,13,Primaria 1°,EduMax,192,19,173
2025-09-23,13,Primaria 1°,TopKids,182,12,170
2025-09-23,13,Primaria 1°,TopKids,96,15,81
2025-09-23,13,Primaria 1°,TopKids,215,17,198
2025-09-23,13,Primaria 1°,TopKids,224,15,209
2025-09-23,13,Primaria 1°,TopKids,143,22,121
2025-09-23,13,Primaria 1°,EduMax,132,1,131
2025-09-23,13,Primaria 2°,TopKids,146,23,123
2025-09-23,13,Primaria 2°,EduMax,279,4,275
2025-09-23,13,Primaria 2°,SuperSchool,147,17,130
2025-09-23,13,Primaria 2°,SuperSchool,207,13,194
2025-09-23,13,Primaria 2°,TopKids,142,2,140
2025-09-23,13,Primaria 2°,TopKids,61,4,57
2025-09-23,13,Primaria 2°,SuperSchool,203,18,185
2025-09-23,13,Primaria 2°,EduMax,171,2,169
2025-09-23,13,Primaria 2°,SuperSchool,82,24,58
2025-09-23,13,Primaria 2°,EduMax,80,13,67
2025-09-23,13,Primaria 2°,SuperSchool,228,1,227
2025-09-23,13,Primaria 2°,EduMax,287,9,278
2025-09-23,13,Primaria 2°,EduMax,156,4,152
2025-09-23,13,Primaria 2°,SuperSchool,276,5,271
2025-09-23,13,Primaria 2°,EduMax,187,6,181
2025-09-23,13,Primaria 3°,TopKids,188,20,168
2025-09-23,13,Primaria 3°,SuperSchool,195,20,175
2025-09-23,13,Primaria 3°,TopKids,299,14,285
2025-09-23,13,Primaria 3°,EduMax,52,12,40
2025-09-23,13,Primaria 3°,TopKids,237,24,213
2025-09-23,13,Primaria 3°,EduMax,104,6,98
2025-09-23,13,Primaria 3°,SuperSchool,287,4,283
2025-09-23,13,Primaria 3°,EduMax,193,17,176
2025-09-23,13,Primaria 3°,EduMax,259,13,246
2025-09-23,13,Primaria 3°,EduMax,261,16,245
2025-09-23,13,Primaria 3°,SuperSchool,286,14,272
2025-09-23,13,Primaria 3°,EduMax,195,8,187
2025-09-23,13,Primaria 3°,SuperSchool,137,9,128
2025-09-23,13,Primaria 3°,TopKids,270,9,261
2025-09-23,13,Primaria 4°,EduMax,67,14,53
2025-09-23,13,Primaria 4°,TopKids,259,16,243
2025-09-23,13,Primaria 4°,SuperSchool,123,20,103
2025-09-23,13,Primaria 4°,EduMax,218,23,195
2025-09-23,13,Primaria 4°,EduMax,284,20,264
2025-09-23,13,Primaria 4°,TopKids,99,5,94
2025-09-23,13,Primaria 4°,TopKids,122,11,111
2025-09-23,13,Primaria 4°,EduMax,154,4,150
2025-09-23,13,Primaria 5°,SuperSchool,52,22,30
2025-09-23,13,Primaria 5°,SuperSchool,161,13,148
2025-09-23,13,Primaria 5°,TopKids,149,1,148
2025-09-23,13,Primaria 5°,EduMax,185,9,176
2025-09-23,13,Primaria 5°,EduMax,118,12,106
2025-09-23,13,Primaria 5°,SuperSchool,213,17,196
2025-09-23,13,Primaria 5°,SuperSchool,284,23,261
2025-09-23,13,Primaria 5°,SuperSchool,207,15,192
2025-09-23,13,Primaria 5°,SuperSchool,53,12,41
2025-09-23,13,Primaria 5°,TopKids,133,17,116
2025-09-23,13,Primaria 5°,EduMax,184,7,177
2025-09-23,13,Primaria 5°,SuperSchool,111,12,99
2025-09-23,13,Primaria 6°,SuperSchool,295,10,285
2025-09-23,13,Primaria 6°,SuperSchool,287,6,281
2025-09-23,13,Primaria 6°,TopKids,135,15,120
2025-09-23,13,Primaria 6°,TopKids,204,7,197
2025-09-23,13,Primaria 6°,EduMax,73,8,65
2025-09-23,13,Primaria 6°,TopKids,60,4,56
2025-09-23,13,Primaria 6°,EduMax,178,7,171
2025-09-23,13,Primaria 6°,TopKids,121,13,108
2025-09-23,13,Primaria 6°,EduMax,280,24,256
2025-09-23,13,Primaria 6°,EduMax,285,7,278
2025-09-23,13,Primaria 6°,EduMax,207,7,200
2025-09-23,13,Primaria 6°,TopKids,79,15,64
2025-09-23,13,Primaria 6°,SuperSchool,51,8,43
2025-09-23,13,Primaria 6°,SuperSchool,97,13,84
2025-09-23,14,Preescolar,SuperSchool,277,12,265
2025-09-23,14,Preescolar,TopKids,179,20,159
2025-09-23,14,Preescolar,TopKids,262,16,246
2025-09-23,14,Preescolar,SuperSchool,181,2,179
2025-09-23,14,Preescolar,EduMax,114,22,92
2025-09-23,14,Preescolar,EduMax,197,20,177
2025-09-23,14,Kínder,TopKids,187,9,178
2025-09-23,14,Kínder,SuperSchool,110,15,95
2025-09-23,14,Kínder,EduMax,130,7,123
2025-09-23,14,Kínder,SuperSchool,129,17,112
2025-09-23,14,Kínder,TopKids,50,22,28
2025-09-23,14,Kínder,EduMax,204,16,188
2025-09-23,14,Kínder,SuperSchool,85,16,69
2025-09-23,14,Primaria 1°,TopKids,82,17,65
2025-09-23,14,Primaria 1°,SuperSchool,212,19,193
2025-09-23,14,Primaria 1°,TopKids,224,2,222
2025-09-23,14,Primaria 1°,SuperSchool,108,22,86
2025-09-23,14,Primaria 1°,TopKids,291,1,290
2025-09-23,14,Primaria 1°,EduMax,161,15,146
2025-09-23,14,Primaria 1°,SuperSchool,234,12,222
2025-09-23,14,Primaria 1°,SuperSchool,222,11,211
2025-09-23,14,Primaria 1°,EduMax,244,5,239
2025-09-23,14,Primaria 1°,EduMax,145,4,141
2025-09-23,14,Primaria 1°,SuperSchool,168,5,163
2025-09-23,14,Primaria 1°,EduMax,95,11,84
2025-09-23,14,Primaria 2°,SuperSchool,185,7,178
2025-09-23,14,Primaria 2°,TopKids,238,15,223
2025-09-23,14,Primaria 2°,SuperSchool,219,18,201
2025-09-23,14,Primaria 2°,EduMax,270,19,251
2025-09-23,14,Primaria 2°,SuperSchool,199,2,197
2025-09-23,14,Primaria 2°,EduMax,287,21,266
2025-09-23,14,Primaria 2°,EduMax,246,5,241
2025-09-23,14,Primaria 2°,EduMax,271,22,249
2025-09-23,14,Primaria 2°,SuperSchool,280,21,259
2025-09-23,14,Primaria 2°,TopKids,96,21,75
2025-09-23,14,Primaria 2°,TopKids,256,6,250
2025-09-23,14,Primaria 2°,TopKids,213,4,209
2025-09-23,14,Primaria 2°,SuperSchool,60,5,55
2025-09-23,14,Primaria 2°,EduMax,278,5,273
2025-09-23,14,Primaria 2°,TopKids,94,12,82
2025-09-23,14,Primaria 2°,EduMax,62,9,53
2025-09-23,14,Primaria 2°,SuperSchool,215,17,198
2025-09-23,14,Primaria 2°,SuperSchool,205,11,194
2025-09-23,14,Primaria 3°,SuperSchool,221,4,217
2025-09-23,14,Primaria 3°,EduMax,256,4,252
2025-09-23,14,Primaria 3°,EduMax,236,18,218
2025-09-23,14,Primaria 3°,SuperSchool,275,21,254
2025-09-23,14,Primaria 3°,TopKids,206,22,184
2025-09-23,14,Primaria 3°,EduMax,149,2,147
2025-09-23,14,Primaria 3°,SuperSchool,120,22,98
2025-09-23,14,Primaria 3°,SuperSchool,59,21,38
2025-09-23,14,Primaria 3°,TopKids,53,21,32
2025-09-23,14,Primaria 3°,SuperSchool,279,20,259
2025-09-23,14,Primaria 4°,TopKids,145,22,123
2025-09-23,14,Primaria 4°,SuperSchool,138,6,132
2025-09-23,14,Primaria 4°,TopKids,204,18,186
2025-09-23,14,Primaria 4°,EduMax,61,19,42
2025-09-23,14,Primaria 4°,TopKids,258,3,255
2025-09-23,14,Primaria 4°,TopKids,246,4,242
2025-09-23,14,Primaria 4°,EduMax,146,21,125
2025-09-23,14,Primaria 4°,TopKids,91,13,78
2025-09-23,14,Primaria 4°,EduMax,88,14,74
2025-09-23,14,Primaria 4°,EduMax,79,13,66
2025-09-23,14,Primaria 4°,SuperSchool,267,24,243
2025-09-23,14,Primaria 5°,EduMax,86,11,75
2025-09-23,14,Primaria 5°,EduMax,199,14,185
2025-09-23,14,Primaria 5°,SuperSchool,73,5,68
2025-09-23,14,Primaria 5°,TopKids,171,22,149
2025-09-23,14,Primaria 5°,SuperSchool,66,20,46
2025-09-23,14,Primaria 5°,EduMax,61,13,48
2025-09-23,14,Primaria 5°,EduMax,244,11,233
2025-09-23,14,Primaria 5°,TopKids,177,21,156
2025-09-23,14,Primaria 5°,EduMax,252,16,236
2025-09-23,14,Primaria 5°,EduMax,221,19,202
2025-09-23,14,Primaria 6°,EduMax,64,23,41
2025-09-23,14,Primaria 6°,SuperSchool,88,5,83
2025-09-23,14,Primaria 6°,TopKids,135,15,120
2025-09-23,14,Primaria 6°,EduMax,229,15,214
2025-09-23,14,Primaria 6°,SuperSchool,68,3,65
2025-09-23,14,Primaria 6°,EduMax,251,15,236
2025-09-23,14,Primaria 6°,EduMax,137,15,122
2025-09-23,14,Primaria 6°,TopKids,197,5,192
2025-09-23,14,Primaria 6°,TopKids,58,5,53
2025-09-23,14,Primaria 6°,TopKids,167,7,160
2025-09-23,14,Primaria 6°,TopKids,51,20,31
2025-09-23,14,Primaria 6°,EduMax,197,21,176
2025-09-23,14,Primaria 6°,TopKids,291,16,275
2025-09-23,15,Preescolar,TopKids,203,9,194
2025-09-23,15,Preescolar,SuperSchool,217,21,196
2025-09-23,15,Preescolar,SuperSchool,140,7,133
2025-09-23,15,Preescolar,EduMax,201,18,183
2025-09-23,15,Preescolar,EduMax,271,20,251
2025-09-23,15,Kínder,SuperSchool,205,4,201
2025-09-23,15,Kínder,TopKids,214,4,210
2025-09-23,15,Kínder,TopKids,205,5,200
2025-09-23,15,Kínder,SuperSchool,63,16,47
2025-09-23,15,Kínder,TopKids,160,18,142
2025-09-23,15,Kínder,EduMax,127,7,120
2025-09-23,15,Kínder,EduMax,109,20,89
2025-09-23,15,Kínder,EduMax,203,16,187
2025-09-23,15,Kínder,EduMax,164,9,155
2025-09-23,15,Kínder,SuperSchool,163,21,142
2025-09-23,15,Kínder,EduMax,159,8,151
2025-09-23,15,Kínder,TopKids,202,17,185
2025-09-23,15,Kínder,EduMax,64,10,54
2025-09-23,15,Kínder,TopKids,270,17,253
2025-09-23,15,Kínder,SuperSchool,195,14,181
2025-09-23,15,Kínder,TopKids,291,18,273
2025-09-23,15,Kínder,TopKids,202,11,191
2025-09-23,15,Kínder,EduMax,246,16,230
2025-09-23,15,Primaria 1°,SuperSchool,107,22,85
2025-09-23,15,Primaria 1°,TopKids,226,9,217
2025-09-23,15,Primaria 1°,TopKids,120,18,102
2025-09-23,15,Primaria 1°,EduMax,57,2,55
2025-09-23,15,Primaria 1°,EduMax,85,24,61
2025-09-23,15,Primaria 1°,TopKids,275,10,265
2025-09-23,15,Primaria 1°,EduMax,188,20,168
2025-09-23,15,Primaria 1°,EduMax,270,17,253
2025-09-23,15,Primaria 1°,EduMax,289,10,279
2025-09-23,15,Primaria 1°,EduMax,232,19,213
2025-09-23,15,Primaria 1°,SuperSchool,277,2,275
2025-09-23,15,Primaria 1°,EduMax,209,12,197
2025-09-23,15,Primaria 1°,EduMax,65,15,50
2025-09-23,15,Primaria 1°,EduMax,124,15,109
2025-09-23,15,Primaria 1°,EduMax,143,24,119
2025-09-23,15,Primaria 1°,TopKids,193,1,192
2025-09-23,15,Primaria 1°,SuperSchool,113,11,102
2025-09-23,15,Primaria 1°,EduMax,275,24,251
2025-09-23,15,Primaria 1°,EduMax,257,15,242
2025-09-23,15,Primaria 2°,SuperSchool,194,20,174
2025-09-23,15,Primaria 2°,EduMax,288,17,271
2025-09-23,15,Primaria 2°,EduMax,233,1,232
2025-09-23,15,Primaria 2°,TopKids,168,5,163
2025-09-23,15,Primaria 2°,TopKids,263,11,252
2025-09-23,15,Primaria 2°,SuperSchool,250,4,246
2025-09-23,15,Primaria 3°,EduMax,123,22,101
2025-09-23,15,Primaria 3°,SuperSchool,244,1,243
2025-09-23,15,Primaria 3°,EduMax,81,20,61
2025-09-23,15,Primaria 3°,TopKids,203,20,183
2025-09-23,15,Primaria 3°,SuperSchool,246,9,237
2025-09-23,15,Primaria 3°,TopKids,93,18,75
2025-09-23,15,Primaria 3°,EduMax,144,10,134
2025-09-23,15,Primaria 3°,TopKids,143,22,121
2025-09-23,15,Primaria 3°,TopKids,131,16,115
2025-09-23,15,Primaria 3°,SuperSchool,82,7,75
2025-09-23,15,Primaria 3°,EduMax,60,6,54
2025-09-23,15,Primaria 3°,SuperSchool,81,5,76
2025-09-23,15,Primaria 3°,EduMax,142,3,139
2025-09-23,15,Primaria 4°,TopKids,61,5,56
2025-09-23,15,Primaria 4°,EduMax,93,22,71
2025-09-23,15,Primaria 4°,TopKids,136,23,113
2025-09-23,15,Primaria 4°,SuperSchool,59,10,49
2025-09-23,15,Primaria 4°,SuperSchool,287,20,267
2025-09-23,15,Primaria 4°,TopKids,227,24,203
2025-09-23,15,Primaria 4°,EduMax,146,18,128
2025-09-23,15,Primaria 4°,TopKids,258,21,237
2025-09-23,15,Primaria 4°,SuperSchool,172,14,158
2025-09-23,15,Primaria 4°,SuperSchool,172,11,161
2025-09-23,15,Primaria 4°,EduMax,196,4,192
2025-09-23,15,Primaria 4°,SuperSchool,67,4,63
2025-09-23,15,Primaria 4°,TopKids,210,6,204
2025-09-23,15,Primaria 4°,TopKids,50,6,44
2025-09-23,15,Primaria 4°,TopKids,136,16,120
2025-09-23,15,Primaria 5°,EduMax,275,11,264
2025-09-23,15,Primaria 5°,TopKids,229,11,218
2025-09-23,15,Primaria 5°,TopKids,137,23,114
2025-09-23,15,Primaria 5°,SuperSchool,192,20,172
2025-09-23,15,Primaria 5°,EduMax,139,18,121
2025-09-23,15,Primaria 5°,SuperSchool,229,5,224
2025-09-23,15,Primaria 5°,EduMax,211,2,209
2025-09-23,15,Primaria 5°,EduMax,275,9,266
2025-09-23,15,Primaria 5°,SuperSchool,157,21,136
2025-09-23,15,Primaria 5°,TopKids,231,20,211
2025-09-23,15,Primaria 5°,EduMax,244,19,225
2025-09-23,15,Primaria 5°,TopKids,257,11,246
2025-09-23,15,Primaria 5°,TopKids,235,24,211
2025-09-23,15,Primaria 5°,TopKids,199,11,188
2025-09-23,15,Primaria 5°,SuperSchool,219,24,195
2025-09-23,15,Primaria 6°,TopKids,182,14,168
2025-09-23,15,Primaria 6°,SuperSchool,106,21,85
2025-09-23,15,Primaria 6°,EduMax,50,12,38
2025-09-23,15,Primaria 6°,EduMax,53,15,38
2025-09-23,15,Primaria 6°,SuperSchool,165,12,153
2025-09-23,15,Primaria 6°,SuperSchool,126,10,116
2025-09-23,15,Primaria 6°,EduMax,122,18,104
2025-09-23,16,Preescolar,EduMax,124,13,111
2025-09-23,16,Preescolar,EduMax,125,19,106
2025-09-23,16,Preescolar,EduMax,196,12,184
2025-09-23,16,Preescolar,SuperSchool,293,23,270
2025-09-23,16,Preescolar,EduMax,271,22,249
2025-09-23,16,Preescolar,EduMax,222,10,212
2025-09-23,16,Kínder,SuperSchool,241,15,226
2025-09-23,16,Kínder,EduMax,203,5,198
2025-09-23,16,Kínder,EduMax,144,22,122
2025-09-23,16,Kínder,EduMax,282,15,267
2025-09-23,16,Kínder,SuperSchool,230,3,227
2025-09-23,16,Kínder,TopKids,211,18,193
2025-09-23,16,Kínder,EduMax,71,24,47
2025-09-23,16,Primaria 1°,TopKids,241,24,217
2025-09-23,16,Primaria 1°,EduMax,296,2,294
2025-09-23,16,Primaria 1°,TopKids,219,2,217
2025-09-23,16,Primaria 1°,SuperSchool,203,23,180
2025-09-23,16,Primaria 1°,EduMax,58,21,37
2025-09-23,16,Primaria 1°,EduMax,277,3,274
2025-09-23,16,Primaria 1°,TopKids,72,23,49
2025-09-23,16,Primaria 1°,SuperSchool,62,10,52
2025-09-23,16,Primaria 1°,TopKids,51,16,35
2025-09-23,16,Primaria 1°,SuperSchool,247,22,225
2025-09-23,16,Primaria 1°,TopKids,146,5,141
2025-09-23,16,Primaria 1°,EduMax,258,19,239
2025-09-23,16,Primaria 1°,EduMax,202,3,199
2025-09-23,16,Primaria 1°,SuperSchool,273,7,266
2025-09-23,16,Primaria 1°,EduMax,64,13,51
2025-09-23,16,Primaria 1°,EduMax,214,24,190
2025-09-23,16,Primaria 1°,EduMax,80,2,78
2025-09-23,16,Primaria 2°,EduMax,210,16,194
2025-09-23,16,Primaria 2°,TopKids,160,6,154
2025-09-23,16,Primaria 2°,TopKids,186,22,164
2025-09-23,16,Primaria 2°,EduMax,183,17,166
2025-09-23,16,Primaria 2°,SuperSchool,128,7,121
2025-09-23,16,Primaria 2°,EduMax,197,18,179
2025-09-23,16,Primaria 2°,TopKids,238,22,216
2025-09-23,16,Primaria 2°,SuperSchool,137,17,120
2025-09-23,16,Primaria 2°,EduMax,275,18,257
2025-09-23,16,Primaria 2°,EduMax,245,7,238
2025-09-23,16,Primaria 2°,TopKids,114,8,106
2025-09-23,16,Primaria 3°,EduMax,186,7,179
2025-09-23,16,Primaria 3°,TopKids,157,3,154
2025-09-23,16,Primaria 3°,SuperSchool,56,12,44
2025-09-23,16,Primaria 3°,TopKids,138,17,121
2025-09-23,16,Primaria 3°,EduMax,276,1,275
2025-09-23,16,Primaria 3°,EduMax,77,23,54
2025-09-23,16,Primaria 3°,EduMax,159,13,146
2025-09-23,16,Primaria 3°,SuperSchool,52,14,38
2025-09-23,16,Primaria 4°,TopKids,194,6,188
2025-09-23,16,Primaria 4°,TopKids,132,15,117
2025-09-23,16,Primaria 4°,TopKids,182,15,167
2025-09-23,16,Primaria 4°,SuperSchool,75,7,68
2025-09-23,16,Primaria 4°,SuperSchool,126,13,113
2025-09-23,16,Primaria 4°,TopKids,89,5,84
2025-09-23,16,Primaria 4°,SuperSchool,133,14,119
2025-09-23,16,Primaria 4°,TopKids,91,1,90
2025-09-23,16,Primaria 4°,TopKids,247,7,240
2025-09-23,16,Primaria 4°,TopKids,215,18,197
2025-09-23,16,Primaria 4°,EduMax,154,6,148
2025-09-23,16,Primaria 5°,SuperSchool,137,11,126
2025-09-23,16,Primaria 5°,TopKids,256,17,239
2025-09-23,16,Primaria 5°,SuperSchool,294,13,281
2025-09-23,16,Primaria 5°,TopKids,206,4,202
2025-09-23,16,Primaria 5°,TopKids,162,16,146
2025-09-23,16,Primaria 5°,TopKids,240,2,238
2025-09-23,16,Primaria 5°,SuperSchool,191,16,175
2025-09-23,16,Primaria 5°,SuperSchool,149,8,141
2025-09-23,16,Primaria 5°,SuperSchool,272,16,256
2025-09-23,16,Primaria 5°,SuperSchool,84,22,62
2025-09-23,16,Primaria 6°,SuperSchool,291,18,273
2025-09-23,16,Primaria 6°,TopKids,183,6,177
2025-09-23,16,Primaria 6°,SuperSchool,174,16,158
2025-09-23,16,Primaria 6°,SuperSchool,181,16,165
2025-09-23,16,Primaria 6°,EduMax,208,22,186
2025-09-23,16,Primaria 6°,TopKids,167,21,146
2025-09-23,16,Primaria 6°,EduMax,136,12,124
2025-09-23,16,Primaria 6°,EduMax,257,7,250
2025-09-23,16,Primaria 6°,EduMax,52,1,51
2025-09-24,9,Preescolar,TopKids,78,7,71
2025-09-24,9,Preescolar,TopKids,217,9,208
2025-09-24,9,Preescolar,EduMax,256,4,252
2025-09-24,9,Preescolar,EduMax,259,12,247
2025-09-24,9,Preescolar,TopKids,151,4,147
2025-09-24,9,Kínder,EduMax,50,21,29
2025-09-24,9,Kínder,EduMax,203,9,194
2025-09-24,9,Kínder,SuperSchool,134,11,123
2025-09-24,9,Kínder,SuperSchool,166,9,157
2025-09-24,9,Kínder,TopKids,145,4,141
2025-09-24,9,Kínder,SuperSchool,110,19,91
2025-09-24,9,Kínder,TopKids,295,1,294
2025-09-24,9,Kínder,SuperSchool,226,7,219
2025-09-24,9,Primaria 1°,SuperSchool,79,14,65
2025-09-24,9,Primaria 1°,TopKids,272,3,269
2025-09-24,9,Primaria 1°,EduMax,88,19,69
2025-09-24,9,Primaria 1°,SuperSchool,147,12,135
2025-09-24,9,Primaria 1°,TopKids,59,20,39
2025-09-24,9,Primaria 1°,TopKids,177,23,154
2025-09-24,9,Primaria 1°,TopKids,267,19,248
2025-09-24,9,Primaria 1°,EduMax,197,13,184
2025-09-24,9,Primaria 1°,EduMax,97,11,86
2025-09-24,9,Primaria 1°,EduMax,266,11,255
2025-09-24,9,Primaria 1°,SuperSchool,209,1,208
2025-09-24,9,Primaria 1°,TopKids,144,7,137
2025-09-24,9,Primaria 1°,EduMax,201,5,196
2025-09-24,9,Primaria 1°,EduMax,157,4,153
2025-09-24,9,Primaria 1°,TopKids,99,24,75
2025-09-24,9,Primaria 1°,TopKids,278,6,272
2025-09-24,9,Primaria 1°,EduMax,247,20,227
2025-09-24,9,Primaria 1°,SuperSchool,72,12,60
2025-09-24,9,Primaria 2°,EduMax,285,8,277
2025-09-24,9,Primaria 2°,TopKids,293,2,291
2025-09-24,9,Primaria 2°,EduMax,150,18,132
2025-09-24,9,Primaria 2°,SuperSchool,212,16,196
2025-09-24,9,Primaria 2°,SuperSchool,90,6,84
2025-09-24,9,Primaria 2°,TopKids,177,22,155
2025-09-24,9,Primaria 2°,SuperSchool,273,16,257
2025-09-24,9,Primaria 2°,EduMax,88,4,84
2025-09-24,9,Primaria 2°,SuperSchool,68,17,51
2025-09-24,9,Primaria 2°,SuperSchool,179,2,177
2025-09-24,9,Primaria 2°,EduMax,104,4,100
2025-09-24,9,Primaria 2°,TopKids,149,20,129
2025-09-24,9,Primaria 2°,EduMax,269,20,249
2025-09-24,9,Primaria 2°,EduMax,146,17,129
2025-09-24,9,Primaria 2°,EduMax,125,10,115
2025-09-24,9,Primaria 2°,TopKids,66,11,55
2025-09-24,9,Primaria 3°,SuperSchool,101,7,94
2025-09-24,9,Primaria 3°,SuperSchool,132,11,121
2025-09-24,9,Primaria 3°,SuperSchool,227,23,204
2025-09-24,9,Primaria 3°,EduMax,192,13,179
2025-09-24,9,Primaria 3°,TopKids,289,19,270
2025-09-24,9,Primaria 3°,EduMax,205,22,183
2025-09-24,9,Primaria 3°,EduMax,82,18,64
2025-09-24,9,Primaria 3°,SuperSchool,222,16,206
2025-09-24,9,Primaria 3°,EduMax,164,23,141
2025-09-24,9,Primaria 3°,SuperSchool,239,8,231
2025-09-24,9,Primaria 3°,EduMax,280,3,277
2025-09-24,9,Primaria 3°,SuperSchool,133,11,122
2025-09-24,9,Primaria 4°,SuperSchool,222,12,210
2025-09-24,9,Primaria 4°,SuperSchool,63,21,42
2025-09-24,9,Primaria 4°,EduMax,271,10,261
2025-09-24,9,Primaria 4°,SuperSchool,209,12,197
2025-09-24,9,Primaria 4°,TopKids,93,1,92
2025-09-24,9,Primaria 4°,EduMax,70,2,68
2025-09-24,9,Primaria 4°,SuperSchool,70,17,53
2025-09-24,9,Primaria 4°,TopKids,64,1,63
2025-09-24,9,Primaria 4°,SuperSchool,191,15,176
2025-09-24,9,Primaria 4°,EduMax,261,2,259
2025-09-24,9,Primaria 4°,EduMax,225,17,208
2025-09-24,9,Primaria 5°,TopKids,289,4,285
2025-09-24,9,Primaria 5°,SuperSchool,210,23,187
2025-09-24,9,Primaria 5°,SuperSchool,62,7,55
2025-09-24,9,Primaria 5°,EduMax,282,14,268
2025-09-24,9,Primaria 5°,TopKids,114,8,106
2025-09-24,9,Primaria 5°,EduMax,144,4,140
2025-09-24,9,Primaria 6°,SuperSchool,163,9,154
2025-09-24,9,Primaria 6°,EduMax,151,21,130
2025-09-24,9,Primaria 6°,TopKids,257,1,256
2025-09-24,9,Primaria 6°,TopKids,247,10,237
2025-09-24,9,Primaria 6°,SuperSchool,249,1,248
2025-09-24,9,Primaria 6°,SuperSchool,203,16,187
2025-09-24,9,Primaria 6°,SuperSchool,88,15,73
2025-09-24,9,Primaria 6°,EduMax,235,17,218
2025-09-24,9,Primaria 6°,SuperSchool,264,7,257
2025-09-24,9,Primaria 6°,EduMax,249,13,236
2025-09-24,9,Primaria 6°,SuperSchool,53,11,42
2025-09-24,9,Primaria 6°,SuperSchool,196,22,174
2025-09-24,9,Primaria 6°,SuperSchool,196,19,177
2025-09-24,10,Preescolar,SuperSchool,196,11,185
2025-09-24,10,Preescolar,EduMax,266,7,259
2025-09-24,10,Preescolar,TopKids,50,15,35
2025-09-24,10,Preescolar,SuperSchool,181,13,168
2025-09-24,10,Preescolar,SuperSchool,89,21,68
2025-09-24,10,Preescolar,TopKids,220,10,210
2025-09-24,10,Preescolar,EduMax,66,13,53
2025-09-24,10,Preescolar,TopKids,295,9,286
2025-09-24,10,Preescolar,SuperSchool,175,10,165
2025-09-24,10,Preescolar,SuperSchool,229,10,219
2025-09-24,10,Preescolar,EduMax,287,15,272
2025-09-24,10,Preescolar,SuperSchool,275,14,261
2025-09-24,10,Preescolar,SuperSchool,152,4,148
2025-09-24,10,Preescolar,SuperSchool,231,22,209
2025-09-24,10,Preescolar,SuperSchool,252,1,251
2025-09-24,10,Preescolar,SuperSchool,262,9,253
2025-09-24,10,Preescolar,SuperSchool,131,7,124
2025-09-24,10,Preescolar,EduMax,203,24,179
2025-09-24,10,Preescolar,SuperSchool,259,1,258
2025-09-24,10,Kínder,SuperSchool,187,16,171
2025-09-24,10,Kínder,TopKids,145,21,124
2025-09-24,10,Kínder,TopKids,249,3,246
2025-09-24,10,Kínder,EduMax,181,8,173
2025-09-24,10,Kínder,TopKids,125,5,120
2025-09-24,10,Kínder,SuperSchool,143,3,140
2025-09-24,10,Kínder,SuperSchool,53,24,29
2025-09-24,10,Kínder,TopKids,70,16,54
2025-09-24,10,Kínder,SuperSchool,67,6,61
2025-09-24,10,Kínder,TopKids,81,16,65
2025-09-24,10,Kínder,SuperSchool,68,20,48
2025-09-24,10,Kínder,EduMax,203,14,189
2025-09-24,10,Kínder,EduMax,222,13,209
2025-09-24,10,Kínder,EduMax,64,4,60
2025-09-24,10,Kínder,EduMax,80,15,65
2025-09-24,10,Kínder,EduMax,270,10,260
2025-09-24,10,Kínder,TopKids,298,1,297
2025-09-24,10,Primaria 1°,SuperSchool,264,14,250
2025-09-24,10,Primaria 1°,TopKids,151,16,135
2025-09-24,10,Primaria 1°,TopKids,79,9,70
2025-09-24,10,Primaria 1°,TopKids,281,17,264
2025-09-24,10,Primaria 1°,EduMax,167,9,158
2025-09-24,10,Primaria 1°,SuperSchool,150,24,126
2025-09-24,10,Primaria 1°,TopKids,107,11,96
2025-09-24,10,Primaria 1°,EduMax,263,14,249
2025-09-24,10,Primaria 1°,TopKids,169,17,152
2025-09-24,10,Primaria 2°,EduMax,252,1,251
2025-09-24,10,Primaria 2°,TopKids,257,2,255
2025-09-24,10,Primaria 2°,SuperSchool,81,12,69
2025-09-24,10,Primaria 2°,EduMax,146,11,135
2025-09-24,10,Primaria 2°,SuperSchool,106,20,86
2025-09-24,10,Primaria 2°,SuperSchool,247,5,242
2025-09-24,10,Primaria 2°,EduMax,181,13,168
2025-09-24,10,Primaria 2°,EduMax,259,13,246
2025-09-24,10,Primaria 2°,TopKids,96,1,95
2025-09-24,10,Primaria 2°,TopKids,257,10,247
2025-09-24,10,Primaria 2°,TopKids,177,8,169
2025-09-24,10,Primaria 2°,TopKids,165,16,149
2025-09-24,10,Primaria 2°,EduMax,85,12,73
2025-09-24,10,Primaria 2°,SuperSchool,129,24,105
2025-09-24,10,Primaria 2°,SuperSchool,291,16,275
2025-09-24,10,Primaria 2°,SuperSchool,257,15,242
2025-09-24,10,Primaria 3°,TopKids,198,21,177
2025-09-24,10,Primaria 3°,TopKids,101,19,82
2025-09-24,10,Primaria 3°,SuperSchool,135,14,121
2025-09-24,10,Primaria 3°,EduMax,190,12,178
2025-09-24,10,Primaria 3°,EduMax,248,20,228
2025-09-24,10,Primaria 3°,TopKids,180,3,177
2025-09-24,10,Primaria 3°,TopKids,193,13,180
2025-09-24,10,Primaria 3°,EduMax,151,17,134
2025-09-24,10,Primaria 3°,EduMax,73,22,51
2025-09-24,10,Primaria 3°,EduMax,264,12,252
2025-09-24,10,Primaria 3°,TopKids,106,12,94
2025-09-24,10,Primaria 3°,TopKids,105,22,83
2025-09-24,10,Primaria 4°,EduMax,127,13,114
2025-09-24,10,Primaria 4°,EduMax,130,9,121
2025-09-24,10,Primaria 4°,EduMax,281,14,267
2025-09-24,10,Primaria 4°,EduMax,283,21,262
2025-09-24,10,Primaria 4°,TopKids,79,17,62
2025-09-24,10,Primaria 5°,SuperSchool,221,7,214
2025-09-24,10,Primaria 5°,TopKids,183,3,180
2025-09-24,10,Primaria 5°,TopKids,178,2,176
2025-09-24,10,Primaria 5°,SuperSchool,75,18,57
2025-09-24,10,Primaria 5°,EduMax,252,12,240
2025-09-24,10,Primaria 5°,EduMax,127,10,117
2025-09-24,10,Primaria 5°,SuperSchool,80,23,57
2025-09-24,10,Primaria 5°,TopKids,207,16,191
2025-09-24,10,Primaria 5°,EduMax,160,23,137
2025-09-24,10,Primaria 5°,SuperSchool,76,12,64
2025-09-24,10,Primaria 5°,EduMax,240,13,227
2025-09-24,10,Primaria 6°,EduMax,220,11,209
2025-09-24,10,Primaria 6°,EduMax,178,24,154
2025-09-24,10,Primaria 6°,EduMax,175,18,157
2025-09-24,10,Primaria 6°,EduMax,126,14,112
2025-09-24,10,Primaria 6°,EduMax,160,4,156
2025-09-24,10,Primaria 6°,TopKids,190,9,181
2025-09-24,10,Primaria 6°,EduMax,173,9,164
2025-09-24,10,Primaria 6°,EduMax,102,10,92
2025-09-24,10,Primaria 6°,TopKids,186,8,178
2025-09-24,10,Primaria 6°,EduMax,293,19,274
2025-09-24,10,Primaria 6°,SuperSchool,210,20,190
2025-09-24,10,Primaria 6°,EduMax,245,15,230
2025-09-24,10,Primaria 6°,EduMax,98,8,90
2025-09-24,10,Primaria 6°,EduMax,82,5,77
2025-09-24,10,Primaria 6°,TopKids,195,3,192
2025-09-24,10,Primaria 6°,EduMax,171,2,169
2025-09-24,10,Primaria 6°,SuperSchool,84,19,65
2025-09-24,10,Primaria 6°,TopKids,121,12,109
2025-09-24,11,Preescolar,EduMax,91,17,74
2025-09-24,11,Preescolar,EduMax,163,7,156
2025-09-24,11,Preescolar,SuperSchool,71,13,58
2025-09-24,11,Preescolar,EduMax,51,8,43
2025-09-24,11,Preescolar,SuperSchool,262,22,240
2025-09-24,11,Preescolar,TopKids,83,12,71
2025-09-24,11,Preescolar,SuperSchool,102,16,86
2025-09-24,11,Preescolar,EduMax,82,12,70
2025-09-24,11,Preescolar,SuperSchool,178,3,175
2025-09-24,11,Preescolar,TopKids,74,4,70
2025-09-24,11,Preescolar,SuperSchool,167,17,150
2025-09-24,11,Preescolar,TopKids,174,3,171
2025-09-24,11,Preescolar,EduMax,261,10,251
2025-09-24,11,Preescolar,TopKids,124,15,109
2025-09-24,11,Preescolar,TopKids,56,22,34
2025-09-24,11,Preescolar,SuperSchool,219,17,202
2025-09-24,11,Preescolar,EduMax,260,12,248
2025-09-24,11,Kínder,EduMax,285,19,266
2025-09-24,11,Kínder,SuperSchool,183,17,166
2025-09-24,11,Kínder,EduMax,216,6,210
2025-09-24,11,Kínder,EduMax,290,18,272
2025-09-24,11,Kínder,EduMax,125,6,119
2025-09-24,11,Kínder,EduMax,127,13,114
2025-09-24,11,Kínder,SuperSchool,163,10,153
2025-09-24,11,Kínder,EduMax,76,14,62
2025-09-24,11,Kínder,SuperSchool,186,9,177
2025-09-24,11,Kínder,TopKids,203,9,194
2025-09-24,11,Kínder,SuperSchool,155,3,152
2025-09-24,11,Kínder,EduMax,78,20,58
2025-09-24,11,Kínder,EduMax,158,20,138
2025-09-24,11,Kínder,TopKids,70,7,63
2025-09-24,11,Kínder,EduMax,232,8,224
2025-09-24,11,Kínder,EduMax,202,4,198
2025-09-24,11,Kínder,SuperSchool,298,18,280
2025-09-24,11,Primaria 1°,SuperSchool,71,24,47
2025-09-24,11,Primaria 1°,EduMax,169,24,145
2025-09-24,11,Primaria 1°,EduMax,278,11,267
2025-09-24,11,Primaria 1°,TopKids,139,20,119
2025-09-24,11,Primaria 1°,TopKids,193,20,173
2025-09-24,11,Primaria 1°,TopKids,255,14,241
2025-09-24,11,Primaria 2°,EduMax,274,16,258
2025-09-24,11,Primaria 2°,TopKids,269,12,257
2025-09-24,11,Primaria 2°,EduMax,122,14,108
2025-09-24,11,Primaria 2°,SuperSchool,228,22,206
2025-09-24,11,Primaria 2°,EduMax,209,16,193
2025-09-24,11,Primaria 2°,TopKids,74,17,57
2025-09-24,11,Primaria 2°,TopKids,86,3,83
2025-09-24,11,Primaria 2°,TopKids,200,1,199
2025-09-24,11,Primaria 2°,EduMax,88,7,81
2025-09-24,11,Primaria 2°,SuperSchool,296,17,279
2025-09-24,11,Primaria 2°,EduMax,152,13,139
2025-09-24,11,Primaria 2°,SuperSchool,158,10,148
2025-09-24,11,Primaria 3°,EduMax,215,7,208
2025-09-24,11,Primaria 3°,TopKids,126,23,103
2025-09-24,11,Primaria 3°,SuperSchool,62,11,51
2025-09-24,11,Primaria 3°,EduMax,270,24,246
2025-09-24,11,Primaria 3°,EduMax,80,17,63
2025-09-24,11,Primaria 3°,SuperSchool,174,20,154
2025-09-24,11,Primaria 3°,TopKids,296,10,286
2025-09-24,11,Primaria 3°,TopKids,163,12,151
2025-09-24,11,Primaria 4°,TopKids,60,15,45
2025-09-24,11,Primaria 4°,EduMax,254,22,232
2025-09-24,11,Primaria 4°,EduMax,297,15,282
2025-09-24,11,Primaria 4°,EduMax,185,6,179
2025-09-24,11,Primaria 4°,EduMax,54,20,34
2025-09-24,11,Primaria 4°,TopKids,281,14,267
2025-09-24,11,Primaria 5°,SuperSchool,168,20,148
2025-09-24,11,Primaria 5°,EduMax,196,4,192
2025-09-24,11,Primaria 5°,EduMax,56,16,40
2025-09-24,11,Primaria 5°,EduMax,156,22,134
2025-09-24,11,Primaria 5°,EduMax,182,12,170
2025-09-24,11,Primaria 5°,TopKids,137,24,113
2025-09-24,11,Primaria 5°,EduMax,203,23,180
2025-09-24,11,Primaria 5°,EduMax,195,11,184
2025-09-24,11,Primaria 5°,SuperSchool,183,13,170
2025-09-24,11,Primaria 5°,SuperSchool,258,16,242
2025-09-24,11,Primaria 6°,TopKids,233,1,232
2025-09-24,11,Primaria 6°,SuperSchool,283,13,270
2025-09-24,11,Primaria 6°,EduMax,134,18,116
2025-09-24,11,Primaria 6°,EduMax,204,4,200
2025-09-24,11,Primaria 6°,TopKids,129,7,122
2025-09-24,11,Primaria 6°,EduMax,120,2,118
2025-09-24,11,Primaria 6°,SuperSchool,166,8,158
2025-09-24,11,Primaria 6°,TopKids,270,20,250
2025-09-24,11,Primaria 6°,EduMax,50,6,44
2025-09-24,11,Primaria 6°,TopKids,130,24,106
2025-09-24,11,Primaria 6°,EduMax,298,24,274
2025-09-24,12,Preescolar,SuperSchool,91,3,88
2025-09-24,12,Preescolar,EduMax,168,13,155
2025-09-24,12,Preescolar,TopKids,196,18,178
2025-09-24,12,Preescolar,TopKids,195,9,186
2025-09-24,12,Preescolar,TopKids,152,21,131
2025-09-24,12,Preescolar,SuperSchool,151,7,144
2025-09-24,12,Preescolar,SuperSchool,138,20,118
2025-09-24,12,Kínder,SuperSchool,168,20,148
2025-09-24,12,Kínder,EduMax,261,8,253
2025-09-24,12,Kínder,EduMax,96,1,95
2025-09-24,12,Kínder,SuperSchool,88,16,72
2025-09-24,12,Kínder,TopKids,293,14,279
2025-09-24,12,Kínder,SuperSchool,221,5,216
2025-09-24,12,Kínder,TopKids,125,19,106
2025-09-24,12,Kínder,SuperSchool,280,7,273
2025-09-24,12,Kínder,SuperSchool,170,20,150
2025-09-24,12,Kínder,SuperSchool,239,5,234
2025-09-24,12,Primaria 1°,TopKids,293,19,274
2025-09-24,12,Primaria 1°,TopKids,106,4,102
2025-09-24,12,Primaria 1°,EduMax,98,17,81
2025-09-24,12,Primaria 1°,TopKids,159,21,138
2025-09-24,12,Primaria 1°,EduMax,170,10,160
2025-09-24,12,Primaria 1°,TopKids,162,2,160
2025-09-24,12,Primaria 1°,TopKids,268,12,256
2025-09-24,12,Primaria 1°,SuperSchool,193,16,177
2025-09-24,12,Primaria 1°,TopKids,266,18,248
2025-09-24,12,Primaria 1°,TopKids,91,8,83
2025-09-24,12,Primaria 1°,EduMax,226,3,223
2025-09-24,12,Primaria 1°,SuperSchool,176,5,171
2025-09-24,12,Primaria 1°,SuperSchool,133,12,121
2025-09-24,12,Primaria 1°,SuperSchool,247,23,224
2025-09-24,12,Primaria 1°,EduMax,187,1,186
2025-09-24,12,Primaria 1°,SuperSchool,195,3,192
2025-09-24,12,Primaria 1°,SuperSchool,123,3,120
2025-09-24,12,Primaria 1°,EduMax,195,7,188
2025-09-24,12,Primaria 2°,EduMax,59,13,46
2025-09-24,12,Primaria 2°,TopKids,232,16,216
2025-09-24,12,Primaria 2°,TopKids,116,8,108
2025-09-24,12,Primaria 2°,TopKids,95,2,93
2025-09-24,12,Primaria 2°,EduMax,244,24,220
2025-09-24,12,Primaria 2°,TopKids,228,8,220
2025-09-24,12,Primaria 2°,SuperSchool,175,9,166
2025-09-24,12,Primaria 2°,SuperSchool,252,2,250
2025-09-24,12,Primaria 2°,TopKids,192,1,191
2025-09-24,12,Primaria 2°,TopKids,298,10,288
2025-09-24,12,Primaria 2°,SuperSchool,244,14,230
2025-09-24,12,Primaria 3°,SuperSchool,255,21,234
2025-09-24,12,Primaria 3°,SuperSchool,146,4,142
2025-09-24,12,Primaria 3°,TopKids,232,23,209
2025-09-24,12,Primaria 3°,SuperSchool,103,1,102
2025-09-24,12,Primaria 3°,TopKids,100,21,79
2025-09-24,12,Primaria 3°,TopKids,213,9,204
2025-09-24,12,Primaria 3°,TopKids,106,14,92
2025-09-24,12,Primaria 3°,TopKids,171,3,168
2025-09-24,12,Primaria 3°,TopKids,156,10,146
2025-09-24,12,Primaria 4°,TopKids,138,17,121
2025-09-24,12,Primaria 4°,TopKids,80,11,69
2025-09-24,12,Primaria 4°,TopKids,193,4,189
2025-09-24,12,Primaria 4°,TopKids,188,20,168
2025-09-24,12,Primaria 4°,EduMax,105,17,88
2025-09-24,12,Primaria 4°,TopKids,267,10,257
2025-09-24,12,Primaria 4°,TopKids,55,13,42
2025-09-24,12,Primaria 4°,TopKids,185,7,178
2025-09-24,12,Primaria 5°,EduMax,172,21,151
2025-09-24,12,Primaria 5°,SuperSchool,124,21,103
2025-09-24,12,Primaria 5°,TopKids,95,7,88
2025-09-24,12,Primaria 5°,TopKids,281,21,260
2025-09-24,12,Primaria 5°,SuperSchool,55,11,44
2025-09-24,12,Primaria 5°,EduMax,142,22,120
2025-09-24,12,Primaria 5°,TopKids,188,23,165
2025-09-24,12,Primaria 5°,SuperSchool,189,1,188
2025-09-24,12,Primaria 5°,TopKids,242,6,236
2025-09-24,12,Primaria 6°,TopKids,158,16,142
2025-09-24,12,Primaria 6°,TopKids,191,6,185
2025-09-24,12,Primaria 6°,SuperSchool,123,21,102
2025-09-24,12,Primaria 6°,EduMax,235,13,222
2025-09-24,12,Primaria 6°,TopKids,94,2,92
2025-09-24,12,Primaria 6°,SuperSchool,232,1,231
2025-09-24,13,Preescolar,TopKids,190,17,173
2025-09-24,13,Preescolar,SuperSchool,190,16,174
2025-09-24,13,Preescolar,SuperSchool,231,7,224
2025-09-24,13,Preescolar,SuperSchool,153,6,147
2025-09-24,13,Preescolar,EduMax,210,15,195
2025-09-24,13,Preescolar,SuperSchool,229,3,226
2025-09-24,13,Preescolar,TopKids,271,6,265
2025-09-24,13,Preescolar,EduMax,158,8,150
2025-09-24,13,Preescolar,SuperSchool,56,24,32
2025-09-24,13,Preescolar,SuperSchool,217,1,216
2025-09-24,13,Preescolar,EduMax,245,1,244
2025-09-24,13,Preescolar,SuperSchool,134,10,124
2025-09-24,13,Preescolar,TopKids,275,7,268
2025-09-24,13,Preescolar,EduMax,74,6,68
2025-09-24,13,Preescolar,TopKids,102,19,83
2025-09-24,13,Preescolar,SuperSchool,210,8,202
2025-09-24,13,Preescolar,EduMax,209,23,186
2025-09-24,13,Preescolar,EduMax,136,14,122
2025-09-24,13,Kínder,TopKids,156,16,140
2025-09-24,13,Kínder,EduMax,299,18,281
2025-09-24,13,Kínder,TopKids,155,4,151
2025-09-24,13,Kínder,TopKids,81,13,68
2025-09-24,13,Kínder,EduMax,142,10,132
2025-09-24,13,Primaria 1°,EduMax,83,20,63
2025-09-24,13,Primaria 1°,TopKids,82,11,71
2025-09-24,13,Primaria 1°,SuperSchool,106,22,84
2025-09-24,13,Primaria 1°,EduMax,81,12,69
2025-09-24,13,Primaria 1°,TopKids,222,8,214
2025-09-24,13,Primaria 1°,EduMax,292,14,278
2025-09-24,13,Primaria 1°,TopKids,108,1,107
2025-09-24,13,Primaria 1°,SuperSchool,299,9,290
2025-09-24,13,Primaria 1°,TopKids,63,4,59
2025-09-24,13,Primaria 1°,EduMax,251,15,236
2025-09-24,13,Primaria 1°,TopKids,274,11,263
2025-09-24,13,Primaria 1°,SuperSchool,281,9,272
2025-09-24,13,Primaria 1°,TopKids,234,5,229
2025-09-24,13,Primaria 1°,SuperSchool,208,21,187
2025-09-24,13,Primaria 1°,EduMax,113,20,93
2025-09-24,13,Primaria 2°,EduMax,109,22,87
2025-09-24,13,Primaria 2°,SuperSchool,133,16,117
2025-09-24,13,Primaria 2°,EduMax,238,4,234
2025-09-24,13,Primaria 2°,EduMax,133,22,111
2025-09-24,13,Primaria 2°,TopKids,69,16,53
2025-09-24,13,Primaria 2°,SuperSchool,144,23,121
2025-09-24,13,Primaria 3°,SuperSchool,279,16,263
2025-09-24,13,Primaria 3°,TopKids,68,11,57
2025-09-24,13,Primaria 3°,SuperSchool,179,19,160
2025-09-24,13,Primaria 3°,TopKids,50,9,41
2025-09-24,13,Primaria 3°,EduMax,52,8,44
2025-09-24,13,Primaria 3°,TopKids,89,7,82
2025-09-24,13,Primaria 3°,TopKids,168,8,160
2025-09-24,13,Primaria 3°,EduMax,292,5,287
2025-09-24,13,Primaria 3°,TopKids,273,3,270
2025-09-24,13,Primaria 3°,TopKids,55,17,38
2025-09-24,13,Primaria 3°,EduMax,262,20,242
2025-09-24,13,Primaria 3°,TopKids,115,1,114
2025-09-24,13,Primaria 3°,SuperSchool,285,12,273
2025-09-24,13,Primaria 3°,TopKids,216,6,210
2025-09-24,13,Primaria 3°,SuperSchool,262,9,253
2025-09-24,13,Primaria 3°,EduMax,140,11,129
2025-09-24,13,Primaria 4°,TopKids,58,12,46
2025-09-24,13,Primaria 4°,SuperSchool,211,19,192
2025-09-24,13,Primaria 4°,EduMax,139,23,116
2025-09-24,13,Primaria 4°,EduMax,286,14,272
2025-09-24,13,Primaria 4°,SuperSchool,286,17,269
2025-09-24,13,Primaria 4°,EduMax,229,10,219
2025-09-24,13,Primaria 4°,TopKids,187,21,166
2025-09-24,13,Primaria 4°,EduMax,87,15,72
2025-09-24,13,Primaria 4°,TopKids,298,12,286
2025-09-24,13,Primaria 4°,SuperSchool,210,24,186
2025-09-24,13,Primaria 4°,TopKids,131,23,108
2025-09-24,13,Primaria 4°,TopKids,291,8,283
2025-09-24,13,Primaria 4°,EduMax,192,6,186
2025-09-24,13,Primaria 4°,TopKids,176,21,155
2025-09-24,13,Primaria 4°,TopKids,224,24,200
2025-09-24,13,Primaria 4°,TopKids,174,10,164
2025-09-24,13,Primaria 4°,SuperSchool,191,21,170
2025-09-24,13,Primaria 4°,EduMax,290,11,279
2025-09-24,13,Primaria 5°,SuperSchool,270,5,265
2025-09-24,13,Primaria 5°,EduMax,116,1,115
2025-09-24,13,Primaria 5°,EduMax,287,12,275
2025-09-24,13,Primaria 5°,TopKids,269,19,250
2025-09-24,13,Primaria 5°,TopKids,275,22,253
2025-09-24,13,Primaria 5°,TopKids,294,23,271
2025-09-24,13,Primaria 5°,TopKids,144,21,123
2025-09-24,13,Primaria 5°,SuperSchool,68,4,64
2025-09-24,13,Primaria 5°,EduMax,285,4,281
2025-09-24,13,Primaria 5°,SuperSchool,133,7,126
2025-09-24,13,Primaria 6°,SuperSchool,130,8,122
2025-09-24,13,Primaria 6°,SuperSchool,285,20,265
2025-09-24,13,Primaria 6°,TopKids,166,12,154
2025-09-24,13,Primaria 6°,EduMax,132,13,119
2025-09-24,13,Primaria 6°,EduMax,187,2,185
2025-09-24,13,Primaria 6°,TopKids,204,3,201
2025-09-24,13,Primaria 6°,SuperSchool,54,5,49
2025-09-24,13,Primaria 6°,TopKids,153,24,129
2025-09-24,13,Primaria 6°,TopKids,100,24,76
2025-09-24,13,Primaria 6°,EduMax,190,2,188
2025-09-24,14,Preescolar,EduMax,102,3,99
2025-09-24,14,Preescolar,EduMax,299,11,288
2025-09-24,14,Preescolar,TopKids,86,20,66
2025-09-24,14,Preescolar,EduMax,198,13,185
2025-09-24,14,Preescolar,SuperSchool,52,20,32
2025-09-24,14,Preescolar,EduMax,253,3,250
2025-09-24,14,Preescolar,TopKids,192,10,182
2025-09-24,14,Preescolar,SuperSchool,203,6,197
2025-09-24,14,Kínder,EduMax,179,17,162
2025-09-24,14,Kínder,TopKids,260,4,256
2025-09-24,14,Kínder,SuperSchool,143,5,138
2025-09-24,14,Kínder,SuperSchool,197,2,195
2025-09-24,14,Kínder,TopKids,285,17,268
2025-09-24,14,Kínder,EduMax,200,9,191
2025-09-24,14,Kínder,SuperSchool,76,17,59
2025-09-24,14,Kínder,SuperSchool,223,17,206
2025-09-24,14,Kínder,SuperSchool,179,15,164
2025-09-24,14,Kínder,TopKids,167,5,162
2025-09-24,14,Kínder,SuperSchool,122,14,108
2025-09-24,14,Kínder,TopKids,125,7,118
2025-09-24,14,Kínder,TopKids,203,3,200
2025-09-24,14,Kínder,EduMax,181,14,167
2025-09-24,14,Kínder,EduMax,180,13,167
2025-09-24,14,Kínder,EduMax,179,6,173
2025-09-24,14,Kínder,EduMax,80,7,73
2025-09-24,14,Kínder,TopKids,258,3,255
2025-09-24,14,Kínder,EduMax,223,24,199
2025-09-24,14,Primaria 1°,SuperSchool,139,12,127
2025-09-24,14,Primaria 1°,TopKids,100,12,88
2025-09-24,14,Primaria 1°,EduMax,82,5,77
2025-09-24,14,Primaria 1°,TopKids,293,19,274
2025-09-24,14,Primaria 1°,EduMax,279,21,258
2025-09-24,14,Primaria 2°,EduMax,124,3,121
2025-09-24,14,Primaria 2°,SuperSchool,276,6,270
2025-09-24,14,Primaria 2°,SuperSchool,57,2,55
2025-09-24,14,Primaria 2°,TopKids,265,16,249
2025-09-24,14,Primaria 2°,SuperSchool,59,20,39
2025-09-24,14,Primaria 2°,EduMax,189,12,177
2025-09-24,14,Primaria 3°,TopKids,55,14,41
2025-09-24,14,Primaria 3°,TopKids,294,1,293
2025-09-24,14,Primaria 3°,EduMax,256,13,243
2025-09-24,14,Primaria 3°,TopKids,73,1,72
2025-09-24,14,Primaria 3°,TopKids,132,6,126
2025-09-24,14,Primaria 3°,SuperSchool,199,22,177
2025-09-24,14,Primaria 3°,SuperSchool,144,15,129
2025-09-24,14,Primaria 3°,TopKids,194,12,182
2025-09-24,14,Primaria 3°,EduMax,240,7,233
2025-09-24,14,Primaria 3°,SuperSchool,286,8,278
2025-09-24,14,Primaria 3°,EduMax,65,16,49
2025-09-24,14,Primaria 3°,EduMax,124,9,115
2025-09-24,14,Primaria 3°,EduMax,109,11,98
2025-09-24,14,Primaria 3°,SuperSchool,283,6,277
2025-09-24,14,Primaria 3°,SuperSchool,107,13,94
2025-09-24,14,Primaria 3°,SuperSchool,97,11,86
2025-09-24,14,Primaria 3°,TopKids,254,1,253
2025-09-24,14,Primaria 4°,TopKids,181,2,179
2025-09-24,14,Primaria 4°,TopKids,228,10,218
2025-09-24,14,Primaria 4°,SuperSchool,296,20,276
2025-09-24,14,Primaria 4°,SuperSchool,67,2,65
2025-09-24,14,Primaria 4°,EduMax,217,2,215
2025-09-24,14,Primaria 4°,EduMax,129,5,124
2025-09-24,14,Primaria 4°,EduMax,154,2,152
2025-09-24,14,Primaria 4°,SuperSchool,147,5,142
2025-09-24,14,Primaria 5°,EduMax,157,13,144
2025-09-24,14,Primaria 5°,SuperSchool,189,15,174
2025-09-24,14,Primaria 5°,EduMax,272,2,270
2025-09-24,14,Primaria 5°,TopKids,123,8,115
2025-09-24,14,Primaria 5°,SuperSchool,252,12,240
2025-09-24,14,Primaria 5°,SuperSchool,152,15,137
2025-09-24,14,Primaria 5°,TopKids,147,6,141
2025-09-24,14,Primaria 5°,EduMax,159,8,151
2025-09-24,14,Primaria 5°,TopKids,227,24,203
2025-09-24,14,Primaria 5°,SuperSchool,158,6,152
2025-09-24,14,Primaria 5°,SuperSchool,213,21,192
2025-09-24,14,Primaria 5°,EduMax,224,23,201
2025-09-24,14,Primaria 5°,EduMax,56,6,50
2025-09-24,14,Primaria 5°,SuperSchool,68,14,54
2025-09-24,14,Primaria 5°,SuperSchool,201,11,190
2025-09-24,14,Primaria 5°,EduMax,72,22,50
2025-09-24,14,Primaria 5°,SuperSchool,159,21,138
2025-09-24,14,Primaria 5°,EduMax,151,5,146
2025-09-24,14,Primaria 5°,SuperSchool,202,7,195
2025-09-24,14,Primaria 6°,TopKids,255,2,253
2025-09-24,14,Primaria 6°,EduMax,81,17,64
2025-09-24,14,Primaria 6°,EduMax,96,7,89
2025-09-24,14,Primaria 6°,TopKids,72,6,66
2025-09-24,14,Primaria 6°,SuperSchool,267,9,258
2025-09-24,14,Primaria 6°,EduMax,294,21,273
2025-09-24,14,Primaria 6°,TopKids,274,10,264
2025-09-24,14,Primaria 6°,EduMax,161,4,157
2025-09-24,14,Primaria 6°,SuperSchool,296,18,278
2025-09-24,14,Primaria 6°,TopKids,285,8,277
2025-09-24,14,Primaria 6°,SuperSchool,249,5,244
2025-09-24,14,Primaria 6°,SuperSchool,244,13,231
2025-09-24,14,Primaria 6°,SuperSchool,174,16,158
2025-09-24,14,Primaria 6°,TopKids,221,7,214
2025-09-24,14,Primaria 6°,TopKids,158,11,147
2025-09-24,14,Primaria 6°,EduMax,80,23,57
2025-09-24,14,Primaria 6°,EduMax,196,21,175
2025-09-24,14,Primaria 6°,EduMax,66,18,48
2025-09-24,15,Preescolar,EduMax,61,15,46
2025-09-24,15,Preescolar,TopKids,62,10,52
2025-09-24,15,Preescolar,TopKids,250,12,238
2025-09-24,15,Preescolar,TopKids,233,8,225
2025-09-24,15,Preescolar,SuperSchool,181,20,161
2025-09-24,15,Preescolar,TopKids,150,7,143
2025-09-24,15,Preescolar,SuperSchool,117,23,94
2025-09-24,15,Kínder,EduMax,222,9,213
2025-09-24,15,Kínder,SuperSchool,58,21,37
2025-09-24,15,Kínder,TopKids,126,6,120
2025-09-24,15,Kínder,EduMax,168,14,154
2025-09-24,15,Kínder,TopKids,142,23,119
2025-09-24,15,Kínder,EduMax,208,6,202
2025-09-24,15,Kínder,TopKids,153,10,143
2025-09-24,15,Kínder,SuperSchool,236,1,235
2025-09-24,15,Kínder,SuperSchool,202,2,200
2025-09-24,15,Kínder,SuperSchool,105,15,90
2025-09-24,15,Kínder,EduMax,241,17,224
2025-09-24,15,Kínder,EduMax,120,22,98
2025-09-24,15,Kínder,EduMax,296,3,293
2025-09-24,15,Kínder,EduMax,161,16,145
2025-09-24,15,Kínder,TopKids,135,3,132
2025-09-24,15,Kínder,SuperSchool,171,17,154
2025-09-24,15,Primaria 1°,TopKids,106,8,98
2025-09-24,15,Primaria 1°,TopKids,248,1,247
2025-09-24,15,Primaria 1°,EduMax,298,8,290
2025-09-24,15,Primaria 1°,TopKids,152,10,142
2025-09-24,15,Primaria 1°,EduMax,224,14,210
2025-09-24,15,Primaria 1°,EduMax,216,23,193
2025-09-24,15,Primaria 1°,EduMax,75,12,63
2025-09-24,15,Primaria 1°,SuperSchool,87,16,71
2025-09-24,15,Primaria 1°,SuperSchool,293,12,281
2025-09-24,15,Primaria 1°,EduMax,66,24,42
2025-09-24,15,Primaria 2°,EduMax,213,3,210
2025-09-24,15,Primaria 2°,TopKids,119,23,96
2025-09-24,15,Primaria 2°,TopKids,160,12,148
2025-09-24,15,Primaria 2°,TopKids,58,2,56
2025-09-24,15,Primaria 2°,EduMax,293,15,278
2025-09-24,15,Primaria 2°,EduMax,113,13,100
2025-09-24,15,Primaria 2°,TopKids,124,3,121
2025-09-24,15,Primaria 2°,SuperSchool,91,17,74
2025-09-24,15,Primaria 2°,EduMax,57,5,52
2025-09-24,15,Primaria 2°,SuperSchool,57,15,42
2025-09-24,15,Primaria 2°,TopKids,177,11,166
2025-09-24,15,Primaria 2°,SuperSchool,170,2,168
2025-09-24,15,Primaria 2°,TopKids,193,7,186
2025-09-24,15,Primaria 2°,SuperSchool,223,22,201
2025-09-24,15,Primaria 2°,TopKids,62,18,44
2025-09-24,15,Primaria 3°,EduMax,62,2,60
2025-09-24,15,Primaria 3°,SuperSchool,175,15,160
2025-09-24,15,Primaria 3°,SuperSchool,295,11,284
2025-09-24,15,Primaria 3°,TopKids,151,19,132
2025-09-24,15,Primaria 3°,TopKids,53,7,46
2025-09-24,15,Primaria 3°,TopKids,80,22,58
2025-09-24,15,Primaria 3°,SuperSchool,251,22,229
2025-09-24,15,Primaria 3°,EduMax,206,17,189
2025-09-24,15,Primaria 3°,TopKids,134,22,112
2025-09-24,15,Primaria 3°,TopKids,153,16,137
2025-09-24,15,Primaria 3°,SuperSchool,199,23,176
2025-09-24,15,Primaria 3°,TopKids,53,7,46
2025-09-24,15,Primaria 3°,EduMax,258,3,255
2025-09-24,15,Primaria 3°,SuperSchool,284,8,276
2025-09-24,15,Primaria 4°,TopKids,131,21,110
2025-09-24,15,Primaria 4°,TopKids,100,3,97
2025-09-24,15,Primaria 4°,EduMax,129,15,114
2025-09-24,15,Primaria 4°,SuperSchool,223,24,199
2025-09-24,15,Primaria 4°,EduMax,236,4,232
2025-09-24,15,Primaria 4°,SuperSchool,289,12,277
2025-09-24,15,Primaria 4°,TopKids,86,22,64
2025-09-24,15,Primaria 5°,SuperSchool,189,8,181
2025-09-24,15,Primaria 5°,SuperSchool,212,22,190
2025-09-24,15,Primaria 5°,SuperSchool,277,21,256
2025-09-24,15,Primaria 5°,TopKids,204,4,200
2025-09-24,15,Primaria 5°,TopKids,52,4,48
2025-09-24,15,Primaria 5°,SuperSchool,254,9,245
2025-09-24,15,Primaria 5°,EduMax,261,5,256
2025-09-24,15,Primaria 5°,EduMax,118,3,115
2025-09-24,15,Primaria 5°,SuperSchool,283,15,268
2025-09-24,15,Primaria 5°,SuperSchool,125,14,111
2025-09-24,15,Primaria 5°,SuperSchool,220,15,205
2025-09-24,15,Primaria 5°,EduMax,140,18,122
2025-09-24,15,Primaria 5°,EduMax,186,15,171
2025-09-24,15,Primaria 6°,TopKids,229,13,216
2025-09-24,15,Primaria 6°,EduMax,160,14,146
2025-09-24,15,Primaria 6°,TopKids,78,4,74
2025-09-24,15,Primaria 6°,EduMax,198,19,179
2025-09-24,15,Primaria 6°,SuperSchool,176,6,170
2025-09-24,15,Primaria 6°,EduMax,194,9,185
2025-09-24,15,Primaria 6°,EduMax,238,20,218
2025-09-24,15,Primaria 6°,SuperSchool,299,3,296
2025-09-24,15,Primaria 6°,SuperSchool,206,12,194
2025-09-24,16,Preescolar,TopKids,272,1,271
2025-09-24,16,Preescolar,SuperSchool,92,5,87
2025-09-24,16,Preescolar,TopKids,149,12,137
2025-09-24,16,Preescolar,SuperSchool,210,3,207
2025-09-24,16,Preescolar,TopKids,138,22,116
2025-09-24,16,Preescolar,TopKids,293,17,276
2025-09-24,16,Preescolar,EduMax,213,3,210
2025-09-24,16,Preescolar,TopKids,210,5,205
2025-09-24,16,Preescolar,EduMax,229,8,221
2025-09-24,16,Preescolar,TopKids,156,18,138
2025-09-24,16,Kínder,EduMax,172,13,159
2025-09-24,16,Kínder,TopKids,226,18,208
2025-09-24,16,Kínder,EduMax,171,3,168
2025-09-24,16,Kínder,SuperSchool,275,23,252
2025-09-24,16,Kínder,EduMax,235,6,229
2025-09-24,16,Kínder,EduMax,98,14,84
2025-09-24,16,Kínder,SuperSchool,258,21,237
2025-09-24,16,Kínder,SuperSchool,145,9,136
2025-09-24,16,Kínder,EduMax,112,19,93
2025-09-24,16,Kínder,EduMax,212,16,196
2025-09-24,16,Kínder,SuperSchool,292,18,274
2025-09-24,16,Kínder,TopKids,283,23,260
2025-09-24,16,Kínder,SuperSchool,146,5,141
2025-09-24,16,Kínder,TopKids,297,24,273
2025-09-24,16,Kínder,TopKids,68,21,47
2025-09-24,16,Primaria 1°,TopKids,249,9,240
2025-09-24,16,Primaria 1°,TopKids,109,18,91
2025-09-24,16,Primaria 1°,EduMax,259,5,254
2025-09-24,16,Primaria 1°,EduMax,173,1,172
2025-09-24,16,Primaria 1°,EduMax,184,5,179
2025-09-24,16,Primaria 1°,TopKids,185,6,179
2025-09-24,16,Primaria 1°,SuperSchool,234,12,222
2025-09-24,16,Primaria 1°,SuperSchool,174,5,169
2025-09-24,16,Primaria 1°,TopKids,66,5,61
2025-09-24,16,Primaria 1°,TopKids,283,3,280
2025-09-24,16,Primaria 1°,TopKids,203,8,195
2025-09-24,16,Primaria 2°,SuperSchool,183,3,180
2025-09-24,16,Primaria 2°,TopKids,280,2,278
2025-09-24,16,Primaria 2°,EduMax,265,19,246
2025-09-24,16,Primaria 2°,SuperSchool,106,11,95
2025-09-24,16,Primaria 2°,SuperSchool,132,19,113
2025-09-24,16,Primaria 2°,SuperSchool,273,14,259
2025-09-24,16,Primaria 2°,SuperSchool,146,1,145
2025-09-24,16,Primaria 2°,SuperSchool,176,4,172
2025-09-24,16,Primaria 2°,SuperSchool,264,11,253
2025-09-24,16,Primaria 2°,EduMax,61,19,42
2025-09-24,16,Primaria 2°,SuperSchool,67,2,65
2025-09-24,16,Primaria 2°,EduMax,156,15,141
2025-09-24,16,Primaria 2°,TopKids,183,4,179
2025-09-24,16,Primaria 3°,TopKids,205,11,194
2025-09-24,16,Primaria 3°,EduMax,97,2,95
2025-09-24,16,Primaria 3°,SuperSchool,277,2,275
2025-09-24,16,Primaria 3°,SuperSchool,282,13,269
2025-09-24,16,Primaria 3°,EduMax,260,8,252
2025-09-24,16,Primaria 3°,SuperSchool,156,8,148
2025-09-24,16,Primaria 3°,EduMax,136,20,116
2025-09-24,16,Primaria 3°,SuperSchool,203,15,188
2025-09-24,16,Primaria 3°,TopKids,82,14,68
2025-09-24,16,Primaria 3°,TopKids,257,21,236
2025-09-24,16,Primaria 3°,TopKids,227,19,208
2025-09-24,16,Primaria 3°,EduMax,237,23,214
2025-09-24,16,Primaria 3°,EduMax,250,13,237
2025-09-24,16,Primaria 3°,EduMax,221,15,206
2025-09-24,16,Primaria 3°,TopKids,152,12,140
2025-09-24,16,Primaria 3°,SuperSchool,222,23,199
2025-09-24,16,Primaria 4°,SuperSchool,110,8,102
2025-09-24,16,Primaria 4°,EduMax,211,17,194
2025-09-24,16,Primaria 4°,SuperSchool,61,13,48
2025-09-24,16,Primaria 4°,TopKids,156,24,132
2025-09-24,16,Primaria 4°,SuperSchool,281,20,261
2025-09-24,16,Primaria 4°,SuperSchool,160,24,136
2025-09-24,16,Primaria 4°,SuperSchool,267,14,253
2025-09-24,16,Primaria 4°,SuperSchool,175,16,159
2025-09-24,16,Primaria 4°,SuperSchool,142,8,134
2025-09-24,16,Primaria 4°,SuperSchool,295,11,284
2025-09-24,16,Primaria 4°,EduMax,131,2,129
2025-09-24,16,Primaria 4°,SuperSchool,167,9,158
2025-09-24,16,Primaria 4°,SuperSchool,73,2,71
2025-09-24,16,Primaria 4°,TopKids,151,2,149
2025-09-24,16,Primaria 4°,EduMax,54,13,41
2025-09-24,16,Primaria 4°,TopKids,168,4,164
2025-09-24,16,Primaria 4°,EduMax,232,10,222
2025-09-24,16,Primaria 5°,EduMax,101,2,99
2025-09-24,16,Primaria 5°,EduMax,181,24,157
2025-09-24,16,Primaria 5°,TopKids,263,9,254
2025-09-24,16,Primaria 5°,EduMax,238,23,215
2025-09-24,16,Primaria 5°,EduMax,162,2,160
2025-09-24,16,Primaria 5°,EduMax,172,24,148
2025-09-24,16,Primaria 5°,SuperSchool,79,7,72
2025-09-24,16,Primaria 5°,EduMax,272,11,261
2025-09-24,16,Primaria 5°,SuperSchool,213,16,197
2025-09-24,16,Primaria 6°,SuperSchool,125,10,115
2025-09-24,16,Primaria 6°,EduMax,197,20,177
2025-09-24,16,Primaria 6°,TopKids,149,20,129
2025-09-24,16,Primaria 6°,SuperSchool,218,14,204
2025-09-24,16,Primaria 6°,TopKids,118,9,109
2025-09-24,16,Primaria 6°,TopKids,51,12,39
2025-09-24,16,Primaria 6°,SuperSchool,134,11,123
2025-09-25,9,Preescolar,SuperSchool,61,9,52
2025-09-25,9,Preescolar,TopKids,68,8,60
2025-09-25,9,Preescolar,TopKids,298,7,291
2025-09-25,9,Preescolar,SuperSchool,170,14,156
2025-09-25,9,Preescolar,SuperSchool,201,24,177
2025-09-25,9,Preescolar,EduMax,179,20,159
2025-09-25,9,Preescolar,TopKids,61,1,60
2025-09-25,9,Preescolar,EduMax,262,10,252
2025-09-25,9,Preescolar,SuperSchool,199,10,189
2025-09-25,9,Preescolar,SuperSchool,255,10,245
2025-09-25,9,Preescolar,SuperSchool,273,6,267
2025-09-25,9,Kínder,TopKids,286,15,271
2025-09-25,9,Kínder,SuperSchool,129,24,105
2025-09-25,9,Kínder,TopKids,157,2,155
2025-09-25,9,Kínder,SuperSchool,135,3,132
2025-09-25,9,Kínder,SuperSchool,175,14,161
2025-09-25,9,Kínder,TopKids,152,20,132
2025-09-25,9,Kínder,EduMax,144,9,135
2025-09-25,9,Kínder,TopKids,270,10,260
2025-09-25,9,Kínder,EduMax,92,11,81
2025-09-25,9,Kínder,TopKids,132,13,119
2025-09-25,9,Kínder,EduMax,193,10,183
2025-09-25,9,Kínder,TopKids,123,12,111
2025-09-25,9,Kínder,SuperSchool,205,18,187
2025-09-25,9,Kínder,TopKids,280,14,266
2025-09-25,9,Kínder,EduMax,149,3,146
2025-09-25,9,Kínder,EduMax,186,15,171
2025-09-25,9,Primaria 1°,SuperSchool,135,24,111
2025-09-25,9,Primaria 1°,TopKids,62,6,56
2025-09-25,9,Primaria 1°,EduMax,228,11,217
2025-09-25,9,Primaria 1°,SuperSchool,65,22,43
2025-09-25,9,Primaria 1°,SuperSchool,104,14,90
2025-09-25,9,Primaria 1°,TopKids,237,9,228
2025-09-25,9,Primaria 1°,SuperSchool,55,6,49
2025-09-25,9,Primaria 1°,SuperSchool,195,24,171
2025-09-25,9,Primaria 1°,TopKids,66,4,62
2025-09-25,9,Primaria 1°,SuperSchool,132,23,109
2025-09-25,9,Primaria 1°,TopKids,166,11,155
2025-09-25,9,Primaria 1°,EduMax,166,22,144
2025-09-25,9,Primaria 1°,TopKids,220,22,198
2025-09-25,9,Primaria 1°,SuperSchool,260,8,252
2025-09-25,9,Primaria 1°,TopKids,200,16,184
2025-09-25,9,Primaria 1°,SuperSchool,102,23,79
2025-09-25,9,Primaria 1°,SuperSchool,201,12,189
2025-09-25,9,Primaria 1°,EduMax,119,4,115
2025-09-25,9,Primaria 1°,SuperSchool,254,4,250
2025-09-25,9,Primaria 2°,TopKids,215,18,197
2025-09-25,9,Primaria 2°,TopKids,97,1,96
2025-09-25,9,Primaria 2°,EduMax,207,4,203
2025-09-25,9,Primaria 2°,TopKids,74,4,70
2025-09-25,9,Primaria 2°,EduMax,222,24,198
2025-09-25,9,Primaria 2°,EduMax,146,20,126
2025-09-25,9,Primaria 2°,EduMax,262,1,261
2025-09-25,9,Primaria 2°,EduMax,122,1,121
2025-09-25,9,Primaria 2°,TopKids,76,15,61
2025-09-25,9,Primaria 2°,TopKids,202,2,200
2025-09-25,9,Primaria 2°,EduMax,232,10,222
2025-09-25,9,Primaria 2°,EduMax,158,9,149
2025-09-25,9,Primaria 2°,EduMax,138,3,135
2025-09-25,9,Primaria 3°,EduMax,153,14,139
2025-09-25,9,Primaria 3°,TopKids,139,16,123
2025-09-25,9,Primaria 3°,EduMax,154,21,133
2025-09-25,9,Primaria 3°,TopKids,132,24,108
2025-09-25,9,Primaria 3°,TopKids,272,24,248
2025-09-25,9,Primaria 3°,TopKids,102,10,92
2025-09-25,9,Primaria 3°,TopKids,196,4,192
2025-09-25,9,Primaria 3°,SuperSchool,222,9,213
2025-09-25,9,Primaria 3°,SuperSchool,103,20,83
2025-09-25,9,Primaria 3°,EduMax,158,9,149
2025-09-25,9,Primaria 3°,TopKids,289,18,271
2025-09-25,9,Primaria 4°,SuperSchool,93,11,82
2025-09-25,9,Primaria 4°,SuperSchool,183,15,168
2025-09-25,9,Primaria 4°,EduMax,223,3,220
2025-09-25,9,Primaria 4°,SuperSchool,189,6,183
2025-09-25,9,Primaria 4°,TopKids,214,7,207
2025-09-25,9,Primaria 4°,EduMax,102,19,83
2025-09-25,9,Primaria 4°,EduMax,291,21,270
2025-09-25,9,Primaria 5°,EduMax,102,19,83
2025-09-25,9,Primaria 5°,EduMax,176,3,173
2025-09-25,9,Primaria 5°,TopKids,134,16,118
2025-09-25,9,Primaria 5°,SuperSchool,288,14,274
2025-09-25,9,Primaria 5°,TopKids,233,7,226
2025-09-25,9,Primaria 5°,SuperSchool,218,16,202
2025-09-25,9,Primaria 5°,EduMax,71,23,48
2025-09-25,9,Primaria 5°,TopKids,285,16,269
2025-09-25,9,Primaria 5°,EduMax,130,17,113
2025-09-25,9,Primaria 5°,TopKids,289,23,266
2025-09-25,9,Primaria 5°,TopKids,150,7,143
2025-09-25,9,Primaria 5°,SuperSchool,154,8,146
2025-09-25,9,Primaria 5°,SuperSchool,175,4,171
2025-09-25,9,Primaria 5°,SuperSchool,120,11,109
2025-09-25,9,Primaria 5°,EduMax,220,7,213
2025-09-25,9,Primaria 5°,TopKids,163,22,141
2025-09-25,9,Primaria 5°,EduMax,56,10,46
2025-09-25,9,Primaria 5°,SuperSchool,151,17,134
2025-09-25,9,Primaria 6°,EduMax,274,6,268
2025-09-25,9,Primaria 6°,EduMax,152,1,151
2025-09-25,9,Primaria 6°,SuperSchool,230,21,209
2025-09-25,9,Primaria 6°,SuperSchool,184,14,170
2025-09-25,9,Primaria 6°,TopKids,263,13,250
2025-09-25,9,Primaria 6°,TopKids,237,22,215
2025-09-25,9,Primaria 6°,EduMax,67,21,46
2025-09-25,10,Preescolar,EduMax,102,19,83
2025-09-25,10,Preescolar,EduMax,74,1,73
2025-09-25,10,Preescolar,TopKids,171,16,155
2025-09-25,10,Preescolar,SuperSchool,162,21,141
2025-09-25,10,Preescolar,TopKids,169,13,156
2025-09-25,10,Preescolar,EduMax,240,22,218
2025-09-25,10,Preescolar,SuperSchool,257,13,244
2025-09-25,10,Preescolar,EduMax,227,9,218
2025-09-25,10,Preescolar,TopKids,178,2,176
2025-09-25,10,Preescolar,TopKids,190,6,184
2025-09-25,10,Preescolar,TopKids,100,2,98
2025-09-25,10,Kínder,EduMax,246,23,223
2025-09-25,10,Kínder,EduMax,79,1,78
2025-09-25,10,Kínder,SuperSchool,93,10,83
2025-09-25,10,Kínder,TopKids,160,5,155
2025-09-25,10,Kínder,TopKids,164,21,143
2025-09-25,10,Kínder,SuperSchool,62,8,54
2025-09-25,10,Kínder,EduMax,153,24,129
2025-09-25,10,Kínder,EduMax,154,14,140
2025-09-25,10,Kínder,SuperSchool,65,14,51
2025-09-25,10,Kínder,EduMax,104,17,87
2025-09-25,10,Kínder,TopKids,129,20,109
2025-09-25,10,Kínder,SuperSchool,241,16,225
2025-09-25,10,Kínder,EduMax,131,6,125
2025-09-25,10,Kínder,SuperSchool,90,22,68
2025-09-25,10,Kínder,TopKids,139,8,131
2025-09-25,10,Kínder,EduMax,275,3,272
2025-09-25,10,Kínder,TopKids,169,11,158
2025-09-25,10,Kínder,SuperSchool,79,13,66
2025-09-25,10,Kínder,EduMax,124,14,110
2025-09-25,10,Primaria 1°,TopKids,277,10,267
2025-09-25,10,Primaria 1°,EduMax,83,18,65
2025-09-25,10,Primaria 1°,TopKids,86,17,69
2025-09-25,10,Primaria 1°,EduMax,84,7,77
2025-09-25,10,Primaria 1°,SuperSchool,134,2,132
2025-09-25,10,Primaria 1°,EduMax,57,16,41
2025-09-25,10,Primaria 1°,TopKids,72,22,50
2025-09-25,10,Primaria 1°,TopKids,142,6,136
2025-09-25,10,Primaria 2°,EduMax,94,4,90
2025-09-25,10,Primaria 2°,SuperSchool,237,24,213
2025-09-25,10,Primaria 2°,SuperSchool,113,3,110
2025-09-25,10,Primaria 2°,TopKids,50,1,49
2025-09-25,10,Primaria 2°,SuperSchool,298,13,285
2025-09-25,10,Primaria 2°,SuperSchool,196,10,186
2025-09-25,10,Primaria 2°,SuperSchool,183,21,162
2025-09-25,10,Primaria 3°,EduMax,102,7,95
2025-09-25,10,Primaria 3°,TopKids,54,22,32
2025-09-25,10,Primaria 3°,TopKids,163,7,156
2025-09-25,10,Primaria 3°,SuperSchool,75,5,70
2025-09-25,10,Primaria 3°,SuperSchool,103,20,83
2025-09-25,10,Primaria 4°,TopKids,221,9,212
2025-09-25,10,Primaria 4°,EduMax,188,16,172
2025-09-25,10,Primaria 4°,SuperSchool,176,11,165
2025-09-25,10,Primaria 4°,EduMax,185,14,171
2025-09-25,10,Primaria 4°,EduMax,272,4,268
2025-09-25,10,Primaria 4°,TopKids,195,11,184
2025-09-25,10,Primaria 4°,TopKids,196,18,178
2025-09-25,10,Primaria 4°,SuperSchool,74,22,52
2025-09-25,10,Primaria 5°,TopKids,239,5,234
2025-09-25,10,Primaria 5°,EduMax,130,20,110
2025-09-25,10,Primaria 5°,SuperSchool,117,14,103
2025-09-25,10,Primaria 5°,SuperSchool,192,3,189
2025-09-25,10,Primaria 5°,SuperSchool,256,1,255
2025-09-25,10,Primaria 5°,SuperSchool,57,9,48
2025-09-25,10,Primaria 5°,EduMax,139,2,137
2025-09-25,10,Primaria 5°,SuperSchool,277,12,265
2025-09-25,10,Primaria 5°,TopKids,76,24,52
2025-09-25,10,Primaria 5°,EduMax,65,2,63
2025-09-25,10,Primaria 5°,SuperSchool,59,10,49
2025-09-25,10,Primaria 5°,SuperSchool,253,7,246
2025-09-25,10,Primaria 5°,SuperSchool,95,18,77
2025-09-25,10,Primaria 5°,TopKids,59,16,43
2025-09-25,10,Primaria 5°,SuperSchool,186,13,173
2025-09-25,10,Primaria 5°,SuperSchool,225,16,209
2025-09-25,10,Primaria 6°,SuperSchool,79,13,66
2025-09-25,10,Primaria 6°,TopKids,60,17,43
2025-09-25,10,Primaria 6°,TopKids,284,11,273
2025-09-25,10,Primaria 6°,TopKids,231,1,230
2025-09-25,10,Primaria 6°,TopKids,81,15,66
2025-09-25,10,Primaria 6°,EduMax,141,14,127
2025-09-25,11,Preescolar,EduMax,197,22,175
2025-09-25,11,Preescolar,TopKids,292,22,270
2025-09-25,11,Preescolar,EduMax,87,17,70
2025-09-25,11,Preescolar,EduMax,178,20,158
2025-09-25,11,Preescolar,SuperSchool,210,13,197
2025-09-25,11,Preescolar,SuperSchool,221,9,212
2025-09-25,11,Preescolar,EduMax,174,13,161
2025-09-25,11,Preescolar,EduMax,225,6,219
2025-09-25,11,Preescolar,SuperSchool,167,8,159
2025-09-25,11,Preescolar,TopKids,152,13,139
2025-09-25,11,Preescolar,SuperSchool,66,12,54
2025-09-25,11,Preescolar,TopKids,188,6,182
2025-09-25,11,Preescolar,TopKids,86,16,70
2025-09-25,11,Preescolar,TopKids,155,8,147
2025-09-25,11,Preescolar,SuperSchool,251,10,241
2025-09-25,11,Preescolar,SuperSchool,286,20,266
2025-09-25,11,Preescolar,TopKids,195,23,172
2025-09-25,11,Kínder,EduMax,167,21,146
2025-09-25,11,Kínder,EduMax,152,20,132
2025-09-25,11,Kínder,SuperSchool,97,1,96
2025-09-25,11,Kínder,SuperSchool,152,12,140
2025-09-25,11,Kínder,TopKids,170,23,147
2025-09-25,11,Kínder,TopKids,115,18,97
2025-09-25,11,Kínder,SuperSchool,222,23,199
2025-09-25,11,Kínder,SuperSchool,149,9,140
2025-09-25,11,Kínder,TopKids,169,1,168
2025-09-25,11,Primaria 1°,SuperSchool,206,16,190
2025-09-25,11,Primaria 1°,TopKids,64,5,59
2025-09-25,11,Primaria 1°,TopKids,297,11,286
2025-09-25,11,Primaria 1°,TopKids,228,24,204
2025-09-25,11,Primaria 1°,SuperSchool,297,3,294
2025-09-25,11,Primaria 1°,EduMax,167,22,145
2025-09-25,11,Primaria 1°,SuperSchool,129,12,117
2025-09-25,11,Primaria 1°,TopKids,82,24,58
2025-09-25,11,Primaria 1°,TopKids,128,19,109
2025-09-25,11,Primaria 1°,TopKids,128,9,119
2025-09-25,11,Primaria 1°,SuperSchool,99,23,76
2025-09-25,11,Primaria 1°,SuperSchool,182,16,166
2025-09-25,11,Primaria 1°,TopKids,143,21,122
2025-09-25,11,Primaria 2°,EduMax,235,11,224
2025-09-25,11,Primaria 2°,EduMax,271,22,249
2025-09-25,11,Primaria 2°,EduMax,158,2,156
2025-09-25,11,Primaria 2°,EduMax,268,13,255
2025-09-25,11,Primaria 2°,SuperSchool,196,17,179
2025-09-25,11,Primaria 2°,TopKids,289,17,272
2025-09-25,11,Primaria 2°,SuperSchool,183,23,160
2025-09-25,11,Primaria 2°,EduMax,92,12,80
2025-09-25,11,Primaria 2°,SuperSchool,115,13,102
2025-09-25,11,Primaria 3°,TopKids,297,4,293
2025-09-25,11,Primaria 3°,SuperSchool,147,18,129
2025-09-25,11,Primaria 3°,SuperSchool,150,16,134
2025-09-25,11,Primaria 3°,TopKids,67,8,59
2025-09-25,11,Primaria 3°,EduMax,266,2,264
2025-09-25,11,Primaria 3°,SuperSchool,265,24,241
2025-09-25,11,Primaria 3°,SuperSchool,163,10,153
2025-09-25,11,Primaria 4°,EduMax,239,4,235
2025-09-25,11,Primaria 4°,EduMax,163,3,160
2025-09-25,11,Primaria 4°,TopKids,234,12,222
2025-09-25,11,Primaria 4°,TopKids,98,23,75
2025-09-25,11,Primaria 4°,SuperSchool,199,4,195
2025-09-25,11,Primaria 4°,TopKids,200,7,193
2025-09-25,11,Primaria 4°,EduMax,71,7,64
2025-09-25,11,Primaria 4°,TopKids,102,9,93
2025-09-25,11,Primaria 4°,EduMax,110,9,101
2025-09-25,11,Primaria 5°,EduMax,78,21,57
2025-09-25,11,Primaria 5°,EduMax,208,9,199
2025-09-25,11,Primaria 5°,EduMax,86,8,78
2025-09-25,11,Primaria 5°,EduMax,66,21,45
2025-09-25,11,Primaria 5°,TopKids,97,9,88
2025-09-25,11,Primaria 5°,SuperSchool,54,6,48
2025-09-25,11,Primaria 5°,EduMax,249,16,233
2025-09-25,11,Primaria 5°,EduMax,146,16,130
2025-09-25,11,Primaria 5°,TopKids,150,9,141
2025-09-25,11,Primaria 5°,TopKids,180,7,173
2025-09-25,11,Primaria 5°,TopKids,65,3,62
2025-09-25,11,Primaria 5°,TopKids,56,3,53
2025-09-25,11,Primaria 5°,TopKids,215,8,207
2025-09-25,11,Primaria 5°,EduMax,257,2,255
2025-09-25,11,Primaria 5°,SuperSchool,196,14,182
2025-09-25,11,Primaria 5°,TopKids,136,4,132
2025-09-25,11,Primaria 5°,EduMax,179,12,167
2025-09-25,11,Primaria 5°,TopKids,233,11,222
2025-09-25,11,Primaria 6°,EduMax,273,19,254
2025-09-25,11,Primaria 6°,SuperSchool,208,4,204
2025-09-25,11,Primaria 6°,TopKids,267,12,255
2025-09-25,11,Primaria 6°,SuperSchool,212,16,196
2025-09-25,11,Primaria 6°,EduMax,82,5,77
2025-09-25,11,Primaria 6°,EduMax,208,14,194
2025-09-25,11,Primaria 6°,SuperSchool,59,9,50
2025-09-25,11,Primaria 6°,SuperSchool,66,19,47
2025-09-25,11,Primaria 6°,SuperSchool,261,1,260
2025-09-25,12,Preescolar,EduMax,208,5,203
2025-09-25,12,Preescolar,EduMax,270,19,251
2025-09-25,12,Preescolar,TopKids,181,4,177
2025-09-25,12,Preescolar,TopKids,67,18,49
2025-09-25,12,Preescolar,EduMax,97,14,83
2025-09-25,12,Preescolar,EduMax,136,1,135
2025-09-25,12,Preescolar,SuperSchool,219,16,203
2025-09-25,12,Preescolar,TopKids,164,11,153
2025-09-25,12,Preescolar,SuperSchool,271,15,256
2025-09-25,12,Preescolar,EduMax,165,19,146
2025-09-25,12,Preescolar,TopKids,112,6,106
2025-09-25,12,Preescolar,SuperSchool,190,8,182
2025-09-25,12,Preescolar,EduMax,212,1,211
2025-09-25,12,Kínder,SuperSchool,163,4,159
2025-09-25,12,Kínder,EduMax,257,18,239
2025-09-25,12,Kínder,TopKids,244,14,230
2025-09-25,12,Kínder,EduMax,214,8,206
2025-09-25,12,Kínder,EduMax,131,5,126
2025-09-25,12,Kínder,TopKids,93,4,89
2025-09-25,12,Kínder,SuperSchool,191,14,177
2025-09-25,12,Kínder,TopKids,251,22,229
2025-09-25,12,Kínder,SuperSchool,265,18,247
2025-09-25,12,Kínder,SuperSchool,137,5,132
2025-09-25,12,Kínder,EduMax,155,1,154
2025-09-25,12,Kínder,TopKids,217,8,209
2025-09-25,12,Primaria 1°,SuperSchool,182,22,160
2025-09-25,12,Primaria 1°,SuperSchool,195,7,188
2025-09-25,12,Primaria 1°,TopKids,146,22,124
2025-09-25,12,Primaria 1°,EduMax,81,19,62
2025-09-25,12,Primaria 1°,TopKids,299,1,298
2025-09-25,12,Primaria 1°,EduMax,134,13,121
2025-09-25,12,Primaria 1°,EduMax,57,7,50
2025-09-25,12,Primaria 1°,TopKids,185,24,161
2025-09-25,12,Primaria 1°,TopKids,230,7,223
2025-09-25,12,Primaria 1°,EduMax,213,6,207
2025-09-25,12,Primaria 2°,EduMax,123,19,104
2025-09-25,12,Primaria 2°,EduMax,221,17,204
2025-09-25,12,Primaria 2°,EduMax,79,19,60
2025-09-25,12,Primaria 2°,EduMax,284,15,269
2025-09-25,12,Primaria 2°,TopKids,60,22,38
2025-09-25,12,Primaria 2°,EduMax,68,3,65
2025-09-25,12,Primaria 2°,TopKids,160,6,154
2025-09-25,12,Primaria 2°,SuperSchool,249,2,247
2025-09-25,12,Primaria 2°,TopKids,288,8,280
2025-09-25,12,Primaria 2°,TopKids,86,12,74
2025-09-25,12,Primaria 2°,TopKids,157,9,148
2025-09-25,12,Primaria 2°,EduMax,74,10,64
2025-09-25,12,Primaria 2°,SuperSchool,256,20,236
2025-09-25,12,Primaria 2°,TopKids,230,10,220
2025-09-25,12,Primaria 2°,SuperSchool,174,6,168
2025-09-25,12,Primaria 3°,EduMax,162,18,144
2025-09-25,12,Primaria 3°,EduMax,296,6,290
2025-09-25,12,Primaria 3°,EduMax,60,19,41
2025-09-25,12,Primaria 3°,EduMax,280,21,259
2025-09-25,12,Primaria 3°,EduMax,128,13,115
2025-09-25,12,Primaria 3°,TopKids,165,3,162
2025-09-25,12,Primaria 3°,TopKids,133,3,130
2025-09-25,12,Primaria 3°,EduMax,76,15,61
2025-09-25,12,Primaria 3°,TopKids,205,15,190
2025-09-25,12,Primaria 3°,SuperSchool,230,20,210
2025-09-25,12,Primaria 3°,TopKids,74,4,70
2025-09-25,12,Primaria 3°,TopKids,103,10,93
2025-09-25,12,Primaria 3°,TopKids,262,4,258
2025-09-25,12,Primaria 4°,TopKids,222,19,203
2025-09-25,12,Primaria 4°,EduMax,190,4,186
2025-09-25,12,Primaria 4°,EduMax,204,8,196
2025-09-25,12,Primaria 4°,SuperSchool,95,8,87
2025-09-25,12,Primaria 4°,SuperSchool,75,1,74
2025-09-25,12,Primaria 5°,SuperSchool,260,20,240
2025-09-25,12,Primaria 5°,EduMax,139,7,132
2025-09-25,12,Primaria 5°,SuperSchool,76,6,70
2025-09-25,12,Primaria 5°,EduMax,242,6,236
2025-09-25,12,Primaria 5°,TopKids,71,9,62
2025-09-25,12,Primaria 5°,SuperSchool,231,8,223
2025-09-25,12,Primaria 5°,TopKids,125,1,124
2025-09-25,12,Primaria 5°,EduMax,189,16,173
2025-09-25,12,Primaria 5°,EduMax,271,11,260
2025-09-25,12,Primaria 5°,TopKids,68,13,55
2025-09-25,12,Primaria 5°,EduMax,160,13,147
2025-09-25,12,Primaria 5°,SuperSchool,297,15,282
2025-09-25,12,Primaria 5°,SuperSchool,112,23,89
2025-09-25,12,Primaria 5°,TopKids,59,4,55
2025-09-25,12,Primaria 5°,TopKids,226,14,212
2025-09-25,12,Primaria 6°,EduMax,144,7,137
2025-09-25,12,Primaria 6°,EduMax,258,22,236
2025-09-25,12,Primaria 6°,TopKids,72,5,67
2025-09-25,12,Primaria 6°,EduMax,296,6,290
2025-09-25,12,Primaria 6°,EduMax,68,11,57
2025-09-25,12,Primaria 6°,TopKids,159,15,144
2025-09-25,12,Primaria 6°,TopKids,278,23,255
2025-09-25,12,Primaria 6°,SuperSchool,135,18,117
2025-09-25,12,Primaria 6°,TopKids,125,5,120
2025-09-25,12,Primaria 6°,TopKids,126,23,103
2025-09-25,12,Primaria 6°,SuperSchool,254,6,248
2025-09-25,12,Primaria 6°,SuperSchool,289,3,286
2025-09-25,12,Primaria 6°,TopKids,294,10,284
2025-09-25,12,Primaria 6°,EduMax,272,4,268
2025-09-25,12,Primaria 6°,EduMax,131,7,124
2025-09-25,12,Primaria 6°,EduMax,264,8,256
2025-09-25,12,Primaria 6°,EduMax,265,13,252
2025-09-25,12,Primaria 6°,TopKids,116,13,103
2025-09-25,13,Preescolar,SuperSchool,163,21,142
2025-09-25,13,Preescolar,TopKids,206,17,189
2025-09-25,13,Preescolar,SuperSchool,183,14,169
2025-09-25,13,Preescolar,EduMax,260,5,255
2025-09-25,13,Preescolar,EduMax,156,24,132
2025-09-25,13,Preescolar,TopKids,134,17,117
2025-09-25,13,Preescolar,SuperSchool,98,2,96
2025-09-25,13,Preescolar,EduMax,138,19,119
2025-09-25,13,Preescolar,EduMax,242,14,228
2025-09-25,13,Preescolar,TopKids,168,2,166
2025-09-25,13,Preescolar,SuperSchool,198,12,186
2025-09-25,13,Kínder,TopKids,240,23,217
2025-09-25,13,Kínder,TopKids,107,13,94
2025-09-25,13,Kínder,SuperSchool,191,22,169
2025-09-25,13,Kínder,SuperSchool,206,16,190
2025-09-25,13,Kínder,EduMax,139,2,137
2025-09-25,13,Primaria 1°,TopKids,66,24,42
2025-09-25,13,Primaria 1°,TopKids,275,18,257
2025-09-25,13,Primaria 1°,SuperSchool,197,12,185
2025-09-25,13,Primaria 1°,SuperSchool,124,17,107
2025-09-25,13,Primaria 1°,EduMax,158,19,139
2025-09-25,13,Primaria 1°,SuperSchool,283,15,268
2025-09-25,13,Primaria 1°,TopKids,106,9,97
2025-09-25,13,Primaria 1°,TopKids,52,10,42
2025-09-25,13,Primaria 1°,TopKids,189,15,174
2025-09-25,13,Primaria 1°,TopKids,140,19,121
2025-09-25,13,Primaria 1°,EduMax,188,6,182
2025-09-25,13,Primaria 1°,EduMax,74,2,72
2025-09-25,13,Primaria 1°,EduMax,265,16,249
2025-09-25,13,Primaria 1°,SuperSchool,271,17,254
2025-09-25,13,Primaria 2°,EduMax,109,10,99
2025-09-25,13,Primaria 2°,EduMax,239,19,220
2025-09-25,13,Primaria 2°,TopKids,127,4,123
2025-09-25,13,Primaria 2°,TopKids,234,22,212
2025-09-25,13,Primaria 2°,TopKids,246,21,225
2025-09-25,13,Primaria 2°,EduMax,189,13,176
2025-09-25,13,Primaria 2°,SuperSchool,179,5,174
2025-09-25,13,Primaria 2°,TopKids,68,24,44
2025-09-25,13,Primaria 3°,EduMax,269,3,266
2025-09-25,13,Primaria 3°,TopKids,80,19,61
2025-09-25,13,Primaria 3°,TopKids,221,19,202
2025-09-25,13,Primaria 3°,EduMax,130,12,118
2025-09-25,13,Primaria 3°,TopKids,139,21,118
2025-09-25,13,Primaria 3°,SuperSchool,121,8,113
2025-09-25,13,Primaria 3°,SuperSchool,202,13,189
2025-09-25,13,Primaria 3°,EduMax,190,10,180
2025-09-25,13,Primaria 3°,TopKids,72,16,56
2025-09-25,13,Primaria 4°,TopKids,221,14,207
2025-09-25,13,Primaria 4°,TopKids,96,11,85
2025-09-25,13,Primaria 4°,TopKids,99,8,91
2025-09-25,13,Primaria 4°,TopKids,89,13,76
2025-09-25,13,Primaria 4°,EduMax,270,10,260
2025-09-25,13,Primaria 4°,TopKids,109,5,104
2025-09-25,13,Primaria 4°,SuperSchool,217,2,215
2025-09-25,13,Primaria 4°,SuperSchool,202,24,178
2025-09-25,13,Primaria 4°,TopKids,161,5,156
2025-09-25,13,Primaria 4°,TopKids,111,11,100
2025-09-25,13,Primaria 4°,EduMax,258,9,249
2025-09-25,13,Primaria 4°,TopKids,213,2,211
2025-09-25,13,Primaria 4°,EduMax,164,22,142
2025-09-25,13,Primaria 4°,SuperSchool,135,16,119
2025-09-25,13,Primaria 4°,SuperSchool,112,2,110
2025-09-25,13,Primaria 4°,TopKids,100,2,98
2025-09-25,13,Primaria 4°,EduMax,255,20,235
2025-09-25,13,Primaria 5°,TopKids,282,15,267
2025-09-25,13,Primaria 5°,TopKids,266,11,255
2025-09-25,13,Primaria 5°,SuperSchool,249,22,227
2025-09-25,13,Primaria 5°,TopKids,174,6,168
2025-09-25,13,Primaria 5°,TopKids,280,19,261
2025-09-25,13,Primaria 6°,TopKids,100,14,86
2025-09-25,13,Primaria 6°,TopKids,203,6,197
2025-09-25,13,Primaria 6°,SuperSchool,223,12,211
2025-09-25,13,Primaria 6°,SuperSchool,189,9,180
2025-09-25,13,Primaria 6°,SuperSchool,90,14,76
2025-09-25,13,Primaria 6°,EduMax,95,23,72
2025-09-25,13,Primaria 6°,EduMax,270,7,263
2025-09-25,13,Primaria 6°,TopKids,295,8,287
2025-09-25,13,Primaria 6°,TopKids,51,1,50
2025-09-25,13,Primaria 6°,TopKids,169,8,161
2025-09-25,13,Primaria 6°,TopKids,88,18,70
2025-09-25,13,Primaria 6°,TopKids,254,16,238
2025-09-25,13,Primaria 6°,TopKids,188,24,164
2025-09-25,13,Primaria 6°,SuperSchool,231,10,221
2025-09-25,13,Primaria 6°,TopKids,298,5,293
2025-09-25,13,Primaria 6°,SuperSchool,203,16,187
2025-09-25,13,Primaria 6°,EduMax,139,4,135
2025-09-25,13,Primaria 6°,SuperSchool,193,22,171
2025-09-25,14,Preescolar,EduMax,269,11,258
2025-09-25,14,Preescolar,EduMax,288,21,267
2025-09-25,14,Preescolar,EduMax,88,21,67
2025-09-25,14,Preescolar,TopKids,199,1,198
2025-09-25,14,Preescolar,EduMax,214,21,193
2025-09-25,14,Preescolar,EduMax,203,6,197
2025-09-25,14,Preescolar,EduMax,233,4,229
2025-09-25,14,Preescolar,TopKids,85,3,82
2025-09-25,14,Preescolar,SuperSchool,129,16,113
2025-09-25,14,Preescolar,SuperSchool,268,24,244
2025-09-25,14,Preescolar,EduMax,198,13,185
2025-09-25,14,Preescolar,SuperSchool,282,11,271
2025-09-25,14,Preescolar,SuperSchool,107,19,88
2025-09-25,14,Preescolar,SuperSchool,144,22,122
2025-09-25,14,Preescolar,SuperSchool,82,17,65
2025-09-25,14,Kínder,SuperSchool,65,21,44
2025-09-25,14,Kínder,TopKids,138,17,121
2025-09-25,14,Kínder,EduMax,131,18,113
2025-09-25,14,Kínder,SuperSchool,267,18,249
2025-09-25,14,Kínder,SuperSchool,77,8,69
2025-09-25,14,Kínder,TopKids,185,13,172
2025-09-25,14,Kínder,SuperSchool,96,10,86
2025-09-25,14,Kínder,SuperSchool,244,10,234
2025-09-25,14,Kínder,SuperSchool,241,15,226
2025-09-25,14,Kínder,SuperSchool,123,20,103
2025-09-25,14,Primaria 1°,EduMax,108,16,92
2025-09-25,14,Primaria 1°,EduMax,279,7,272
2025-09-25,14,Primaria 1°,EduMax,91,19,72
2025-09-25,14,Primaria 1°,EduMax,141,9,132
2025-09-25,14,Primaria 1°,EduMax,115,9,106
2025-09-25,14,Primaria 1°,EduMax,176,4,172
2025-09-25,14,Primaria 1°,TopKids,226,3,223
2025-09-25,14,Primaria 1°,EduMax,224,2,222
2025-09-25,14,Primaria 1°,EduMax,269,10,259
2025-09-25,14,Primaria 2°,TopKids,155,1,154
2025-09-25,14,Primaria 2°,SuperSchool,122,17,105
2025-09-25,14,Primaria 2°,EduMax,108,2,106
2025-09-25,14,Primaria 2°,SuperSchool,211,13,198
2025-09-25,14,Primaria 2°,SuperSchool,178,21,157
2025-09-25,14,Primaria 2°,SuperSchool,111,15,96
2025-09-25,14,Primaria 2°,TopKids,100,14,86
2025-09-25,14,Primaria 2°,EduMax,108,20,88
2025-09-25,14,Primaria 2°,SuperSchool,276,11,265
2025-09-25,14,Primaria 2°,SuperSchool,105,5,100
2025-09-25,14,Primaria 3°,EduMax,138,23,115
2025-09-25,14,Primaria 3°,TopKids,96,16,80
2025-09-25,14,Primaria 3°,TopKids,226,18,208
2025-09-25,14,Primaria 3°,TopKids,153,21,132
2025-09-25,14,Primaria 3°,SuperSchool,237,14,223
2025-09-25,14,Primaria 4°,EduMax,133,21,112
2025-09-25,14,Primaria 4°,TopKids,184,23,161
2025-09-25,14,Primaria 4°,SuperSchool,70,7,63
2025-09-25,14,Primaria 4°,TopKids,297,15,282
2025-09-25,14,Primaria 4°,EduMax,51,5,46
2025-09-25,14,Primaria 4°,TopKids,225,4,221
2025-09-25,14,Primaria 4°,TopKids,290,11,279
2025-09-25,14,Primaria 4°,TopKids,181,4,177
2025-09-25,14,Primaria 5°,EduMax,129,20,109
2025-09-25,14,Primaria 5°,SuperSchool,281,19,262
2025-09-25,14,Primaria 5°,EduMax,209,2,207
2025-09-25,14,Primaria 5°,SuperSchool,72,12,60
2025-09-25,14,Primaria 5°,EduMax,189,22,167
2025-09-25,14,Primaria 5°,SuperSchool,251,4,247
2025-09-25,14,Primaria 5°,TopKids,295,2,293
2025-09-25,14,Primaria 6°,EduMax,250,24,226
2025-09-25,14,Primaria 6°,EduMax,238,17,221
2025-09-25,14,Primaria 6°,TopKids,257,17,240
2025-09-25,14,Primaria 6°,EduMax,249,3,246
2025-09-25,14,Primaria 6°,SuperSchool,206,21,185
2025-09-25,14,Primaria 6°,EduMax,293,6,287
2025-09-25,14,Primaria 6°,SuperSchool,264,18,246
2025-09-25,14,Primaria 6°,TopKids,247,13,234
2025-09-25,14,Primaria 6°,SuperSchool,237,9,228
2025-09-25,14,Primaria 6°,SuperSchool,76,14,62
2025-09-25,14,Primaria 6°,SuperSchool,54,6,48
2025-09-25,14,Primaria 6°,SuperSchool,293,13,280
2025-09-25,14,Primaria 6°,SuperSchool,143,22,121
2025-09-25,14,Primaria 6°,SuperSchool,183,7,176
2025-09-25,14,Primaria 6°,EduMax,213,18,195
2025-09-25,14,Primaria 6°,SuperSchool,97,19,78
2025-09-25,14,Primaria 6°,TopKids,194,2,192
2025-09-25,14,Primaria 6°,TopKids,154,14,140
2025-09-25,14,Primaria 6°,SuperSchool,128,7,121
2025-09-25,15,Preescolar,TopKids,191,9,182
2025-09-25,15,Preescolar,SuperSchool,162,21,141
2025-09-25,15,Preescolar,EduMax,157,22,135
2025-09-25,15,Preescolar,EduMax,256,6,250
2025-09-25,15,Preescolar,TopKids,175,22,153
2025-09-25,15,Preescolar,TopKids,112,17,95
2025-09-25,15,Preescolar,TopKids,182,23,159
2025-09-25,15,Preescolar,TopKids,177,1,176
2025-09-25,15,Preescolar,TopKids,92,22,70
2025-09-25,15,Preescolar,EduMax,277,17,260
2025-09-25,15,Preescolar,SuperSchool,251,23,228
2025-09-25,15,Preescolar,EduMax,223,7,216
2025-09-25,15,Preescolar,TopKids,168,23,145
2025-09-25,15,Preescolar,TopKids,201,3,198
2025-09-25,15,Preescolar,TopKids,246,4,242
2025-09-25,15,Preescolar,SuperSchool,277,6,271
2025-09-25,15,Preescolar,EduMax,142,5,137
2025-09-25,15,Preescolar,TopKids,57,2,55
2025-09-25,15,Kínder,TopKids,86,9,77
2025-09-25,15,Kínder,SuperSchool,249,14,235
2025-09-25,15,Kínder,SuperSchool,275,3,272
2025-09-25,15,Kínder,TopKids,182,15,167
2025-09-25,15,Kínder,EduMax,269,18,251
2025-09-25,15,Kínder,SuperSchool,60,10,50
2025-09-25,15,Kínder,EduMax,197,5,192
2025-09-25,15,Kínder,TopKids,231,1,230
2025-09-25,15,Kínder,SuperSchool,159,22,137
2025-09-25,15,Primaria 1°,TopKids,122,3,119
2025-09-25,15,Primaria 1°,EduMax,189,24,165
2025-09-25,15,Primaria 1°,EduMax,105,4,101
2025-09-25,15,Primaria 1°,SuperSchool,229,15,214
2025-09-25,15,Primaria 1°,SuperSchool,249,17,232
2025-09-25,15,Primaria 1°,SuperSchool,120,3,117
2025-09-25,15,Primaria 1°,EduMax,94,16,78
2025-09-25,15,Primaria 1°,TopKids,66,6,60
2025-09-25,15,Primaria 1°,EduMax,86,18,68
2025-09-25,15,Primaria 1°,TopKids,109,11,98
2025-09-25,15,Primaria 1°,TopKids,247,16,231
2025-09-25,15,Primaria 1°,EduMax,186,18,168
2025-09-25,15,Primaria 1°,SuperSchool,291,19,272
2025-09-25,15,Primaria 1°,SuperSchool,95,12,83
2025-09-25,15,Primaria 1°,EduMax,250,12,238
2025-09-25,15,Primaria 1°,SuperSchool,72,19,53
2025-09-25,15,Primaria 1°,EduMax,83,6,77
2025-09-25,15,Primaria 2°,SuperSchool,242,18,224
2025-09-25,15,Primaria 2°,TopKids,267,15,252
2025-09-25,15,Primaria 2°,EduMax,230,15,215
2025-09-25,15,Primaria 2°,TopKids,107,13,94
2025-09-25,15,Primaria 2°,TopKids,91,17,74
2025-09-25,15,Primaria 2°,SuperSchool,210,19,191
2025-09-25,15,Primaria 2°,SuperSchool,184,2,182
2025-09-25,15,Primaria 2°,SuperSchool,256,20,236
2025-09-25,15,Primaria 2°,SuperSchool,81,7,74
2025-09-25,15,Primaria 2°,EduMax,112,20,92
2025-09-25,15,Primaria 3°,SuperSchool,196,22,174
2025-09-25,15,Primaria 3°,SuperSchool,123,8,115
2025-09-25,15,Primaria 3°,SuperSchool,127,11,116
2025-09-25,15,Primaria 3°,EduMax,274,10,264
2025-09-25,15,Primaria 3°,EduMax,216,17,199
2025-09-25,15,Primaria 3°,SuperSchool,169,10,159
2025-09-25,15,Primaria 3°,SuperSchool,182,9,173
2025-09-25,15,Primaria 3°,TopKids,96,5,91
2025-09-25,15,Primaria 3°,TopKids,194,19,175
2025-09-25,15,Primaria 3°,EduMax,166,24,142
2025-09-25,15,Primaria 3°,EduMax,243,14,229
2025-09-25,15,Primaria 3°,TopKids,128,22,106
2025-09-25,15,Primaria 3°,EduMax,99,19,80
2025-09-25,15,Primaria 3°,EduMax,59,24,35
2025-09-25,15,Primaria 3°,EduMax,65,5,60
2025-09-25,15,Primaria 3°,SuperSchool,286,23,263
2025-09-25,15,Primaria 3°,EduMax,171,12,159
2025-09-25,15,Primaria 3°,SuperSchool,122,20,102
2025-09-25,15,Primaria 4°,SuperSchool,179,14,165
2025-09-25,15,Primaria 4°,SuperSchool,110,1,109
2025-09-25,15,Primaria 4°,SuperSchool,288,22,266
2025-09-25,15,Primaria 4°,EduMax,76,1,75
2025-09-25,15,Primaria 4°,SuperSchool,129,10,119
2025-09-25,15,Primaria 5°,SuperSchool,179,14,165
2025-09-25,15,Primaria 5°,TopKids,260,19,241
2025-09-25,15,Primaria 5°,TopKids,148,11,137
2025-09-25,15,Primaria 5°,EduMax,171,16,155
2025-09-25,15,Primaria 5°,SuperSchool,78,20,58
2025-09-25,15,Primaria 5°,TopKids,137,11,126
2025-09-25,15,Primaria 5°,SuperSchool,117,5,112
2025-09-25,15,Primaria 5°,TopKids,225,19,206
2025-09-25,15,Primaria 5°,EduMax,161,1,160
2025-09-25,15,Primaria 5°,TopKids,51,10,41
2025-09-25,15,Primaria 5°,TopKids,108,6,102
2025-09-25,15,Primaria 5°,EduMax,261,19,242
2025-09-25,15,Primaria 5°,SuperSchool,169,9,160
2025-09-25,15,Primaria 5°,SuperSchool,81,8,73
2025-09-25,15,Primaria 5°,SuperSchool,54,21,33
2025-09-25,15,Primaria 6°,TopKids,161,18,143
2025-09-25,15,Primaria 6°,EduMax,55,10,45
2025-09-25,15,Primaria 6°,SuperSchool,257,19,238
2025-09-25,15,Primaria 6°,EduMax,86,13,73
2025-09-25,15,Primaria 6°,TopKids,288,6,282
2025-09-25,16,Preescolar,TopKids,273,15,258
2025-09-25,16,Preescolar,TopKids,124,5,119
2025-09-25,16,Preescolar,EduMax,270,20,250
2025-09-25,16,Preescolar,EduMax,189,17,172
2025-09-25,16,Preescolar,SuperSchool,117,19,98
2025-09-25,16,Preescolar,SuperSchool,136,18,118
2025-09-25,16,Kínder,SuperSchool,219,14,205
2025-09-25,16,Kínder,SuperSchool,127,4,123
2025-09-25,16,Kínder,TopKids,85,11,74
2025-09-25,16,Kínder,SuperSchool,279,5,274
2025-09-25,16,Kínder,TopKids,214,12,202
2025-09-25,16,Kínder,TopKids,241,6,235
2025-09-25,16,Kínder,EduMax,191,22,169
2025-09-25,16,Kínder,TopKids,124,8,116
2025-09-25,16,Primaria 1°,TopKids,233,6,227
2025-09-25,16,Primaria 1°,SuperSchool,126,6,120
2025-09-25,16,Primaria 1°,EduMax,103,2,101
2025-09-25,16,Primaria 1°,TopKids,121,22,99
2025-09-25,16,Primaria 1°,TopKids,224,24,200
2025-09-25,16,Primaria 1°,TopKids,91,3,88
2025-09-25,16,Primaria 1°,EduMax,100,3,97
2025-09-25,16,Primaria 1°,EduMax,86,22,64
2025-09-25,16,Primaria 2°,EduMax,152,2,150
2025-09-25,16,Primaria 2°,SuperSchool,136,22,114
2025-09-25,16,Primaria 2°,EduMax,84,2,82
2025-09-25,16,Primaria 2°,SuperSchool,99,14,85
2025-09-25,16,Primaria 2°,EduMax,121,1,120
2025-09-25,16,Primaria 3°,TopKids,297,22,275
2025-09-25,16,Primaria 3°,TopKids,147,16,131
2025-09-25,16,Primaria 3°,EduMax,209,9,200
2025-09-25,16,Primaria 3°,TopKids,276,19,257
2025-09-25,16,Primaria 3°,EduMax,107,24,83
2025-09-25,16,Primaria 3°,TopKids,168,16,152
2025-09-25,16,Primaria 3°,TopKids,288,14,274
2025-09-25,16,Primaria 3°,SuperSchool,120,3,117
2025-09-25,16,Primaria 3°,SuperSchool,115,16,99
2025-09-25,16,Primaria 3°,EduMax,276,12,264
2025-09-25,16,Primaria 3°,SuperSchool,224,1,223
2025-09-25,16,Primaria 3°,SuperSchool,128,3,125
2025-09-25,16,Primaria 3°,EduMax,231,10,221
2025-09-25,16,Primaria 3°,TopKids,133,18,115
2025-09-25,16,Primaria 3°,TopKids,177,4,173
2025-09-25,16,Primaria 3°,TopKids,290,20,270
2025-09-25,16,Primaria 4°,TopKids,60,3,57
2025-09-25,16,Primaria 4°,TopKids,59,19,40
2025-09-25,16,Primaria 4°,TopKids,62,3,59
2025-09-25,16,Primaria 4°,SuperSchool,102,15,87
2025-09-25,16,Primaria 4°,SuperSchool,262,10,252
2025-09-25,16,Primaria 4°,SuperSchool,294,15,279
2025-09-25,16,Primaria 4°,TopKids,79,14,65
2025-09-25,16,Primaria 4°,SuperSchool,298,15,283
2025-09-25,16,Primaria 5°,TopKids,108,14,94
2025-09-25,16,Primaria 5°,EduMax,113,12,101
2025-09-25,16,Primaria 5°,EduMax,202,15,187
2025-09-25,16,Primaria 5°,SuperSchool,51,19,32
2025-09-25,16,Primaria 5°,SuperSchool,128,23,105
2025-09-25,16,Primaria 5°,EduMax,220,14,206
2025-09-25,16,Primaria 5°,SuperSchool,238,3,235
2025-09-25,16,Primaria 5°,SuperSchool,215,6,209
2025-09-25,16,Primaria 5°,SuperSchool,117,3,114
2025-09-25,16,Primaria 5°,SuperSchool,207,4,203
2025-09-25,16,Primaria 5°,TopKids,111,7,104
2025-09-25,16,Primaria 5°,TopKids,209,11,198
2025-09-25,16,Primaria 5°,EduMax,292,19,273
2025-09-25,16,Primaria 5°,SuperSchool,274,11,263
2025-09-25,16,Primaria 5°,SuperSchool,111,23,88
2025-09-25,16,Primaria 5°,SuperSchool,121,23,98
2025-09-25,16,Primaria 5°,SuperSchool,53,19,34
2025-09-25,16,Primaria 5°,TopKids,93,9,84
2025-09-25,16,Primaria 6°,SuperSchool,189,24,165
2025-09-25,16,Primaria 6°,EduMax,97,13,84
2025-09-25,16,Primaria 6°,TopKids,81,6,75
2025-09-25,16,Primaria 6°,EduMax,243,22,221
2025-09-25,16,Primaria 6°,SuperSchool,208,20,188
2025-09-25,16,Primaria 6°,TopKids,193,8,185
2025-09-25,16,Primaria 6°,EduMax,87,3,84
2025-09-25,16,Primaria 6°,SuperSchool,149,6,143
2025-09-25,16,Primaria 6°,EduMax,263,3,260
2025-09-25,16,Primaria 6°,TopKids,155,15,140
2025-09-25,16,Primaria 6°,EduMax,76,6,70
2025-09-25,16,Primaria 6°,TopKids,183,16,167
2025-09-25,16,Primaria 6°,EduMax,128,20,108
2025-09-25,16,Primaria 6°,TopKids,145,8,137
2025-09-25,16,Primaria 6°,TopKids,255,21,234
2025-09-25,16,Primaria 6°,TopKids,203,20,183
2025-09-25,16,Primaria 6°,SuperSchool,126,15,111
2025-09-26,9,Preescolar,EduMax,203,15,188
2025-09-26,9,Preescolar,EduMax,292,8,284
2025-09-26,9,Preescolar,EduMax,190,4,186
2025-09-26,9,Preescolar,TopKids,51,19,32
2025-09-26,9,Preescolar,SuperSchool,131,23,108
2025-09-26,9,Preescolar,SuperSchool,119,14,105
2025-09-26,9,Preescolar,EduMax,124,7,117
2025-09-26,9,Preescolar,TopKids,274,10,264
2025-09-26,9,Preescolar,SuperSchool,250,23,227
2025-09-26,9,Preescolar,EduMax,225,16,209
2025-09-26,9,Preescolar,SuperSchool,266,17,249
2025-09-26,9,Preescolar,TopKids,211,3,208
2025-09-26,9,Kínder,TopKids,204,19,185
2025-09-26,9,Kínder,SuperSchool,280,4,276
2025-09-26,9,Kínder,EduMax,248,24,224
2025-09-26,9,Kínder,SuperSchool,182,10,172
2025-09-26,9,Kínder,EduMax,297,1,296
2025-09-26,9,Kínder,TopKids,179,14,165
2025-09-26,9,Kínder,TopKids,164,3,161
2025-09-26,9,Kínder,SuperSchool,290,3,287
2025-09-26,9,Kínder,EduMax,211,13,198
2025-09-26,9,Kínder,SuperSchool,187,8,179
2025-09-26,9,Primaria 1°,SuperSchool,231,7,224
2025-09-26,9,Primaria 1°,EduMax,82,23,59
2025-09-26,9,Primaria 1°,TopKids,217,6,211
2025-09-26,9,Primaria 1°,TopKids,108,18,90
2025-09-26,9,Primaria 1°,TopKids,176,20,156
2025-09-26,9,Primaria 1°,EduMax,289,12,277
2025-09-26,9,Primaria 1°,SuperSchool,274,6,268
2025-09-26,9,Primaria 1°,SuperSchool,237,22,215
2025-09-26,9,Primaria 1°,SuperSchool,57,13,44
2025-09-26,9,Primaria 1°,TopKids,74,23,51
2025-09-26,9,Primaria 1°,SuperSchool,236,24,212
2025-09-26,9,Primaria 1°,SuperSchool,268,19,249
2025-09-26,9,Primaria 1°,EduMax,133,4,129
2025-09-26,9,Primaria 1°,EduMax,184,22,162
2025-09-26,9,Primaria 1°,EduMax,59,23,36
2025-09-26,9,Primaria 1°,TopKids,158,24,134
2025-09-26,9,Primaria 1°,EduMax,201,22,179
2025-09-26,9,Primaria 2°,TopKids,177,8,169
2025-09-26,9,Primaria 2°,TopKids,266,3,263
2025-09-26,9,Primaria 2°,EduMax,299,8,291
2025-09-26,9,Primaria 2°,SuperSchool,151,21,130
2025-09-26,9,Primaria 2°,EduMax,114,10,104
2025-09-26,9,Primaria 2°,EduMax,115,8,107
2025-09-26,9,Primaria 2°,EduMax,210,7,203
2025-09-26,9,Primaria 2°,SuperSchool,143,5,138
2025-09-26,9,Primaria 2°,EduMax,207,17,190
2025-09-26,9,Primaria 2°,SuperSchool,79,13,66
2025-09-26,9,Primaria 2°,SuperSchool,149,21,128
2025-09-26,9,Primaria 2°,EduMax,193,17,176
2025-09-26,9,Primaria 2°,EduMax,211,21,190
2025-09-26,9,Primaria 2°,TopKids,59,9,50
2025-09-26,9,Primaria 2°,TopKids,299,4,295
2025-09-26,9,Primaria 2°,TopKids,102,23,79
2025-09-26,9,Primaria 3°,EduMax,282,7,275
2025-09-26,9,Primaria 3°,TopKids,206,2,204
2025-09-26,9,Primaria 3°,EduMax,174,20,154
2025-09-26,9,Primaria 3°,EduMax,268,24,244
2025-09-26,9,Primaria 3°,EduMax,89,23,66
2025-09-26,9,Primaria 3°,SuperSchool,240,23,217
2025-09-26,9,Primaria 3°,EduMax,60,22,38
2025-09-26,9,Primaria 3°,TopKids,123,22,101
2025-09-26,9,Primaria 3°,SuperSchool,143,3,140
2025-09-26,9,Primaria 3°,SuperSchool,54,3,51
2025-09-26,9,Primaria 3°,TopKids,117,9,108
2025-09-26,9,Primaria 3°,SuperSchool,251,21,230
2025-09-26,9,Primaria 3°,TopKids,258,16,242
2025-09-26,9,Primaria 3°,TopKids,160,18,142
2025-09-26,9,Primaria 3°,EduMax,271,15,256
2025-09-26,9,Primaria 3°,TopKids,229,5,224
2025-09-26,9,Primaria 3°,SuperSchool,213,2,211
2025-09-26,9,Primaria 3°,TopKids,112,17,95
2025-09-26,9,Primaria 4°,EduMax,177,4,173
2025-09-26,9,Primaria 4°,EduMax,236,13,223
2025-09-26,9,Primaria 4°,EduMax,221,3,218
2025-09-26,9,Primaria 4°,SuperSchool,256,15,241
2025-09-26,9,Primaria 4°,TopKids,224,8,216
2025-09-26,9,Primaria 4°,SuperSchool,138,23,115
2025-09-26,9,Primaria 4°,EduMax,273,23,250
2025-09-26,9,Primaria 4°,EduMax,66,2,64
2025-09-26,9,Primaria 4°,TopKids,65,19,46
2025-09-26,9,Primaria 4°,SuperSchool,70,21,49
2025-09-26,9,Primaria 4°,EduMax,95,13,82
2025-09-26,9,Primaria 4°,TopKids,107,7,100
2025-09-26,9,Primaria 4°,SuperSchool,279,2,277
2025-09-26,9,Primaria 5°,SuperSchool,93,15,78
2025-09-26,9,Primaria 5°,EduMax,176,1,175
2025-09-26,9,Primaria 5°,TopKids,102,12,90
2025-09-26,9,Primaria 5°,TopKids,143,19,124
2025-09-26,9,Primaria 5°,SuperSchool,238,11,227
2025-09-26,9,Primaria 5°,TopKids,248,12,236
2025-09-26,9,Primaria 5°,EduMax,78,16,62
2025-09-26,9,Primaria 5°,TopKids,198,13,185
2025-09-26,9,Primaria 5°,SuperSchool,204,4,200
2025-09-26,9,Primaria 5°,SuperSchool,58,10,48
2025-09-26,9,Primaria 6°,SuperSchool,290,7,283
2025-09-26,9,Primaria 6°,TopKids,158,6,152
2025-09-26,9,Primaria 6°,EduMax,168,8,160
2025-09-26,9,Primaria 6°,TopKids,199,10,189
2025-09-26,9,Primaria 6°,EduMax,203,12,191
2025-09-26,9,Primaria 6°,EduMax,232,11,221
2025-09-26,9,Primaria 6°,TopKids,232,13,219
2025-09-26,9,Primaria 6°,EduMax,115,3,112
2025-09-26,9,Primaria 6°,EduMax,138,1,137
2025-09-26,9,Primaria 6°,SuperSchool,201,23,178
2025-09-26,9,Primaria 6°,EduMax,114,2,112
2025-09-26,9,Primaria 6°,EduMax,93,5,88
2025-09-26,9,Primaria 6°,SuperSchool,189,8,181
2025-09-26,9,Primaria 6°,EduMax,112,14,98
2025-09-26,9,Primaria 6°,TopKids,217,9,208
2025-09-26,10,Preescolar,TopKids,54,1,53
2025-09-26,10,Preescolar,TopKids,295,4,291
2025-09-26,10,Preescolar,EduMax,66,4,62
2025-09-26,10,Preescolar,SuperSchool,199,14,185
2025-09-26,10,Preescolar,SuperSchool,131,3,128
2025-09-26,10,Preescolar,SuperSchool,60,15,45
2025-09-26,10,Preescolar,TopKids,277,6,271
2025-09-26,10,Preescolar,SuperSchool,91,7,84
2025-09-26,10,Preescolar,TopKids,128,21,107
2025-09-26,10,Preescolar,SuperSchool,97,21,76
2025-09-26,10,Preescolar,TopKids,73,23,50
2025-09-26,10,Preescolar,SuperSchool,150,1,149
2025-09-26,10,Preescolar,EduMax,224,21,203
2025-09-26,10,Preescolar,SuperSchool,248,18,230
2025-09-26,10,Preescolar,TopKids,106,21,85
2025-09-26,10,Preescolar,EduMax,89,3,86
2025-09-26,10,Kínder,EduMax,174,20,154
2025-09-26,10,Kínder,EduMax,243,4,239
2025-09-26,10,Kínder,SuperSchool,296,16,280
2025-09-26,10,Kínder,TopKids,274,2,272
2025-09-26,10,Kínder,TopKids,157,16,141
2025-09-26,10,Primaria 1°,TopKids,64,19,45
2025-09-26,10,Primaria 1°,EduMax,74,22,52
2025-09-26,10,Primaria 1°,TopKids,224,4,220
2025-09-26,10,Primaria 1°,TopKids,120,24,96
2025-09-26,10,Primaria 1°,EduMax,106,7,99
2025-09-26,10,Primaria 1°,TopKids,78,12,66
2025-09-26,10,Primaria 1°,EduMax,191,15,176
2025-09-26,10,Primaria 1°,TopKids,259,11,248
2025-09-26,10,Primaria 1°,EduMax,287,3,284
2025-09-26,10,Primaria 2°,SuperSchool,242,13,229
2025-09-26,10,Primaria 2°,EduMax,192,11,181
2025-09-26,10,Primaria 2°,EduMax,247,24,223
2025-09-26,10,Primaria 2°,SuperSchool,202,23,179
2025-09-26,10,Primaria 2°,EduMax,194,20,174
2025-09-26,10,Primaria 2°,TopKids,179,13,166
2025-09-26,10,Primaria 3°,SuperSchool,224,7,217
2025-09-26,10,Primaria 3°,SuperSchool,123,22,101
2025-09-26,10,Primaria 3°,EduMax,205,23,182
2025-09-26,10,Primaria 3°,EduMax,155,18,137
2025-09-26,10,Primaria 3°,EduMax,196,22,174
2025-09-26,10,Primaria 4°,TopKids,245,24,221
2025-09-26,10,Primaria 4°,EduMax,241,5,236
2025-09-26,10,Primaria 4°,TopKids,118,20,98
2025-09-26,10,Primaria 4°,EduMax,159,8,151
2025-09-26,10,Primaria 4°,EduMax,226,3,223
2025-09-26,10,Primaria 5°,SuperSchool,274,24,250
2025-09-26,10,Primaria 5°,EduMax,86,19,67
2025-09-26,10,Primaria 5°,SuperSchool,202,22,180
2025-09-26,10,Primaria 5°,SuperSchool,54,8,46
2025-09-26,10,Primaria 5°,EduMax,102,9,93
2025-09-26,10,Primaria 5°,TopKids,76,3,73
2025-09-26,10,Primaria 5°,SuperSchool,133,7,126
2025-09-26,10,Primaria 5°,SuperSchool,180,10,170
2025-09-26,10,Primaria 6°,EduMax,97,9,88
2025-09-26,10,Primaria 6°,TopKids,191,19,172
2025-09-26,10,Primaria 6°,TopKids,239,6,233
2025-09-26,10,Primaria 6°,TopKids,150,13,137
2025-09-26,10,Primaria 6°,SuperSchool,95,1,94
2025-09-26,10,Primaria 6°,SuperSchool,90,9,81
2025-09-26,10,Primaria 6°,TopKids,246,21,225
2025-09-26,10,Primaria 6°,SuperSchool,166,7,159
2025-09-26,10,Primaria 6°,TopKids,231,2,229
2025-09-26,10,Primaria 6°,TopKids,91,19,72
2025-09-26,10,Primaria 6°,SuperSchool,264,15,249
2025-09-26,10,Primaria 6°,EduMax,92,4,88
2025-09-26,11,Preescolar,TopKids,144,2,142
2025-09-26,11,Preescolar,EduMax,269,11,258
2025-09-26,11,Preescolar,SuperSchool,67,24,43
2025-09-26,11,Preescolar,SuperSchool,207,5,202
2025-09-26,11,Preescolar,TopKids,200,4,196
2025-09-26,11,Kínder,TopKids,137,3,134
2025-09-26,11,Kínder,TopKids,233,14,219
2025-09-26,11,Kínder,SuperSchool,251,13,238
2025-09-26,11,Kínder,EduMax,232,12,220
2025-09-26,11,Kínder,SuperSchool,51,11,40
2025-09-26,11,Kínder,SuperSchool,219,3,216
2025-09-26,11,Kínder,SuperSchool,98,19,79
2025-09-26,11,Kínder,EduMax,86,7,79
2025-09-26,11,Kínder,TopKids,87,5,82
2025-09-26,11,Kínder,SuperSchool,132,13,119
2025-09-26,11,Kínder,TopKids,77,2,75
2025-09-26,11,Kínder,EduMax,256,5,251
2025-09-26,11,Kínder,SuperSchool,169,23,146
2025-09-26,11,Primaria 1°,EduMax,286,24,262
2025-09-26,11,Primaria 1°,EduMax,178,3,175
2025-09-26,11,Primaria 1°,TopKids,146,21,125
2025-09-26,11,Primaria 1°,EduMax,288,16,272
2025-09-26,11,Primaria 1°,SuperSchool,180,17,163
2025-09-26,11,Primaria 1°,SuperSchool,233,22,211
2025-09-26,11,Primaria 1°,SuperSchool,62,21,41
2025-09-26,11,Primaria 1°,EduMax,274,19,255
2025-09-26,11,Primaria 1°,TopKids,203,21,182
2025-09-26,11,Primaria 2°,TopKids,215,9,206
2025-09-26,11,Primaria 2°,EduMax,143,22,121
2025-09-26,11,Primaria 2°,TopKids,181,7,174
2025-09-26,11,Primaria 2°,SuperSchool,131,18,113
2025-09-26,11,Primaria 2°,EduMax,142,5,137
2025-09-26,11,Primaria 2°,EduMax,211,2,209
2025-09-26,11,Primaria 2°,SuperSchool,195,10,185
2025-09-26,11,Primaria 2°,TopKids,179,19,160
2025-09-26,11,Primaria 2°,TopKids,238,22,216
2025-09-26,11,Primaria 2°,EduMax,187,12,175
2025-09-26,11,Primaria 2°,TopKids,189,15,174
2025-09-26,11,Primaria 2°,EduMax,240,23,217
2025-09-26,11,Primaria 2°,SuperSchool,215,9,206
2025-09-26,11,Primaria 3°,EduMax,270,6,264
2025-09-26,11,Primaria 3°,EduMax,97,15,82
2025-09-26,11,Primaria 3°,SuperSchool,51,11,40
2025-09-26,11,Primaria 3°,SuperSchool,193,24,169
2025-09-26,11,Primaria 3°,EduMax,220,24,196
2025-09-26,11,Primaria 3°,SuperSchool,279,6,273
2025-09-26,11,Primaria 3°,SuperSchool,218,21,197
2025-09-26,11,Primaria 3°,SuperSchool,157,11,146
2025-09-26,11,Primaria 3°,SuperSchool,56,4,52
2025-09-26,11,Primaria 3°,SuperSchool,196,15,181
2025-09-26,11,Primaria 3°,EduMax,234,4,230
2025-09-26,11,Primaria 3°,SuperSchool,102,13,89
2025-09-26,11,Primaria 4°,EduMax,156,18,138
2025-09-26,11,Primaria 4°,TopKids,162,17,145
2025-09-26,11,Primaria 4°,TopKids,165,16,149
2025-09-26,11,Primaria 4°,TopKids,109,22,87
2025-09-26,11,Primaria 4°,TopKids,258,8,250
2025-09-26,11,Primaria 4°,TopKids,81,12,69
2025-09-26,11,Primaria 4°,TopKids,140,4,136
2025-09-26,11,Primaria 4°,SuperSchool,96,5,91
2025-09-26,11,Primaria 4°,EduMax,59,24,35
2025-09-26,11,Primaria 5°,EduMax,112,19,93
2025-09-26,11,Primaria 5°,TopKids,119,9,110
2025-09-26,11,Primaria 5°,EduMax,143,9,134
2025-09-26,11,Primaria 5°,SuperSchool,187,9,178
2025-09-26,11,Primaria 5°,SuperSchool,95,23,72
2025-09-26,11,Primaria 5°,TopKids,220,20,200
2025-09-26,11,Primaria 5°,SuperSchool,168,8,160
2025-09-26,11,Primaria 5°,SuperSchool,194,15,179
2025-09-26,11,Primaria 5°,TopKids,104,19,85
2025-09-26,11,Primaria 6°,TopKids,286,8,278
2025-09-26,11,Primaria 6°,EduMax,287,23,264
2025-09-26,11,Primaria 6°,SuperSchool,185,14,171
2025-09-26,11,Primaria 6°,SuperSchool,61,20,41
2025-09-26,11,Primaria 6°,TopKids,85,20,65
2025-09-26,12,Preescolar,EduMax,283,7,276
2025-09-26,12,Preescolar,TopKids,129,10,119
2025-09-26,12,Preescolar,TopKids,108,8,100
2025-09-26,12,Preescolar,SuperSchool,117,21,96
2025-09-26,12,Preescolar,TopKids,192,13,179
2025-09-26,12,Preescolar,SuperSchool,246,6,240
2025-09-26,12,Kínder,SuperSchool,202,10,192
2025-09-26,12,Kínder,EduMax,61,3,58
2025-09-26,12,Kínder,SuperSchool,270,11,259
2025-09-26,12,Kínder,SuperSchool,160,17,143
2025-09-26,12,Kínder,SuperSchool,118,23,95
2025-09-26,12,Kínder,TopKids,217,11,206
2025-09-26,12,Kínder,TopKids,112,22,90
2025-09-26,12,Kínder,TopKids,186,18,168
2025-09-26,12,Kínder,EduMax,241,6,235
2025-09-26,12,Kínder,TopKids,197,3,194
2025-09-26,12,Kínder,TopKids,239,3,236
2025-09-26,12,Kínder,EduMax,276,20,256
2025-09-26,12,Kínder,EduMax,149,23,126
2025-09-26,12,Kínder,SuperSchool,201,1,200
2025-09-26,12,Kínder,EduMax,98,6,92
2025-09-26,12,Kínder,EduMax,231,9,222
2025-09-26,12,Kínder,EduMax,145,5,140
2025-09-26,12,Primaria 1°,EduMax,73,8,65
2025-09-26,12,Primaria 1°,EduMax,152,8,144
2025-09-26,12,Primaria 1°,TopKids,231,19,212
2025-09-26,12,Primaria 1°,TopKids,156,3,153
2025-09-26,12,Primaria 1°,SuperSchool,144,24,120
2025-09-26,12,Primaria 1°,TopKids,271,10,261
2025-09-26,12,Primaria 1°,EduMax,52,10,42
2025-09-26,12,Primaria 1°,EduMax,114,12,102
2025-09-26,12,Primaria 1°,SuperSchool,209,24,185
2025-09-26,12,Primaria 1°,TopKids,178,16,162
2025-09-26,12,Primaria 1°,EduMax,268,15,253
2025-09-26,12,Primaria 1°,EduMax,201,8,193
2025-09-26,12,Primaria 2°,SuperSchool,58,6,52
2025-09-26,12,Primaria 2°,SuperSchool,72,22,50
2025-09-26,12,Primaria 2°,SuperSchool,66,2,64
2025-09-26,12,Primaria 2°,EduMax,291,16,275
2025-09-26,12,Primaria 2°,EduMax,52,3,49
2025-09-26,12,Primaria 3°,EduMax,59,2,57
2025-09-26,12,Primaria 3°,TopKids,191,17,174
2025-09-26,12,Primaria 3°,SuperSchool,175,10,165
2025-09-26,12,Primaria 3°,TopKids,98,13,85
2025-09-26,12,Primaria 3°,TopKids,239,16,223
2025-09-26,12,Primaria 3°,TopKids,96,7,89
2025-09-26,12,Primaria 3°,SuperSchool,170,7,163
2025-09-26,12,Primaria 3°,TopKids,95,11,84
2025-09-26,12,Primaria 3°,SuperSchool,132,7,125
2025-09-26,12,Primaria 3°,EduMax,243,22,221
2025-09-26,12,Primaria 3°,TopKids,275,21,254
2025-09-26,12,Primaria 3°,SuperSchool,204,18,186
2025-09-26,12,Primaria 3°,TopKids,105,15,90
2025-09-26,12,Primaria 3°,SuperSchool,73,20,53
2025-09-26,12,Primaria 3°,SuperSchool,247,16,231
2025-09-26,12,Primaria 3°,TopKids,143,14,129
2025-09-26,12,Primaria 3°,TopKids,294,5,289
2025-09-26,12,Primaria 3°,SuperSchool,151,15,136
2025-09-26,12,Primaria 4°,TopKids,261,6,255
2025-09-26,12,Primaria 4°,TopKids,207,8,199
2025-09-26,12,Primaria 4°,TopKids,200,12,188
2025-09-26,12,Primaria 4°,SuperSchool,50,10,40
2025-09-26,12,Primaria 4°,EduMax,152,18,134
2025-09-26,12,Primaria 4°,SuperSchool,111,16,95
2025-09-26,12,Primaria 4°,EduMax,157,9,148
2025-09-26,12,Primaria 5°,EduMax,106,10,96
2025-09-26,12,Primaria 5°,EduMax,134,10,124
2025-09-26,12,Primaria 5°,EduMax,119,11,108
2025-09-26,12,Primaria 5°,SuperSchool,244,19,225
2025-09-26,12,Primaria 5°,TopKids,53,15,38
2025-09-26,12,Primaria 5°,EduMax,172,12,160
2025-09-26,12,Primaria 5°,TopKids,226,18,208
2025-09-26,12,Primaria 5°,EduMax,214,10,204
2025-09-26,12,Primaria 5°,EduMax,122,18,104
2025-09-26,12,Primaria 5°,TopKids,93,8,85
2025-09-26,12,Primaria 5°,TopKids,269,11,258
2025-09-26,12,Primaria 5°,SuperSchool,53,18,35
2025-09-26,12,Primaria 5°,EduMax,223,22,201
2025-09-26,12,Primaria 5°,SuperSchool,141,23,118
2025-09-26,12,Primaria 5°,SuperSchool,207,9,198
2025-09-26,12,Primaria 5°,EduMax,138,18,120
2025-09-26,12,Primaria 5°,TopKids,184,24,160
2025-09-26,12,Primaria 5°,SuperSchool,168,23,145
2025-09-26,12,Primaria 6°,TopKids,60,2,58
2025-09-26,12,Primaria 6°,TopKids,128,5,123
2025-09-26,12,Primaria 6°,EduMax,70,13,57
2025-09-26,12,Primaria 6°,SuperSchool,120,17,103
2025-09-26,12,Primaria 6°,EduMax,281,13,268
2025-09-26,12,Primaria 6°,EduMax,222,23,199
2025-09-26,12,Primaria 6°,TopKids,113,15,98
2025-09-26,13,Preescolar,SuperSchool,227,19,208
2025-09-26,13,Preescolar,EduMax,198,10,188
2025-09-26,13,Preescolar,TopKids,149,9,140
2025-09-26,13,Preescolar,EduMax,65,7,58
2025-09-26,13,Preescolar,TopKids,192,23,169
2025-09-26,13,Preescolar,TopKids,246,1,245
2025-09-26,13,Preescolar,SuperSchool,190,20,170
2025-09-26,13,Preescolar,SuperSchool,145,23,122
2025-09-26,13,Preescolar,SuperSchool,195,2,193
2025-09-26,13,Preescolar,TopKids,99,10,89
2025-09-26,13,Preescolar,TopKids,294,10,284
2025-09-26,13,Preescolar,SuperSchool,52,22,30
2025-09-26,13,Preescolar,EduMax,252,6,246
2025-09-26,13,Preescolar,SuperSchool,207,14,193
2025-09-26,13,Kínder,SuperSchool,150,8,142
2025-09-26,13,Kínder,EduMax,262,19,243
2025-09-26,13,Kínder,TopKids,67,7,60
2025-09-26,13,Kínder,SuperSchool,95,18,77
2025-09-26,13,Kínder,EduMax,189,8,181
2025-09-26,13,Kínder,EduMax,215,12,203
2025-09-26,13,Primaria 1°,SuperSchool,212,16,196
2025-09-26,13,Primaria 1°,SuperSchool,161,13,148
2025-09-26,13,Primaria 1°,SuperSchool,190,24,166
2025-09-26,13,Primaria 1°,SuperSchool,51,14,37
2025-09-26,13,Primaria 1°,EduMax,68,23,45
2025-09-26,13,Primaria 1°,EduMax,73,5,68
2025-09-26,13,Primaria 1°,SuperSchool,211,6,205
2025-09-26,13,Primaria 2°,TopKids,158,13,145
2025-09-26,13,Primaria 2°,TopKids,198,14,184
2025-09-26,13,Primaria 2°,TopKids,96,21,75
2025-09-26,13,Primaria 2°,TopKids,122,10,112
2025-09-26,13,Primaria 2°,SuperSchool,216,14,202
2025-09-26,13,Primaria 2°,SuperSchool,266,14,252
2025-09-26,13,Primaria 2°,SuperSchool,155,5,150
2025-09-26,13,Primaria 2°,TopKids,259,17,242
2025-09-26,13,Primaria 2°,EduMax,181,20,161
2025-09-26,13,Primaria 2°,SuperSchool,286,24,262
2025-09-26,13,Primaria 2°,EduMax,237,15,222
2025-09-26,13,Primaria 2°,SuperSchool,267,18,249
2025-09-26,13,Primaria 2°,SuperSchool,187,17,170
2025-09-26,13,Primaria 2°,EduMax,212,4,208
2025-09-26,13,Primaria 2°,TopKids,173,11,162
2025-09-26,13,Primaria 2°,TopKids,77,11,66
2025-09-26,13,Primaria 3°,TopKids,74,12,62
2025-09-26,13,Primaria 3°,SuperSchool,233,21,212
2025-09-26,13,Primaria 3°,EduMax,145,8,137
2025-09-26,13,Primaria 3°,EduMax,161,19,142
2025-09-26,13,Primaria 3°,TopKids,231,11,220
2025-09-26,13,Primaria 3°,EduMax,56,24,32
2025-09-26,13,Primaria 3°,TopKids,81,23,58
2025-09-26,13,Primaria 4°,TopKids,289,22,267
2025-09-26,13,Primaria 4°,TopKids,74,6,68
2025-09-26,13,Primaria 4°,SuperSchool,146,15,131
2025-09-26,13,Primaria 4°,TopKids,197,11,186
2025-09-26,13,Primaria 4°,EduMax,145,24,121
2025-09-26,13,Primaria 4°,TopKids,53,12,41
2025-09-26,13,Primaria 5°,EduMax,108,20,88
2025-09-26,13,Primaria 5°,TopKids,171,16,155
2025-09-26,13,Primaria 5°,SuperSchool,232,10,222
2025-09-26,13,Primaria 5°,EduMax,133,5,128
2025-09-26,13,Primaria 5°,EduMax,157,18,139
2025-09-26,13,Primaria 5°,TopKids,246,3,243
2025-09-26,13,Primaria 5°,TopKids,90,4,86
2025-09-26,13,Primaria 5°,EduMax,165,17,148
2025-09-26,13,Primaria 5°,TopKids,142,13,129
2025-09-26,13,Primaria 5°,SuperSchool,237,24,213
2025-09-26,13,Primaria 5°,EduMax,167,15,152
2025-09-26,13,Primaria 5°,SuperSchool,233,1,232
2025-09-26,13,Primaria 5°,SuperSchool,186,13,173
2025-09-26,13,Primaria 5°,TopKids,205,23,182
2025-09-26,13,Primaria 5°,SuperSchool,282,5,277
2025-09-26,13,Primaria 6°,TopKids,111,16,95
2025-09-26,13,Primaria 6°,EduMax,239,15,224
2025-09-26,13,Primaria 6°,EduMax,290,5,285
2025-09-26,13,Primaria 6°,EduMax,288,20,268
2025-09-26,13,Primaria 6°,SuperSchool,56,1,55
2025-09-26,13,Primaria 6°,EduMax,295,20,275
2025-09-26,13,Primaria 6°,EduMax,100,4,96
2025-09-26,13,Primaria 6°,EduMax,264,1,263
2025-09-26,13,Primaria 6°,SuperSchool,116,18,98
2025-09-26,13,Primaria 6°,TopKids,212,13,199
2025-09-26,13,Primaria 6°,SuperSchool,62,22,40
2025-09-26,13,Primaria 6°,SuperSchool,130,11,119
2025-09-26,13,Primaria 6°,EduMax,232,15,217
2025-09-26,13,Primaria 6°,SuperSchool,91,9,82
2025-09-26,13,Primaria 6°,TopKids,234,10,224
2025-09-26,13,Primaria 6°,SuperSchool,190,16,174
2025-09-26,13,Primaria 6°,EduMax,121,23,98
2025-09-26,13,Primaria 6°,TopKids,211,1,210
2025-09-26,14,Preescolar,TopKids,151,2,149
2025-09-26,14,Preescolar,TopKids,155,9,146
2025-09-26,14,Preescolar,EduMax,267,15,252
2025-09-26,14,Preescolar,TopKids,128,21,107
2025-09-26,14,Preescolar,TopKids,275,17,258
2025-09-26,14,Preescolar,TopKids,136,18,118
2025-09-26,14,Preescolar,EduMax,72,1,71
2025-09-26,14,Preescolar,TopKids,253,6,247
2025-09-26,14,Kínder,SuperSchool,290,2,288
2025-09-26,14,Kínder,SuperSchool,259,15,244
2025-09-26,14,Kínder,SuperSchool,209,20,189
2025-09-26,14,Kínder,EduMax,126,12,114
2025-09-26,14,Kínder,TopKids,185,18,167
2025-09-26,14,Kínder,SuperSchool,205,15,190
2025-09-26,14,Primaria 1°,TopKids,274,6,268
2025-09-26,14,Primaria 1°,TopKids,129,24,105
2025-09-26,14,Primaria 1°,SuperSchool,159,8,151
2025-09-26,14,Primaria 1°,EduMax,236,17,219
2025-09-26,14,Primaria 1°,TopKids,127,20,107
2025-09-26,14,Primaria 1°,SuperSchool,188,6,182
2025-09-26,14,Primaria 1°,SuperSchool,182,11,171
2025-09-26,14,Primaria 1°,TopKids,291,7,284
2025-09-26,14,Primaria 1°,SuperSchool,72,1,71
2025-09-26,14,Primaria 1°,EduMax,285,11,274
2025-09-26,14,Primaria 1°,SuperSchool,97,2,95
2025-09-26,14,Primaria 1°,SuperSchool,112,6,106
2025-09-26,14,Primaria 1°,SuperSchool,290,2,288
2025-09-26,14,Primaria 1°,TopKids,154,3,151
2025-09-26,14,Primaria 1°,EduMax,59,5,54
2025-09-26,14,Primaria 1°,SuperSchool,80,24,56
2025-09-26,14,Primaria 2°,TopKids,100,23,77
2025-09-26,14,Primaria 2°,EduMax,287,4,283
2025-09-26,14,Primaria 2°,TopKids,276,23,253
2025-09-26,14,Primaria 2°,EduMax,71,14,57
2025-09-26,14,Primaria 2°,TopKids,267,19,248
2025-09-26,14,Primaria 2°,SuperSchool,245,22,223
2025-09-26,14,Primaria 2°,SuperSchool,170,21,149
2025-09-26,14,Primaria 2°,SuperSchool,64,16,48
2025-09-26,14,Primaria 2°,EduMax,231,4,227
2025-09-26,14,Primaria 2°,EduMax,299,5,294
2025-09-26,14,Primaria 2°,EduMax,227,8,219
2025-09-26,14,Primaria 2°,TopKids,245,13,232
2025-09-26,14,Primaria 2°,EduMax,58,6,52
2025-09-26,14,Primaria 2°,SuperSchool,70,23,47
2025-09-26,14,Primaria 2°,EduMax,101,22,79
2025-09-26,14,Primaria 2°,TopKids,293,20,273
2025-09-26,14,Primaria 2°,SuperSchool,281,13,268
2025-09-26,14,Primaria 2°,TopKids,169,22,147
2025-09-26,14,Primaria 3°,SuperSchool,63,18,45
2025-09-26,14,Primaria 3°,TopKids,146,7,139
2025-09-26,14,Primaria 3°,EduMax,237,23,214
2025-09-26,14,Primaria 3°,EduMax,176,13,163
2025-09-26,14,Primaria 3°,TopKids,217,12,205
2025-09-26,14,Primaria 3°,SuperSchool,208,23,185
2025-09-26,14,Primaria 3°,SuperSchool,232,3,229
2025-09-26,14,Primaria 3°,TopKids,128,21,107
2025-09-26,14,Primaria 3°,SuperSchool,60,19,41
2025-09-26,14,Primaria 3°,SuperSchool,162,2,160
2025-09-26,14,Primaria 3°,SuperSchool,148,13,135
2025-09-26,14,Primaria 3°,TopKids,134,21,113
2025-09-26,14,Primaria 3°,SuperSchool,116,9,107
2025-09-26,14,Primaria 3°,EduMax,141,2,139
2025-09-26,14,Primaria 3°,SuperSchool,198,15,183
2025-09-26,14,Primaria 3°,TopKids,185,8,177
2025-09-26,14,Primaria 3°,EduMax,280,20,260
2025-09-26,14,Primaria 4°,EduMax,88,7,81
2025-09-26,14,Primaria 4°,SuperSchool,252,2,250
2025-09-26,14,Primaria 4°,TopKids,137,19,118
2025-09-26,14,Primaria 4°,SuperSchool,78,21,57
2025-09-26,14,Primaria 4°,SuperSchool,82,13,69
2025-09-26,14,Primaria 4°,EduMax,86,21,65
2025-09-26,14,Primaria 4°,EduMax,155,21,134
2025-09-26,14,Primaria 4°,TopKids,140,7,133
2025-09-26,14,Primaria 4°,EduMax,128,11,117
2025-09-26,14,Primaria 4°,EduMax,241,5,236
2025-09-26,14,Primaria 4°,EduMax,120,12,108
2025-09-26,14,Primaria 4°,EduMax,63,24,39
2025-09-26,14,Primaria 4°,TopKids,147,20,127
2025-09-26,14,Primaria 4°,TopKids,136,3,133
2025-09-26,14,Primaria 4°,SuperSchool,91,7,84
2025-09-26,14,Primaria 4°,SuperSchool,295,18,277
2025-09-26,14,Primaria 4°,SuperSchool,279,10,269
2025-09-26,14,Primaria 5°,EduMax,238,1,237
2025-09-26,14,Primaria 5°,TopKids,209,4,205
2025-09-26,14,Primaria 5°,TopKids,51,23,28
2025-09-26,14,Primaria 5°,TopKids,72,3,69
2025-09-26,14,Primaria 5°,TopKids,75,17,58
2025-09-26,14,Primaria 5°,EduMax,190,8,182
2025-09-26,14,Primaria 5°,TopKids,59,7,52
2025-09-26,14,Primaria 5°,EduMax,181,18,163
2025-09-26,14,Primaria 5°,TopKids,160,20,140
2025-09-26,14,Primaria 5°,SuperSchool,233,8,225
2025-09-26,14,Primaria 5°,SuperSchool,160,13,147
2025-09-26,14,Primaria 5°,EduMax,135,4,131
2025-09-26,14,Primaria 5°,TopKids,143,3,140
2025-09-26,14,Primaria 5°,TopKids,112,13,99
2025-09-26,14,Primaria 5°,SuperSchool,224,6,218
2025-09-26,14,Primaria 5°,EduMax,167,8,159
2025-09-26,14,Primaria 6°,SuperSchool,197,21,176
2025-09-26,14,Primaria 6°,EduMax,145,2,143
2025-09-26,14,Primaria 6°,EduMax,243,9,234
2025-09-26,14,Primaria 6°,TopKids,71,9,62
2025-09-26,14,Primaria 6°,SuperSchool,187,7,180
2025-09-26,14,Primaria 6°,SuperSchool,54,12,42
2025-09-26,14,Primaria 6°,SuperSchool,282,18,264
2025-09-26,14,Primaria 6°,EduMax,251,23,228
2025-09-26,14,Primaria 6°,SuperSchool,166,21,145
2025-09-26,14,Primaria 6°,EduMax,278,18,260
2025-09-26,14,Primaria 6°,EduMax,260,13,247
2025-09-26,14,Primaria 6°,EduMax,194,22,172
2025-09-26,14,Primaria 6°,EduMax,87,23,64
2025-09-26,15,Preescolar,SuperSchool,277,18,259
2025-09-26,15,Preescolar,SuperSchool,114,15,99
2025-09-26,15,Preescolar,EduMax,109,21,88
2025-09-26,15,Preescolar,TopKids,125,13,112
2025-09-26,15,Preescolar,TopKids,84,14,70
2025-09-26,15,Preescolar,TopKids,56,3,53
2025-09-26,15,Preescolar,SuperSchool,90,4,86
2025-09-26,15,Preescolar,EduMax,84,1,83
2025-09-26,15,Preescolar,SuperSchool,154,18,136
2025-09-26,15,Preescolar,SuperSchool,164,19,145
2025-09-26,15,Preescolar,TopKids,173,7,166
2025-09-26,15,Preescolar,TopKids,140,17,123
2025-09-26,15,Preescolar,TopKids,66,23,43
2025-09-26,15,Kínder,SuperSchool,54,7,47
2025-09-26,15,Kínder,TopKids,132,1,131
2025-09-26,15,Kínder,SuperSchool,296,19,277
2025-09-26,15,Kínder,SuperSchool,171,17,154
2025-09-26,15,Kínder,EduMax,264,15,249
2025-09-26,15,Kínder,SuperSchool,69,9,60
2025-09-26,15,Kínder,EduMax,114,16,98
2025-09-26,15,Kínder,EduMax,111,13,98
2025-09-26,15,Kínder,TopKids,60,1,59
2025-09-26,15,Kínder,EduMax,114,6,108
2025-09-26,15,Kínder,TopKids,250,13,237
2025-09-26,15,Kínder,SuperSchool,293,24,269
2025-09-26,15,Kínder,TopKids,158,1,157
2025-09-26,15,Kínder,TopKids,92,20,72
2025-09-26,15,Kínder,SuperSchool,164,14,150
2025-09-26,15,Kínder,EduMax,163,6,157
2025-09-26,15,Kínder,SuperSchool,203,9,194
2025-09-26,15,Kínder,TopKids,171,5,166
2025-09-26,15,Primaria 1°,SuperSchool,282,17,265
2025-09-26,15,Primaria 1°,TopKids,235,21,214
2025-09-26,15,Primaria 1°,SuperSchool,91,9,82
2025-09-26,15,Primaria 1°,TopKids,68,7,61
2025-09-26,15,Primaria 1°,SuperSchool,271,13,258
2025-09-26,15,Primaria 1°,EduMax,195,21,174
2025-09-26,15,Primaria 1°,EduMax,230,8,222
2025-09-26,15,Primaria 2°,SuperSchool,254,20,234
2025-09-26,15,Primaria 2°,SuperSchool,141,12,129
2025-09-26,15,Primaria 2°,TopKids,298,21,277
2025-09-26,15,Primaria 2°,EduMax,264,13,251
2025-09-26,15,Primaria 2°,SuperSchool,277,2,275
2025-09-26,15,Primaria 2°,EduMax,246,2,244
2025-09-26,15,Primaria 2°,EduMax,96,2,94
2025-09-26,15,Primaria 2°,EduMax,261,8,253
2025-09-26,15,Primaria 3°,SuperSchool,129,23,106
2025-09-26,15,Primaria 3°,EduMax,112,24,88
2025-09-26,15,Primaria 3°,EduMax,112,8,104
2025-09-26,15,Primaria 3°,TopKids,166,22,144
2025-09-26,15,Primaria 3°,TopKids,220,8,212
2025-09-26,15,Primaria 3°,TopKids,193,21,172
2025-09-26,15,Primaria 3°,EduMax,177,8,169
2025-09-26,15,Primaria 3°,SuperSchool,231,20,211
2025-09-26,15,Primaria 3°,SuperSchool,267,3,264
2025-09-26,15,Primaria 3°,EduMax,108,1,107
2025-09-26,15,Primaria 3°,TopKids,190,11,179
2025-09-26,15,Primaria 4°,EduMax,71,18,53
2025-09-26,15,Primaria 4°,TopKids,254,8,246
2025-09-26,15,Primaria 4°,SuperSchool,237,18,219
2025-09-26,15,Primaria 4°,EduMax,292,19,273
2025-09-26,15,Primaria 4°,SuperSchool,57,20,37
2025-09-26,15,Primaria 5°,TopKids,115,6,109
2025-09-26,15,Primaria 5°,TopKids,257,15,242
2025-09-26,15,Primaria 5°,EduMax,241,14,227
2025-09-26,15,Primaria 5°,EduMax,165,20,145
2025-09-26,15,Primaria 5°,SuperSchool,171,4,167
2025-09-26,15,Primaria 5°,SuperSchool,266,14,252
2025-09-26,15,Primaria 5°,TopKids,166,21,145
2025-09-26,15,Primaria 5°,TopKids,159,20,139
2025-09-26,15,Primaria 5°,EduMax,292,9,283
2025-09-26,15,Primaria 5°,EduMax,213,4,209
2025-09-26,15,Primaria 5°,EduMax,157,8,149
2025-09-26,15,Primaria 5°,TopKids,280,20,260
2025-09-26,15,Primaria 5°,EduMax,137,10,127
2025-09-26,15,Primaria 6°,SuperSchool,286,9,277
2025-09-26,15,Primaria 6°,EduMax,155,14,141
2025-09-26,15,Primaria 6°,EduMax,52,22,30
2025-09-26,15,Primaria 6°,TopKids,202,24,178
2025-09-26,15,Primaria 6°,TopKids,55,15,40
2025-09-26,15,Primaria 6°,TopKids,89,21,68
2025-09-26,16,Preescolar,EduMax,158,12,146
2025-09-26,16,Preescolar,SuperSchool,69,17,52
2025-09-26,16,Preescolar,TopKids,254,14,240
2025-09-26,16,Preescolar,SuperSchool,94,3,91
2025-09-26,16,Preescolar,SuperSchool,89,6,83
2025-09-26,16,Preescolar,TopKids,60,10,50
2025-09-26,16,Preescolar,EduMax,236,8,228
2025-09-26,16,Preescolar,TopKids,175,7,168
2025-09-26,16,Preescolar,TopKids,104,12,92
2025-09-26,16,Preescolar,TopKids,220,13,207
2025-09-26,16,Preescolar,SuperSchool,268,16,252
2025-09-26,16,Preescolar,SuperSchool,89,12,77
2025-09-26,16,Preescolar,TopKids,276,13,263
2025-09-26,16,Preescolar,TopKids,208,24,184
2025-09-26,16,Kínder,SuperSchool,175,23,152
2025-09-26,16,Kínder,SuperSchool,279,19,260
2025-09-26,16,Kínder,SuperSchool,251,2,249
2025-09-26,16,Kínder,SuperSchool,237,3,234
2025-09-26,16,Kínder,TopKids,183,15,168
2025-09-26,16,Kínder,EduMax,273,21,252
2025-09-26,16,Kínder,SuperSchool,68,14,54
2025-09-26,16,Kínder,SuperSchool,100,2,98
2025-09-26,16,Kínder,SuperSchool,225,3,222
2025-09-26,16,Kínder,EduMax,127,21,106
2025-09-26,16,Kínder,TopKids,248,10,238
2025-09-26,16,Kínder,SuperSchool,186,8,178
2025-09-26,16,Kínder,TopKids,221,6,215
2025-09-26,16,Primaria 1°,TopKids,207,8,199
2025-09-26,16,Primaria 1°,TopKids,51,9,42
2025-09-26,16,Primaria 1°,EduMax,203,8,195
2025-09-26,16,Primaria 1°,EduMax,150,17,133
2025-09-26,16,Primaria 1°,SuperSchool,184,1,183
2025-09-26,16,Primaria 1°,TopKids,283,14,269
2025-09-26,16,Primaria 1°,TopKids,58,11,47
2025-09-26,16,Primaria 1°,TopKids,221,1,220
2025-09-26,16,Primaria 1°,EduMax,198,20,178
2025-09-26,16,Primaria 1°,SuperSchool,296,1,295
2025-09-26,16,Primaria 1°,SuperSchool,195,9,186
2025-09-26,16,Primaria 1°,SuperSchool,169,13,156
2025-09-26,16,Primaria 1°,SuperSchool,92,17,75
2025-09-26,16,Primaria 1°,SuperSchool,297,14,283
2025-09-26,16,Primaria 1°,SuperSchool,200,8,192
2025-09-26,16,Primaria 1°,EduMax,85,18,67
2025-09-26,16,Primaria 1°,SuperSchool,255,22,233
2025-09-26,16,Primaria 1°,SuperSchool,284,11,273
2025-09-26,16,Primaria 1°,SuperSchool,141,8,133
2025-09-26,16,Primaria 2°,SuperSchool,178,16,162
2025-09-26,16,Primaria 2°,EduMax,146,20,126
2025-09-26,16,Primaria 2°,EduMax,283,11,272
2025-09-26,16,Primaria 2°,TopKids,289,5,284
2025-09-26,16,Primaria 2°,SuperSchool,114,18,96
2025-09-26,16,Primaria 2°,SuperSchool,120,1,119
2025-09-26,16,Primaria 2°,TopKids,140,2,138
2025-09-26,16,Primaria 2°,TopKids,211,16,195
2025-09-26,16,Primaria 2°,EduMax,133,16,117
2025-09-26,16,Primaria 2°,SuperSchool,74,4,70
2025-09-26,16,Primaria 2°,EduMax,94,8,86
2025-09-26,16,Primaria 2°,SuperSchool,54,17,37
2025-09-26,16,Primaria 2°,TopKids,120,10,110
2025-09-26,16,Primaria 2°,TopKids,236,3,233
2025-09-26,16,Primaria 2°,TopKids,233,16,217
2025-09-26,16,Primaria 2°,TopKids,192,6,186
2025-09-26,16,Primaria 3°,TopKids,73,19,54
2025-09-26,16,Primaria 3°,TopKids,182,7,175
2025-09-26,16,Primaria 3°,EduMax,142,21,121
2025-09-26,16,Primaria 3°,TopKids,84,2,82
2025-09-26,16,Primaria 3°,TopKids,83,19,64
2025-09-26,16,Primaria 3°,EduMax,178,9,169
2025-09-26,16,Primaria 3°,EduMax,102,16,86
2025-09-26,16,Primaria 3°,EduMax,298,8,290
2025-09-26,16,Primaria 3°,EduMax,104,22,82
2025-09-26,16,Primaria 3°,TopKids,289,20,269
2025-09-26,16,Primaria 3°,EduMax,123,23,100
2025-09-26,16,Primaria 3°,SuperSchool,280,1,279
2025-09-26,16,Primaria 3°,EduMax,58,14,44
2025-09-26,16,Primaria 3°,TopKids,154,2,152
2025-09-26,16,Primaria 4°,TopKids,165,14,151
2025-09-26,16,Primaria 4°,TopKids,113,10,103
2025-09-26,16,Primaria 4°,SuperSchool,146,9,137
2025-09-26,16,Primaria 4°,SuperSchool,92,10,82
2025-09-26,16,Primaria 4°,SuperSchool,82,13,69
2025-09-26,16,Primaria 4°,SuperSchool,103,8,95
2025-09-26,16,Primaria 4°,SuperSchool,201,8,193
2025-09-26,16,Primaria 4°,TopKids,105,17,88
2025-09-26,16,Primaria 4°,SuperSchool,72,12,60
2025-09-26,16,Primaria 4°,SuperSchool,93,11,82
2025-09-26,16,Primaria 4°,EduMax,203,24,179
2025-09-26,16,Primaria 4°,TopKids,142,16,126
2025-09-26,16,Primaria 4°,SuperSchool,201,9,192
2025-09-26,16,Primaria 4°,TopKids,123,11,112
2025-09-26,16,Primaria 4°,SuperSchool,272,3,269
2025-09-26,16,Primaria 4°,SuperSchool,230,11,219
2025-09-26,16,Primaria 4°,TopKids,50,17,33
2025-09-26,16,Primaria 5°,TopKids,275,21,254
2025-09-26,16,Primaria 5°,TopKids,186,24,162
2025-09-26,16,Primaria 5°,SuperSchool,148,22,126
2025-09-26,16,Primaria 5°,EduMax,120,12,108
2025-09-26,16,Primaria 5°,EduMax,109,23,86
2025-09-26,16,Primaria 5°,TopKids,88,9,79
2025-09-26,16,Primaria 5°,SuperSchool,178,3,175
2025-09-26,16,Primaria 6°,TopKids,181,12,169
2025-09-26,16,Primaria 6°,SuperSchool,210,13,197
2025-09-26,16,Primaria 6°,SuperSchool,133,2,131
2025-09-26,16,Primaria 6°,SuperSchool,107,19,88
2025-09-26,16,Primaria 6°,TopKids,193,4,189
2025-09-26,16,Primaria 6°,EduMax,124,24,100
2025-09-26,16,Primaria 6°,SuperSchool,91,2,89
2025-09-26,16,Primaria 6°,TopKids,232,24,208
2025-09-26,16,Primaria 6°,EduMax,244,22,222
2025-09-29,9,Preescolar,EduMax,185,18,167
2025-09-29,9,Preescolar,SuperSchool,177,11,166
2025-09-29,9,Preescolar,EduMax,84,8,76
2025-09-29,9,Preescolar,SuperSchool,192,10,182
2025-09-29,9,Preescolar,EduMax,214,18,196
2025-09-29,9,Preescolar,TopKids,153,14,139
2025-09-29,9,Preescolar,SuperSchool,117,22,95
2025-09-29,9,Preescolar,SuperSchool,89,21,68
2025-09-29,9,Preescolar,SuperSchool,193,16,177
2025-09-29,9,Preescolar,EduMax,72,24,48
2025-09-29,9,Preescolar,SuperSchool,132,8,124
2025-09-29,9,Preescolar,TopKids,100,1,99
2025-09-29,9,Preescolar,SuperSchool,222,4,218
2025-09-29,9,Preescolar,TopKids,138,10,128
2025-09-29,9,Preescolar,TopKids,299,11,288
2025-09-29,9,Preescolar,EduMax,191,5,186
2025-09-29,9,Kínder,TopKids,194,16,178
2025-09-29,9,Kínder,SuperSchool,253,20,233
2025-09-29,9,Kínder,TopKids,108,21,87
2025-09-29,9,Kínder,TopKids,216,5,211
2025-09-29,9,Kínder,SuperSchool,235,4,231
2025-09-29,9,Kínder,EduMax,183,19,164
2025-09-29,9,Kínder,EduMax,283,19,264
2025-09-29,9,Kínder,TopKids,110,10,100
2025-09-29,9,Kínder,SuperSchool,212,22,190
2025-09-29,9,Kínder,EduMax,179,1,178
2025-09-29,9,Kínder,EduMax,94,1,93
2025-09-29,9,Kínder,TopKids,275,10,265
2025-09-29,9,Kínder,EduMax,280,5,275
2025-09-29,9,Kínder,SuperSchool,257,7,250
2025-09-29,9,Kínder,SuperSchool,293,9,284
2025-09-29,9,Kínder,TopKids,137,17,120
2025-09-29,9,Kínder,EduMax,273,11,262
2025-09-29,9,Primaria 1°,TopKids,218,19,199
2025-09-29,9,Primaria 1°,SuperSchool,183,19,164
2025-09-29,9,Primaria 1°,TopKids,136,2,134
2025-09-29,9,Primaria 1°,SuperSchool,116,2,114
2025-09-29,9,Primaria 1°,SuperSchool,273,11,262
2025-09-29,9,Primaria 1°,SuperSchool,156,13,143
2025-09-29,9,Primaria 1°,EduMax,132,24,108
2025-09-29,9,Primaria 1°,EduMax,286,1,285
2025-09-29,9,Primaria 1°,TopKids,126,6,120
2025-09-29,9,Primaria 1°,EduMax,207,19,188
2025-09-29,9,Primaria 1°,EduMax,104,14,90
2025-09-29,9,Primaria 1°,EduMax,66,2,64
2025-09-29,9,Primaria 1°,EduMax,236,5,231
2025-09-29,9,Primaria 1°,TopKids,165,6,159
2025-09-29,9,Primaria 1°,EduMax,118,10,108
2025-09-29,9,Primaria 2°,TopKids,114,6,108
2025-09-29,9,Primaria 2°,SuperSchool,129,10,119
2025-09-29,9,Primaria 2°,TopKids,70,19,51
2025-09-29,9,Primaria 2°,TopKids,128,5,123
2025-09-29,9,Primaria 2°,TopKids,292,10,282
2025-09-29,9,Primaria 2°,EduMax,185,20,165
2025-09-29,9,Primaria 2°,SuperSchool,133,21,112
2025-09-29,9,Primaria 2°,EduMax,94,7,87
2025-09-29,9,Primaria 2°,EduMax,250,19,231
2025-09-29,9,Primaria 2°,SuperSchool,290,23,267
2025-09-29,9,Primaria 2°,EduMax,123,23,100
2025-09-29,9,Primaria 2°,SuperSchool,92,19,73
2025-09-29,9,Primaria 2°,TopKids,100,2,98
2025-09-29,9,Primaria 2°,SuperSchool,112,3,109
2025-09-29,9,Primaria 2°,SuperSchool,298,7,291
2025-09-29,9,Primaria 2°,TopKids,226,1,225
2025-09-29,9,Primaria 2°,EduMax,213,1,212
2025-09-29,9,Primaria 2°,SuperSchool,143,18,125
2025-09-29,9,Primaria 2°,SuperSchool,260,15,245
2025-09-29,9,Primaria 3°,EduMax,93,16,77
2025-09-29,9,Primaria 3°,SuperSchool,158,4,154
2025-09-29,9,Primaria 3°,EduMax,285,19,266
2025-09-29,9,Primaria 3°,SuperSchool,256,9,247
2025-09-29,9,Primaria 3°,EduMax,79,7,72
2025-09-29,9,Primaria 3°,EduMax,218,18,200
2025-09-29,9,Primaria 3°,TopKids,143,8,135
2025-09-29,9,Primaria 3°,SuperSchool,291,13,278
2025-09-29,9,Primaria 3°,TopKids,285,5,280
2025-09-29,9,Primaria 3°,EduMax,267,22,245
2025-09-29,9,Primaria 3°,TopKids,172,1,171
2025-09-29,9,Primaria 3°,EduMax,154,15,139
2025-09-29,9,Primaria 3°,TopKids,248,20,228
2025-09-29,9,Primaria 3°,SuperSchool,145,4,141
2025-09-29,9,Primaria 3°,TopKids,187,4,183
2025-09-29,9,Primaria 3°,EduMax,263,3,260
2025-09-29,9,Primaria 3°,EduMax,153,17,136
2025-09-29,9,Primaria 3°,EduMax,94,18,76
2025-09-29,9,Primaria 3°,TopKids,63,1,62
2025-09-29,9,Primaria 4°,SuperSchool,215,7,208
2025-09-29,9,Primaria 4°,TopKids,82,3,79
2025-09-29,9,Primaria 4°,EduMax,190,6,184
2025-09-29,9,Primaria 4°,EduMax,231,7,224
2025-09-29,9,Primaria 4°,TopKids,232,15,217
2025-09-29,9,Primaria 4°,TopKids,163,1,162
2025-09-29,9,Primaria 4°,EduMax,159,23,136
2025-09-29,9,Primaria 4°,SuperSchool,131,17,114
2025-09-29,9,Primaria 4°,EduMax,285,1,284
2025-09-29,9,Primaria 4°,TopKids,213,5,208
2025-09-29,9,Primaria 4°,SuperSchool,177,2,175
2025-09-29,9,Primaria 4°,TopKids,148,8,140
2025-09-29,9,Primaria 4°,EduMax,149,7,142
2025-09-29,9,Primaria 4°,SuperSchool,196,19,177
2025-09-29,9,Primaria 4°,TopKids,153,14,139
2025-09-29,9,Primaria 4°,EduMax,82,5,77
2025-09-29,9,Primaria 5°,EduMax,288,20,268
2025-09-29,9,Primaria 5°,EduMax,204,24,180
2025-09-29,9,Primaria 5°,SuperSchool,248,18,230
2025-09-29,9,Primaria 5°,EduMax,229,7,222
2025-09-29,9,Primaria 5°,SuperSchool,136,2,134
2025-09-29,9,Primaria 5°,EduMax,90,7,83
2025-09-29,9,Primaria 5°,SuperSchool,241,24,217
2025-09-29,9,Primaria 5°,TopKids,98,21,77
2025-09-29,9,Primaria 5°,TopKids,257,23,234
2025-09-29,9,Primaria 5°,TopKids,255,3,252
2025-09-29,9,Primaria 5°,SuperSchool,185,15,170
2025-09-29,9,Primaria 5°,SuperSchool,122,16,106
2025-09-29,9,Primaria 5°,EduMax,294,18,276
2025-09-29,9,Primaria 5°,TopKids,293,21,272
2025-09-29,9,Primaria 5°,EduMax,61,12,49
2025-09-29,9,Primaria 6°,TopKids,251,2,249
2025-09-29,9,Primaria 6°,SuperSchool,207,12,195
2025-09-29,9,Primaria 6°,TopKids,215,24,191
2025-09-29,9,Primaria 6°,SuperSchool,238,9,229
2025-09-29,9,Primaria 6°,SuperSchool,133,16,117
2025-09-29,9,Primaria 6°,SuperSchool,101,6,95
2025-09-29,9,Primaria 6°,SuperSchool,197,8,189
2025-09-29,9,Primaria 6°,EduMax,61,7,54
2025-09-29,9,Primaria 6°,EduMax,263,10,253
2025-09-29,9,Primaria 6°,SuperSchool,135,24,111
2025-09-29,9,Primaria 6°,TopKids,227,9,218
2025-09-29,9,Primaria 6°,EduMax,246,13,233
2025-09-29,9,Primaria 6°,SuperSchool,167,22,145
2025-09-29,9,Primaria 6°,EduMax,152,3,149
2025-09-29,9,Primaria 6°,SuperSchool,180,22,158
2025-09-29,10,Preescolar,EduMax,251,3,248
2025-09-29,10,Preescolar,SuperSchool,221,12,209
2025-09-29,10,Preescolar,TopKids,253,17,236
2025-09-29,10,Preescolar,EduMax,290,8,282
2025-09-29,10,Preescolar,TopKids,248,23,225
2025-09-29,10,Preescolar,EduMax,203,22,181
2025-09-29,10,Preescolar,TopKids,102,8,94
2025-09-29,10,Preescolar,SuperSchool,83,14,69
2025-09-29,10,Preescolar,EduMax,99,5,94
2025-09-29,10,Preescolar,TopKids,164,6,158
2025-09-29,10,Preescolar,TopKids,135,11,124
2025-09-29,10,Preescolar,EduMax,259,20,239
2025-09-29,10,Kínder,TopKids,153,21,132
2025-09-29,10,Kínder,EduMax,123,17,106
2025-09-29,10,Kínder,EduMax,90,13,77
2025-09-29,10,Kínder,TopKids,98,16,82
2025-09-29,10,Kínder,SuperSchool,225,21,204
2025-09-29,10,Kínder,EduMax,281,10,271
2025-09-29,10,Kínder,EduMax,104,9,95
2025-09-29,10,Kínder,TopKids,145,4,141
2025-09-29,10,Kínder,SuperSchool,168,16,152
2025-09-29,10,Kínder,SuperSchool,291,18,273
2025-09-29,10,Kínder,TopKids,112,19,93
2025-09-29,10,Kínder,SuperSchool,274,3,271
2025-09-29,10,Kínder,EduMax,240,2,238
2025-09-29,10,Kínder,EduMax,130,6,124
2025-09-29,10,Kínder,SuperSchool,111,21,90
2025-09-29,10,Kínder,TopKids,218,22,196
2025-09-29,10,Kínder,SuperSchool,213,7,206
2025-09-29,10,Kínder,SuperSchool,289,20,269
2025-09-29,10,Primaria 1°,EduMax,150,18,132
2025-09-29,10,Primaria 1°,SuperSchool,259,11,248
2025-09-29,10,Primaria 1°,EduMax,221,4,217
2025-09-29,10,Primaria 1°,TopKids,254,19,235
2025-09-29,10,Primaria 1°,TopKids,88,15,73
2025-09-29,10,Primaria 2°,SuperSchool,104,1,103
2025-09-29,10,Primaria 2°,SuperSchool,157,19,138
2025-09-29,10,Primaria 2°,EduMax,202,5,197
2025-09-29,10,Primaria 2°,EduMax,171,11,160
2025-09-29,10,Primaria 2°,EduMax,282,22,260
2025-09-29,10,Primaria 2°,SuperSchool,205,14,191
2025-09-29,10,Primaria 2°,EduMax,93,23,70
2025-09-29,10,Primaria 3°,EduMax,263,4,259
2025-09-29,10,Primaria 3°,EduMax,227,6,221
2025-09-29,10,Primaria 3°,SuperSchool,80,10,70
2025-09-29,10,Primaria 3°,TopKids,137,11,126
2025-09-29,10,Primaria 3°,SuperSchool,204,16,188
2025-09-29,10,Primaria 3°,EduMax,187,7,180
2025-09-29,10,Primaria 3°,TopKids,251,2,249
2025-09-29,10,Primaria 3°,SuperSchool,242,10,232
2025-09-29,10,Primaria 3°,EduMax,82,2,80
2025-09-29,10,Primaria 3°,SuperSchool,162,13,149
2025-09-29,10,Primaria 3°,EduMax,143,24,119
2025-09-29,10,Primaria 3°,EduMax,147,5,142
2025-09-29,10,Primaria 3°,TopKids,115,22,93
2025-09-29,10,Primaria 3°,SuperSchool,217,15,202
2025-09-29,10,Primaria 3°,EduMax,149,12,137
2025-09-29,10,Primaria 4°,EduMax,153,22,131
2025-09-29,10,Primaria 4°,EduMax,276,1,275
2025-09-29,10,Primaria 4°,TopKids,109,17,92
2025-09-29,10,Primaria 4°,SuperSchool,105,18,87
2025-09-29,10,Primaria 4°,TopKids,225,8,217
2025-09-29,10,Primaria 4°,SuperSchool,233,12,221
2025-09-29,10,Primaria 4°,EduMax,208,2,206
2025-09-29,10,Primaria 4°,TopKids,176,22,154
2025-09-29,10,Primaria 4°,SuperSchool,110,20,90
2025-09-29,10,Primaria 5°,SuperSchool,116,24,92
2025-09-29,10,Primaria 5°,TopKids,159,14,145
2025-09-29,10,Primaria 5°,TopKids,204,1,203
2025-09-29,10,Primaria 5°,TopKids,127,4,123
2025-09-29,10,Primaria 5°,SuperSchool,173,11,162
2025-09-29,10,Primaria 6°,TopKids,253,15,238
2025-09-29,10,Primaria 6°,SuperSchool,234,24,210
2025-09-29,10,Primaria 6°,TopKids,203,22,181
2025-09-29,10,Primaria 6°,TopKids,277,6,271
2025-09-29,10,Primaria 6°,EduMax,51,23,28
2025-09-29,11,Preescolar,TopKids,153,20,133
2025-09-29,11,Preescolar,EduMax,113,17,96
2025-09-29,11,Preescolar,TopKids,114,21,93
2025-09-29,11,Preescolar,EduMax,192,11,181
2025-09-29,11,Preescolar,SuperSchool,216,16,200
2025-09-29,11,Preescolar,TopKids,72,12,60
2025-09-29,11,Preescolar,TopKids,147,8,139
2025-09-29,11,Preescolar,TopKids,136,11,125
2025-09-29,11,Preescolar,TopKids,92,2,90
2025-09-29,11,Preescolar,SuperSchool,214,24,190
2025-09-29,11,Preescolar,EduMax,83,15,68
2025-09-29,11,Preescolar,EduMax,189,10,179
2025-09-29,11,Preescolar,TopKids,128,15,113
2025-09-29,11,Kínder,SuperSchool,270,20,250
2025-09-29,11,Kínder,TopKids,180,16,164
2025-09-29,11,Kínder,SuperSchool,260,7,253
2025-09-29,11,Kínder,SuperSchool,277,22,255
2025-09-29,11,Kínder,TopKids,122,17,105
2025-09-29,11,Kínder,SuperSchool,51,7,44
2025-09-29,11,Kínder,TopKids,272,14,258
2025-09-29,11,Kínder,SuperSchool,53,13,40
2025-09-29,11,Kínder,TopKids,59,13,46
2025-09-29,11,Kínder,EduMax,265,12,253
2025-09-29,11,Kínder,TopKids,195,11,184
2025-09-29,11,Kínder,EduMax,231,12,219
2025-09-29,11,Kínder,SuperSchool,102,16,86
2025-09-29,11,Kínder,EduMax,82,7,75
2025-09-29,11,Kínder,TopKids,74,5,69
2025-09-29,11,Kínder,SuperSchool,123,4,119
2025-09-29,11,Primaria 1°,EduMax,296,6,290
2025-09-29,11,Primaria 1°,SuperSchool,189,20,169
2025-09-29,11,Primaria 1°,EduMax,253,1,252
2025-09-29,11,Primaria 1°,EduMax,125,6,119
2025-09-29,11,Primaria 1°,SuperSchool,59,19,40
2025-09-29,11,Primaria 1°,TopKids,82,5,77
2025-09-29,11,Primaria 1°,EduMax,158,2,156
2025-09-29,11,Primaria 1°,EduMax,215,6,209
2025-09-29,11,Primaria 1°,SuperSchool,200,1,199
2025-09-29,11,Primaria 1°,EduMax,293,11,282
2025-09-29,11,Primaria 1°,EduMax,143,4,139
2025-09-29,11,Primaria 1°,EduMax,275,20,255
2025-09-29,11,Primaria 2°,SuperSchool,128,23,105
2025-09-29,11,Primaria 2°,SuperSchool,200,10,190
2025-09-29,11,Primaria 2°,SuperSchool,83,11,72
2025-09-29,11,Primaria 2°,EduMax,204,16,188
2025-09-29,11,Primaria 2°,SuperSchool,282,12,270
2025-09-29,11,Primaria 2°,SuperSchool,276,6,270
2025-09-29,11,Primaria 2°,TopKids,149,14,135
2025-09-29,11,Primaria 2°,SuperSchool,191,2,189
2025-09-29,11,Primaria 2°,SuperSchool,256,12,244
2025-09-29,11,Primaria 2°,EduMax,136,10,126
2025-09-29,11,Primaria 2°,EduMax,212,2,210
2025-09-29,11,Primaria 2°,EduMax,272,11,261
2025-09-29,11,Primaria 2°,TopKids,221,11,210
2025-09-29,11,Primaria 2°,EduMax,182,19,163
2025-09-29,11,Primaria 2°,TopKids,207,17,190
2025-09-29,11,Primaria 2°,SuperSchool,288,20,268
2025-09-29,11,Primaria 2°,SuperSchool,206,12,194
2025-09-29,11,Primaria 3°,TopKids,102,2,100
2025-09-29,11,Primaria 3°,SuperSchool,230,17,213
2025-09-29,11,Primaria 3°,SuperSchool,297,10,287
2025-09-29,11,Primaria 3°,EduMax,73,24,49
2025-09-29,11,Primaria 3°,SuperSchool,85,5,80
2025-09-29,11,Primaria 3°,EduMax,233,3,230
2025-09-29,11,Primaria 3°,SuperSchool,216,20,196
2025-09-29,11,Primaria 3°,EduMax,61,21,40
2025-09-29,11,Primaria 3°,EduMax,133,17,116
2025-09-29,11,Primaria 3°,TopKids,249,11,238
2025-09-29,11,Primaria 3°,SuperSchool,250,19,231
2025-09-29,11,Primaria 3°,EduMax,165,5,160
2025-09-29,11,Primaria 4°,SuperSchool,138,5,133
2025-09-29,11,Primaria 4°,TopKids,84,17,67
2025-09-29,11,Primaria 4°,EduMax,174,10,164
2025-09-29,11,Primaria 4°,SuperSchool,119,24,95
2025-09-29,11,Primaria 4°,EduMax,282,24,258
2025-09-29,11,Primaria 4°,SuperSchool,86,23,63
2025-09-29,11,Primaria 4°,EduMax,298,20,278
2025-09-29,11,Primaria 4°,TopKids,234,16,218
2025-09-29,11,Primaria 4°,TopKids,237,23,214
2025-09-29,11,Primaria 4°,EduMax,90,21,69
2025-09-29,11,Primaria 4°,EduMax,100,4,96
2025-09-29,11,Primaria 4°,SuperSchool,203,2,201
2025-09-29,11,Primaria 4°,TopKids,55,16,39
2025-09-29,11,Primaria 4°,TopKids,159,13,146
2025-09-29,11,Primaria 5°,SuperSchool,67,20,47
2025-09-29,11,Primaria 5°,SuperSchool,199,4,195
2025-09-29,11,Primaria 5°,EduMax,187,20,167
2025-09-29,11,Primaria 5°,EduMax,162,5,157
2025-09-29,11,Primaria 5°,TopKids,199,4,195
2025-09-29,11,Primaria 5°,TopKids,206,22,184
2025-09-29,11,Primaria 5°,SuperSchool,254,7,247
2025-09-29,11,Primaria 5°,SuperSchool,113,22,91
2025-09-29,11,Primaria 5°,SuperSchool,227,22,205
2025-09-29,11,Primaria 5°,TopKids,67,17,50
2025-09-29,11,Primaria 5°,SuperSchool,231,8,223
2025-09-29,11,Primaria 5°,TopKids,183,8,175
2025-09-29,11,Primaria 5°,EduMax,263,8,255
2025-09-29,11,Primaria 5°,TopKids,96,19,77
2025-09-29,11,Primaria 5°,EduMax,245,23,222
2025-09-29,11,Primaria 5°,TopKids,184,2,182
2025-09-29,11,Primaria 6°,EduMax,103,14,89
2025-09-29,11,Primaria 6°,SuperSchool,270,7,263
2025-09-29,11,Primaria 6°,EduMax,246,24,222
2025-09-29,11,Primaria 6°,EduMax,109,19,90
2025-09-29,11,Primaria 6°,EduMax,50,12,38
2025-09-29,11,Primaria 6°,EduMax,124,11,113
2025-09-29,11,Primaria 6°,SuperSchool,211,21,190
2025-09-29,11,Primaria 6°,SuperSchool,210,12,198
2025-09-29,11,Primaria 6°,SuperSchool,125,14,111
2025-09-29,11,Primaria 6°,SuperSchool,157,5,152
2025-09-29,11,Primaria 6°,EduMax,213,24,189
2025-09-29,11,Primaria 6°,TopKids,231,18,213
2025-09-29,11,Primaria 6°,TopKids,163,20,143
2025-09-29,11,Primaria 6°,TopKids,198,15,183
2025-09-29,11,Primaria 6°,SuperSchool,296,8,288
2025-09-29,12,Preescolar,TopKids,91,8,83
2025-09-29,12,Preescolar,SuperSchool,60,21,39
2025-09-29,12,Preescolar,TopKids,93,7,86
2025-09-29,12,Preescolar,EduMax,82,3,79
2025-09-29,12,Preescolar,TopKids,62,4,58
2025-09-29,12,Preescolar,TopKids,75,10,65
2025-09-29,12,Preescolar,EduMax,149,23,126
2025-09-29,12,Preescolar,EduMax,73,23,50
2025-09-29,12,Preescolar,EduMax,217,5,212
2025-09-29,12,Preescolar,EduMax,202,22,180
2025-09-29,12,Preescolar,TopKids,261,17,244
2025-09-29,12,Kínder,TopKids,134,20,114
2025-09-29,12,Kínder,SuperSchool,160,9,151
2025-09-29,12,Kínder,SuperSchool,148,9,139
2025-09-29,12,Kínder,TopKids,262,11,251
2025-09-29,12,Kínder,EduMax,101,21,80
2025-09-29,12,Kínder,SuperSchool,171,18,153
2025-09-29,12,Kínder,TopKids,182,12,170
2025-09-29,12,Kínder,TopKids,183,17,166
2025-09-29,12,Primaria 1°,TopKids,114,23,91
2025-09-29,12,Primaria 1°,SuperSchool,163,10,153
2025-09-29,12,Primaria 1°,TopKids,109,19,90
2025-09-29,12,Primaria 1°,TopKids,258,7,251
2025-09-29,12,Primaria 1°,TopKids,65,20,45
2025-09-29,12,Primaria 1°,SuperSchool,158,4,154
2025-09-29,12,Primaria 1°,EduMax,166,22,144
2025-09-29,12,Primaria 1°,SuperSchool,202,24,178
2025-09-29,12,Primaria 1°,EduMax,269,18,251
2025-09-29,12,Primaria 1°,EduMax,123,17,106
2025-09-29,12,Primaria 1°,EduMax,287,6,281
2025-09-29,12,Primaria 1°,TopKids,255,23,232
2025-09-29,12,Primaria 1°,EduMax,215,1,214
2025-09-29,12,Primaria 1°,SuperSchool,290,17,273
2025-09-29,12,Primaria 1°,EduMax,112,10,102
2025-09-29,12,Primaria 1°,EduMax,274,2,272
2025-09-29,12,Primaria 1°,EduMax,197,3,194
2025-09-29,12,Primaria 1°,SuperSchool,69,3,66
2025-09-29,12,Primaria 2°,EduMax,280,4,276
2025-09-29,12,Primaria 2°,TopKids,151,5,146
2025-09-29,12,Primaria 2°,EduMax,162,16,146
2025-09-29,12,Primaria 2°,TopKids,178,14,164
2025-09-29,12,Primaria 2°,SuperSchool,251,10,241
2025-09-29,12,Primaria 2°,EduMax,281,9,272
2025-09-29,12,Primaria 2°,TopKids,245,11,234
2025-09-29,12,Primaria 3°,SuperSchool,61,13,48
2025-09-29,12,Primaria 3°,SuperSchool,137,1,136
2025-09-29,12,Primaria 3°,EduMax,135,11,124
2025-09-29,12,Primaria 3°,SuperSchool,208,24,184
2025-09-29,12,Primaria 3°,EduMax,86,11,75
2025-09-29,12,Primaria 3°,SuperSchool,221,3,218
2025-09-29,12,Primaria 3°,SuperSchool,144,17,127
2025-09-29,12,Primaria 3°,TopKids,217,6,211
2025-09-29,12,Primaria 3°,TopKids,176,10,166
2025-09-29,12,Primaria 3°,EduMax,272,4,268
2025-09-29,12,Primaria 3°,SuperSchool,91,20,71
2025-09-29,12,Primaria 4°,EduMax,60,18,42
2025-09-29,12,Primaria 4°,TopKids,122,12,110
2025-09-29,12,Primaria 4°,TopKids,208,11,197
2025-09-29,12,Primaria 4°,EduMax,99,23,76
2025-09-29,12,Primaria 4°,EduMax,257,9,248
2025-09-29,12,Primaria 5°,SuperSchool,254,4,250
2025-09-29,12,Primaria 5°,SuperSchool,221,2,219
2025-09-29,12,Primaria 5°,SuperSchool,64,13,51
2025-09-29,12,Primaria 5°,EduMax,267,6,261
2025-09-29,12,Primaria 5°,SuperSchool,93,1,92
2025-09-29,12,Primaria 5°,TopKids,148,10,138
2025-09-29,12,Primaria 5°,EduMax,278,22,256
2025-09-29,12,Primaria 5°,EduMax,124,14,110
2025-09-29,12,Primaria 5°,SuperSchool,172,20,152
2025-09-29,12,Primaria 5°,SuperSchool,94,9,85
2025-09-29,12,Primaria 5°,EduMax,283,11,272
2025-09-29,12,Primaria 5°,EduMax,230,24,206
2025-09-29,12,Primaria 5°,SuperSchool,118,16,102
2025-09-29,12,Primaria 5°,SuperSchool,281,15,266
2025-09-29,12,Primaria 5°,TopKids,122,15,107
2025-09-29,12,Primaria 5°,SuperSchool,185,14,171
2025-09-29,12,Primaria 6°,TopKids,209,23,186
2025-09-29,12,Primaria 6°,SuperSchool,160,7,153
2025-09-29,12,Primaria 6°,TopKids,283,6,277
2025-09-29,12,Primaria 6°,EduMax,157,17,140
2025-09-29,12,Primaria 6°,EduMax,142,10,132
2025-09-29,12,Primaria 6°,SuperSchool,60,18,42
2025-09-29,12,Primaria 6°,SuperSchool,197,16,181
2025-09-29,12,Primaria 6°,TopKids,136,14,122
2025-09-29,12,Primaria 6°,SuperSchool,76,13,63
2025-09-29,12,Primaria 6°,SuperSchool,265,12,253
2025-09-29,12,Primaria 6°,SuperSchool,62,13,49
2025-09-29,13,Preescolar,EduMax,105,24,81
2025-09-29,13,Preescolar,EduMax,268,9,259
2025-09-29,13,Preescolar,SuperSchool,56,13,43
2025-09-29,13,Preescolar,TopKids,275,24,251
2025-09-29,13,Preescolar,SuperSchool,113,9,104
2025-09-29,13,Preescolar,SuperSchool,142,21,121
2025-09-29,13,Preescolar,EduMax,270,9,261
2025-09-29,13,Preescolar,TopKids,135,20,115
2025-09-29,13,Preescolar,SuperSchool,126,10,116
2025-09-29,13,Preescolar,TopKids,61,14,47
2025-09-29,13,Preescolar,EduMax,252,23,229
2025-09-29,13,Preescolar,TopKids,234,20,214
2025-09-29,13,Kínder,SuperSchool,93,2,91
2025-09-29,13,Kínder,EduMax,282,22,260
2025-09-29,13,Kínder,EduMax,151,23,128
2025-09-29,13,Kínder,SuperSchool,229,19,210
2025-09-29,13,Kínder,EduMax,248,21,227
2025-09-29,13,Kínder,SuperSchool,261,9,252
2025-09-29,13,Kínder,TopKids,57,11,46
2025-09-29,13,Kínder,TopKids,198,17,181
2025-09-29,13,Primaria 1°,SuperSchool,64,8,56
2025-09-29,13,Primaria 1°,SuperSchool,249,5,244
2025-09-29,13,Primaria 1°,EduMax,181,15,166
2025-09-29,13,Primaria 1°,SuperSchool,199,10,189
2025-09-29,13,Primaria 1°,SuperSchool,85,1,84
2025-09-29,13,Primaria 1°,TopKids,269,6,263
2025-09-29,13,Primaria 1°,EduMax,179,5,174
2025-09-29,13,Primaria 1°,TopKids,175,19,156
2025-09-29,13,Primaria 1°,EduMax,120,9,111
2025-09-29,13,Primaria 1°,SuperSchool,176,24,152
2025-09-29,13,Primaria 1°,SuperSchool,155,11,144
2025-09-29,13,Primaria 1°,SuperSchool,93,1,92
2025-09-29,13,Primaria 1°,SuperSchool,106,8,98
2025-09-29,13,Primaria 1°,EduMax,221,9,212
2025-09-29,13,Primaria 1°,EduMax,244,2,242
2025-09-29,13,Primaria 1°,SuperSchool,166,18,148
2025-09-29,13,Primaria 2°,EduMax,265,21,244
2025-09-29,13,Primaria 2°,TopKids,93,2,91
2025-09-29,13,Primaria 2°,SuperSchool,296,5,291
2025-09-29,13,Primaria 2°,SuperSchool,291,6,285
2025-09-29,13,Primaria 2°,TopKids,88,16,72
2025-09-29,13,Primaria 2°,TopKids,252,20,232
2025-09-29,13,Primaria 2°,EduMax,292,11,281
2025-09-29,13,Primaria 2°,EduMax,218,12,206
2025-09-29,13,Primaria 2°,SuperSchool,275,10,265
2025-09-29,13,Primaria 3°,EduMax,236,23,213
2025-09-29,13,Primaria 3°,EduMax,277,16,261
2025-09-29,13,Primaria 3°,EduMax,91,21,70
2025-09-29,13,Primaria 3°,TopKids,278,13,265
2025-09-29,13,Primaria 3°,SuperSchool,250,23,227
2025-09-29,13,Primaria 3°,TopKids,149,1,148
2025-09-29,13,Primaria 4°,EduMax,196,1,195
2025-09-29,13,Primaria 4°,SuperSchool,251,4,247
2025-09-29,13,Primaria 4°,TopKids,259,12,247
2025-09-29,13,Primaria 4°,TopKids,56,6,50
2025-09-29,13,Primaria 4°,SuperSchool,243,15,228
2025-09-29,13,Primaria 4°,EduMax,286,11,275
2025-09-29,13,Primaria 4°,EduMax,231,19,212
2025-09-29,13,Primaria 4°,EduMax,250,12,238
2025-09-29,13,Primaria 4°,SuperSchool,92,3,89
2025-09-29,13,Primaria 4°,EduMax,297,13,284
2025-09-29,13,Primaria 4°,EduMax,62,15,47
2025-09-29,13,Primaria 4°,TopKids,241,15,226
2025-09-29,13,Primaria 4°,TopKids,54,5,49
2025-09-29,13,Primaria 4°,EduMax,163,6,157
2025-09-29,13,Primaria 4°,EduMax,143,22,121
2025-09-29,13,Primaria 4°,TopKids,273,20,253
2025-09-29,13,Primaria 4°,EduMax,197,3,194
2025-09-29,13,Primaria 4°,SuperSchool,165,19,146
2025-09-29,13,Primaria 4°,SuperSchool,200,19,181
2025-09-29,13,Primaria 5°,TopKids,55,20,35
2025-09-29,13,Primaria 5°,TopKids,118,1,117
2025-09-29,13,Primaria 5°,EduMax,242,24,218
2025-09-29,13,Primaria 5°,TopKids,82,6,76
2025-09-29,13,Primaria 5°,EduMax,285,17,268
2025-09-29,13,Primaria 5°,EduMax,278,5,273
2025-09-29,13,Primaria 5°,EduMax,253,5,248
2025-09-29,13,Primaria 6°,TopKids,264,20,244
2025-09-29,13,Primaria 6°,EduMax,110,21,89
2025-09-29,13,Primaria 6°,TopKids,215,24,191
2025-09-29,13,Primaria 6°,EduMax,170,11,159
2025-09-29,13,Primaria 6°,EduMax,281,23,258
2025-09-29,13,Primaria 6°,SuperSchool,282,6,276
2025-09-29,13,Primaria 6°,TopKids,143,8,135
2025-09-29,13,Primaria 6°,TopKids,178,13,165
2025-09-29,13,Primaria 6°,EduMax,298,8,290
2025-09-29,13,Primaria 6°,EduMax,191,6,185
2025-09-29,13,Primaria 6°,TopKids,52,23,29
2025-09-29,13,Primaria 6°,EduMax,198,3,195
2025-09-29,13,Primaria 6°,SuperSchool,220,9,211
2025-09-29,13,Primaria 6°,TopKids,141,5,136
2025-09-29,13,Primaria 6°,TopKids,240,7,233
2025-09-29,13,Primaria 6°,EduMax,112,9,103
2025-09-29,13,Primaria 6°,SuperSchool,160,11,149
2025-09-29,13,Primaria 6°,SuperSchool,148,23,125
2025-09-29,14,Preescolar,TopKids,258,24,234
2025-09-29,14,Preescolar,TopKids,110,20,90
2025-09-29,14,Preescolar,EduMax,240,4,236
2025-09-29,14,Preescolar,TopKids,296,7,289
2025-09-29,14,Preescolar,EduMax,137,14,123
2025-09-29,14,Preescolar,SuperSchool,50,23,27
2025-09-29,14,Preescolar,EduMax,140,13,127
2025-09-29,14,Preescolar,TopKids,185,18,167
2025-09-29,14,Preescolar,EduMax,101,6,95
2025-09-29,14,Preescolar,EduMax,76,18,58
2025-09-29,14,Preescolar,SuperSchool,173,18,155
2025-09-29,14,Preescolar,SuperSchool,241,15,226
2025-09-29,14,Preescolar,TopKids,108,3,105
2025-09-29,14,Preescolar,SuperSchool,250,22,228
2025-09-29,14,Preescolar,EduMax,200,20,180
2025-09-29,14,Preescolar,TopKids,166,17,149
2025-09-29,14,Preescolar,TopKids,184,13,171
2025-09-29,14,Kínder,SuperSchool,200,5,195
2025-09-29,14,Kínder,SuperSchool,247,10,237
2025-09-29,14,Kínder,EduMax,212,23,189
2025-09-29,14,Kínder,TopKids,261,7,254
2025-09-29,14,Kínder,SuperSchool,125,5,120
2025-09-29,14,Kínder,SuperSchool,299,19,280
2025-09-29,14,Kínder,SuperSchool,245,12,233
2025-09-29,14,Kínder,SuperSchool,64,2,62
2025-09-29,14,Kínder,EduMax,224,11,213
2025-09-29,14,Kínder,SuperSchool,63,4,59
2025-09-29,14,Kínder,EduMax,153,20,133
2025-09-29,14,Kínder,EduMax,53,17,36
2025-09-29,14,Kínder,SuperSchool,196,8,188
2025-09-29,14,Primaria 1°,SuperSchool,249,14,235
2025-09-29,14,Primaria 1°,EduMax,163,10,153
2025-09-29,14,Primaria 1°,SuperSchool,261,1,260
2025-09-29,14,Primaria 1°,TopKids,133,12,121
2025-09-29,14,Primaria 1°,EduMax,189,7,182
2025-09-29,14,Primaria 1°,SuperSchool,235,3,232
2025-09-29,14,Primaria 1°,TopKids,264,13,251
2025-09-29,14,Primaria 1°,SuperSchool,124,20,104
2025-09-29,14,Primaria 1°,SuperSchool,112,15,97
2025-09-29,14,Primaria 1°,EduMax,76,6,70
2025-09-29,14,Primaria 1°,EduMax,280,9,271
2025-09-29,14,Primaria 1°,EduMax,171,9,162
2025-09-29,14,Primaria 1°,SuperSchool,259,1,258
2025-09-29,14,Primaria 2°,EduMax,125,1,124
2025-09-29,14,Primaria 2°,TopKids,171,14,157
2025-09-29,14,Primaria 2°,EduMax,267,16,251
2025-09-29,14,Primaria 2°,EduMax,162,13,149
2025-09-29,14,Primaria 2°,EduMax,72,19,53
2025-09-29,14,Primaria 2°,SuperSchool,266,20,246
2025-09-29,14,Primaria 3°,EduMax,218,21,197
2025-09-29,14,Primaria 3°,TopKids,157,8,149
2025-09-29,14,Primaria 3°,SuperSchool,92,1,91
2025-09-29,14,Primaria 3°,TopKids,260,23,237
2025-09-29,14,Primaria 3°,EduMax,83,14,69
2025-09-29,14,Primaria 3°,TopKids,111,15,96
2025-09-29,14,Primaria 4°,SuperSchool,272,16,256
2025-09-29,14,Primaria 4°,EduMax,117,2,115
2025-09-29,14,Primaria 4°,TopKids,132,19,113
2025-09-29,14,Primaria 4°,TopKids,197,15,182
2025-09-29,14,Primaria 4°,TopKids,152,9,143
2025-09-29,14,Primaria 4°,EduMax,206,15,191
2025-09-29,14,Primaria 5°,SuperSchool,184,22,162
2025-09-29,14,Primaria 5°,EduMax,298,24,274
2025-09-29,14,Primaria 5°,EduMax,292,6,286
2025-09-29,14,Primaria 5°,SuperSchool,131,2,129
2025-09-29,14,Primaria 5°,SuperSchool,134,1,133
2025-09-29,14,Primaria 5°,TopKids,251,3,248
2025-09-29,14,Primaria 5°,SuperSchool,209,10,199
2025-09-29,14,Primaria 5°,SuperSchool,52,22,30
2025-09-29,14,Primaria 6°,EduMax,264,9,255
2025-09-29,14,Primaria 6°,EduMax,230,24,206
2025-09-29,14,Primaria 6°,SuperSchool,82,17,65
2025-09-29,14,Primaria 6°,TopKids,190,5,185
2025-09-29,14,Primaria 6°,TopKids,78,9,69
2025-09-29,14,Primaria 6°,SuperSchool,287,19,268
2025-09-29,14,Primaria 6°,SuperSchool,148,16,132
2025-09-29,14,Primaria 6°,TopKids,134,11,123
2025-09-29,14,Primaria 6°,EduMax,237,15,222
2025-09-29,14,Primaria 6°,SuperSchool,222,20,202
2025-09-29,15,Preescolar,SuperSchool,103,4,99
2025-09-29,15,Preescolar,TopKids,224,21,203
2025-09-29,15,Preescolar,SuperSchool,284,18,266
2025-09-29,15,Preescolar,EduMax,225,4,221
2025-09-29,15,Preescolar,SuperSchool,292,23,269
2025-09-29,15,Preescolar,SuperSchool,64,6,58
2025-09-29,15,Preescolar,EduMax,108,23,85
2025-09-29,15,Preescolar,EduMax,91,20,71
2025-09-29,15,Preescolar,EduMax,208,6,202
2025-09-29,15,Preescolar,TopKids,215,15,200
2025-09-29,15,Kínder,EduMax,230,11,219
2025-09-29,15,Kínder,EduMax,242,14,228
2025-09-29,15,Kínder,EduMax,59,17,42
2025-09-29,15,Kínder,TopKids,283,15,268
2025-09-29,15,Kínder,TopKids,199,18,181
2025-09-29,15,Primaria 1°,TopKids,75,7,68
2025-09-29,15,Primaria 1°,TopKids,227,17,210
2025-09-29,15,Primaria 1°,TopKids,257,23,234
2025-09-29,15,Primaria 1°,TopKids,207,13,194
2025-09-29,15,Primaria 1°,SuperSchool,184,19,165
2025-09-29,15,Primaria 1°,EduMax,228,12,216
2025-09-29,15,Primaria 1°,SuperSchool,168,17,151
2025-09-29,15,Primaria 1°,SuperSchool,155,18,137
2025-09-29,15,Primaria 1°,SuperSchool,256,11,245
2025-09-29,15,Primaria 1°,SuperSchool,183,13,170
2025-09-29,15,Primaria 1°,EduMax,121,7,114
2025-09-29,15,Primaria 1°,SuperSchool,150,16,134
2025-09-29,15,Primaria 2°,EduMax,193,15,178
2025-09-29,15,Primaria 2°,EduMax,230,8,222
2025-09-29,15,Primaria 2°,TopKids,58,21,37
2025-09-29,15,Primaria 2°,SuperSchool,118,19,99
2025-09-29,15,Primaria 2°,SuperSchool,161,16,145
2025-09-29,15,Primaria 2°,EduMax,253,16,237
2025-09-29,15,Primaria 2°,SuperSchool,182,3,179
2025-09-29,15,Primaria 2°,TopKids,165,14,151
2025-09-29,15,Primaria 2°,SuperSchool,246,8,238
2025-09-29,15,Primaria 2°,EduMax,103,7,96
2025-09-29,15,Primaria 2°,EduMax,91,3,88
2025-09-29,15,Primaria 2°,EduMax,168,19,149
2025-09-29,15,Primaria 2°,EduMax,275,19,256
2025-09-29,15,Primaria 2°,EduMax,98,23,75
2025-09-29,15,Primaria 2°,TopKids,191,22,169
2025-09-29,15,Primaria 2°,EduMax,52,11,41
2025-09-29,15,Primaria 2°,EduMax,116,9,107
2025-09-29,15,Primaria 2°,EduMax,176,5,171
2025-09-29,15,Primaria 3°,TopKids,171,16,155
2025-09-29,15,Primaria 3°,EduMax,55,4,51
2025-09-29,15,Primaria 3°,TopKids,222,1,221
2025-09-29,15,Primaria 3°,EduMax,240,15,225
2025-09-29,15,Primaria 3°,TopKids,254,23,231
2025-09-29,15,Primaria 3°,EduMax,288,8,280
2025-09-29,15,Primaria 3°,SuperSchool,278,3,275
2025-09-29,15,Primaria 3°,TopKids,89,16,73
2025-09-29,15,Primaria 3°,SuperSchool,140,10,130
2025-09-29,15,Primaria 3°,SuperSchool,114,19,95
2025-09-29,15,Primaria 3°,EduMax,78,18,60
2025-09-29,15,Primaria 3°,SuperSchool,156,1,155
2025-09-29,15,Primaria 3°,TopKids,263,11,252
2025-09-29,15,Primaria 3°,TopKids,150,20,130
2025-09-29,15,Primaria 4°,EduMax,249,22,227
2025-09-29,15,Primaria 4°,TopKids,84,16,68
2025-09-29,15,Primaria 4°,SuperSchool,211,20,191
2025-09-29,15,Primaria 4°,SuperSchool,293,13,280
2025-09-29,15,Primaria 4°,TopKids,254,21,233
2025-09-29,15,Primaria 4°,EduMax,207,16,191
2025-09-29,15,Primaria 4°,SuperSchool,143,10,133
2025-09-29,15,Primaria 4°,TopKids,275,4,271
2025-09-29,15,Primaria 4°,TopKids,71,22,49
2025-09-29,15,Primaria 4°,SuperSchool,97,23,74
2025-09-29,15,Primaria 5°,EduMax,164,5,159
2025-09-29,15,Primaria 5°,TopKids,279,7,272
2025-09-29,15,Primaria 5°,SuperSchool,210,21,189
2025-09-29,15,Primaria 5°,EduMax,203,10,193
2025-09-29,15,Primaria 5°,EduMax,69,14,55
2025-09-29,15,Primaria 5°,EduMax,166,7,159
2025-09-29,15,Primaria 5°,EduMax,144,8,136
2025-09-29,15,Primaria 5°,EduMax,50,8,42
2025-09-29,15,Primaria 5°,EduMax,132,10,122
2025-09-29,15,Primaria 5°,EduMax,243,5,238
2025-09-29,15,Primaria 5°,SuperSchool,115,20,95
2025-09-29,15,Primaria 6°,TopKids,137,9,128
2025-09-29,15,Primaria 6°,TopKids,97,14,83
2025-09-29,15,Primaria 6°,EduMax,287,22,265
2025-09-29,15,Primaria 6°,TopKids,252,18,234
2025-09-29,15,Primaria 6°,TopKids,137,14,123
2025-09-29,15,Primaria 6°,TopKids,67,4,63
2025-09-29,15,Primaria 6°,SuperSchool,83,19,64
2025-09-29,16,Preescolar,TopKids,124,17,107
2025-09-29,16,Preescolar,EduMax,118,21,97
2025-09-29,16,Preescolar,SuperSchool,97,12,85
2025-09-29,16,Preescolar,SuperSchool,162,14,148
2025-09-29,16,Preescolar,EduMax,184,23,161
2025-09-29,16,Preescolar,TopKids,257,15,242
2025-09-29,16,Preescolar,EduMax,200,22,178
2025-09-29,16,Preescolar,TopKids,194,2,192
2025-09-29,16,Preescolar,EduMax,216,24,192
2025-09-29,16,Preescolar,TopKids,54,21,33
2025-09-29,16,Preescolar,EduMax,197,11,186
2025-09-29,16,Preescolar,EduMax,120,15,105
2025-09-29,16,Preescolar,TopKids,122,2,120
2025-09-29,16,Kínder,TopKids,224,8,216
2025-09-29,16,Kínder,SuperSchool,85,8,77
2025-09-29,16,Kínder,TopKids,190,5,185
2025-09-29,16,Kínder,EduMax,199,18,181
2025-09-29,16,Kínder,TopKids,252,6,246
2025-09-29,16,Kínder,TopKids,174,20,154
2025-09-29,16,Kínder,EduMax,256,3,253
2025-09-29,16,Kínder,SuperSchool,271,22,249
2025-09-29,16,Primaria 1°,EduMax,234,16,218
2025-09-29,16,Primaria 1°,EduMax,162,11,151
2025-09-29,16,Primaria 1°,SuperSchool,125,8,117
2025-09-29,16,Primaria 1°,TopKids,92,13,79
2025-09-29,16,Primaria 1°,SuperSchool,218,15,203
2025-09-29,16,Primaria 1°,EduMax,236,21,215
2025-09-29,16,Primaria 1°,TopKids,78,9,69
2025-09-29,16,Primaria 1°,EduMax,216,17,199
2025-09-29,16,Primaria 1°,TopKids,243,17,226
2025-09-29,16,Primaria 1°,SuperSchool,204,7,197
2025-09-29,16,Primaria 1°,TopKids,267,20,247
2025-09-29,16,Primaria 1°,EduMax,294,7,287
2025-09-29,16,Primaria 1°,EduMax,136,19,117
2025-09-29,16,Primaria 1°,EduMax,89,7,82
2025-09-29,16,Primaria 1°,SuperSchool,202,6,196
2025-09-29,16,Primaria 1°,TopKids,174,4,170
2025-09-29,16,Primaria 1°,TopKids,199,18,181
2025-09-29,16,Primaria 1°,EduMax,121,10,111
2025-09-29,16,Primaria 1°,SuperSchool,280,17,263
2025-09-29,16,Primaria 2°,TopKids,187,7,180
2025-09-29,16,Primaria 2°,EduMax,248,10,238
2025-09-29,16,Primaria 2°,SuperSchool,276,9,267
2025-09-29,16,Primaria 2°,SuperSchool,106,16,90
2025-09-29,16,Primaria 2°,SuperSchool,284,23,261
2025-09-29,16,Primaria 2°,TopKids,106,18,88
2025-09-29,16,Primaria 2°,EduMax,288,5,283
2025-09-29,16,Primaria 2°,TopKids,278,4,274
2025-09-29,16,Primaria 2°,EduMax,135,12,123
2025-09-29,16,Primaria 2°,SuperSchool,57,9,48
2025-09-29,16,Primaria 3°,SuperSchool,158,22,136
2025-09-29,16,Primaria 3°,SuperSchool,151,1,150
2025-09-29,16,Primaria 3°,EduMax,214,13,201
2025-09-29,16,Primaria 3°,SuperSchool,246,15,231
2025-09-29,16,Primaria 3°,EduMax,244,4,240
2025-09-29,16,Primaria 3°,TopKids,101,12,89
2025-09-29,16,Primaria 3°,EduMax,144,14,130
2025-09-29,16,Primaria 3°,EduMax,68,5,63
2025-09-29,16,Primaria 3°,TopKids,226,19,207
2025-09-29,16,Primaria 3°,TopKids,295,18,277
2025-09-29,16,Primaria 3°,TopKids,157,18,139
2025-09-29,16,Primaria 3°,SuperSchool,222,4,218
2025-09-29,16,Primaria 3°,TopKids,259,20,239
2025-09-29,16,Primaria 3°,SuperSchool,139,2,137
2025-09-29,16,Primaria 3°,EduMax,273,10,263
2025-09-29,16,Primaria 4°,EduMax,133,8,125
2025-09-29,16,Primaria 4°,SuperSchool,117,19,98
2025-09-29,16,Primaria 4°,TopKids,224,5,219
2025-09-29,16,Primaria 4°,EduMax,268,17,251
2025-09-29,16,Primaria 4°,TopKids,266,21,245
2025-09-29,16,Primaria 4°,EduMax,273,5,268
2025-09-29,16,Primaria 4°,TopKids,181,14,167
2025-09-29,16,Primaria 4°,TopKids,85,4,81
2025-09-29,16,Primaria 4°,EduMax,216,19,197
2025-09-29,16,Primaria 4°,SuperSchool,93,19,74
2025-09-29,16,Primaria 4°,SuperSchool,157,9,148
2025-09-29,16,Primaria 4°,EduMax,152,1,151
2025-09-29,16,Primaria 4°,EduMax,251,1,250
2025-09-29,16,Primaria 4°,EduMax,212,11,201
2025-09-29,16,Primaria 4°,TopKids,127,6,121
2025-09-29,16,Primaria 4°,TopKids,280,8,272
2025-09-29,16,Primaria 4°,SuperSchool,264,22,242
2025-09-29,16,Primaria 5°,EduMax,259,15,244
2025-09-29,16,Primaria 5°,SuperSchool,139,18,121
2025-09-29,16,Primaria 5°,TopKids,251,15,236
2025-09-29,16,Primaria 5°,TopKids,107,8,99
2025-09-29,16,Primaria 5°,SuperSchool,235,8,227
2025-09-29,16,Primaria 5°,SuperSchool,223,10,213
2025-09-29,16,Primaria 5°,SuperSchool,187,6,181
2025-09-29,16,Primaria 5°,EduMax,97,18,79
2025-09-29,16,Primaria 5°,SuperSchool,119,9,110
2025-09-29,16,Primaria 6°,TopKids,79,3,76
2025-09-29,16,Primaria 6°,SuperSchool,103,15,88
2025-09-29,16,Primaria 6°,TopKids,260,10,250
2025-09-29,16,Primaria 6°,TopKids,58,7,51
2025-09-29,16,Primaria 6°,SuperSchool,63,2,61
2025-09-29,16,Primaria 6°,EduMax,237,13,224
2025-09-29,16,Primaria 6°,EduMax,236,23,213
2025-09-29,16,Primaria 6°,TopKids,295,8,287
2025-09-29,16,Primaria 6°,TopKids,257,20,237
2025-09-29,16,Primaria 6°,SuperSchool,230,11,219
2025-09-30,9,Preescolar,TopKids,223,4,219
2025-09-30,9,Preescolar,TopKids,164,15,149
2025-09-30,9,Preescolar,EduMax,72,16,56
2025-09-30,9,Preescolar,SuperSchool,180,6,174
2025-09-30,9,Preescolar,SuperSchool,53,1,52
2025-09-30,9,Preescolar,EduMax,57,16,41
2025-09-30,9,Preescolar,TopKids,133,16,117
2025-09-30,9,Preescolar,TopKids,80,2,78
2025-09-30,9,Preescolar,SuperSchool,125,4,121
2025-09-30,9,Preescolar,TopKids,220,2,218
2025-09-30,9,Preescolar,EduMax,98,19,79
2025-09-30,9,Preescolar,SuperSchool,182,14,168
2025-09-30,9,Preescolar,TopKids,233,1,232
2025-09-30,9,Kínder,TopKids,187,15,172
2025-09-30,9,Kínder,TopKids,141,3,138
2025-09-30,9,Kínder,EduMax,82,13,69
2025-09-30,9,Kínder,TopKids,134,10,124
2025-09-30,9,Kínder,TopKids,172,18,154
2025-09-30,9,Kínder,TopKids,166,5,161
2025-09-30,9,Kínder,EduMax,297,16,281
2025-09-30,9,Kínder,EduMax,185,13,172
2025-09-30,9,Primaria 1°,EduMax,190,24,166
2025-09-30,9,Primaria 1°,SuperSchool,108,17,91
2025-09-30,9,Primaria 1°,TopKids,109,9,100
2025-09-30,9,Primaria 1°,EduMax,85,13,72
2025-09-30,9,Primaria 1°,TopKids,118,13,105
2025-09-30,9,Primaria 1°,EduMax,249,23,226
2025-09-30,9,Primaria 1°,TopKids,57,12,45
2025-09-30,9,Primaria 1°,TopKids,194,13,181
2025-09-30,9,Primaria 1°,SuperSchool,154,22,132
2025-09-30,9,Primaria 1°,EduMax,221,24,197
2025-09-30,9,Primaria 1°,EduMax,190,8,182
2025-09-30,9,Primaria 1°,SuperSchool,156,24,132
2025-09-30,9,Primaria 1°,EduMax,120,22,98
2025-09-30,9,Primaria 1°,EduMax,240,24,216
2025-09-30,9,Primaria 1°,EduMax,128,5,123
2025-09-30,9,Primaria 1°,SuperSchool,237,20,217
2025-09-30,9,Primaria 1°,TopKids,164,5,159
2025-09-30,9,Primaria 1°,SuperSchool,171,12,159
2025-09-30,9,Primaria 1°,SuperSchool,271,7,264
2025-09-30,9,Primaria 2°,SuperSchool,124,10,114
2025-09-30,9,Primaria 2°,EduMax,250,6,244
2025-09-30,9,Primaria 2°,EduMax,283,17,266
2025-09-30,9,Primaria 2°,EduMax,203,2,201
2025-09-30,9,Primaria 2°,TopKids,105,4,101
2025-09-30,9,Primaria 2°,TopKids,165,4,161
2025-09-30,9,Primaria 2°,EduMax,268,20,248
2025-09-30,9,Primaria 3°,TopKids,139,3,136
2025-09-30,9,Primaria 3°,SuperSchool,65,11,54
2025-09-30,9,Primaria 3°,SuperSchool,186,22,164
2025-09-30,9,Primaria 3°,SuperSchool,261,24,237
2025-09-30,9,Primaria 3°,TopKids,147,10,137
2025-09-30,9,Primaria 3°,SuperSchool,81,24,57
2025-09-30,9,Primaria 3°,SuperSchool,157,3,154
2025-09-30,9,Primaria 4°,TopKids,176,11,165
2025-09-30,9,Primaria 4°,EduMax,61,5,56
2025-09-30,9,Primaria 4°,EduMax,106,12,94
2025-09-30,9,Primaria 4°,EduMax,274,14,260
2025-09-30,9,Primaria 4°,TopKids,283,12,271
2025-09-30,9,Primaria 4°,EduMax,225,10,215
2025-09-30,9,Primaria 4°,TopKids,285,10,275
2025-09-30,9,Primaria 4°,EduMax,295,11,284
2025-09-30,9,Primaria 4°,SuperSchool,58,12,46
2025-09-30,9,Primaria 4°,EduMax,223,9,214
2025-09-30,9,Primaria 4°,SuperSchool,131,22,109
2025-09-30,9,Primaria 5°,TopKids,271,13,258
2025-09-30,9,Primaria 5°,EduMax,65,13,52
2025-09-30,9,Primaria 5°,EduMax,144,12,132
2025-09-30,9,Primaria 5°,TopKids,155,22,133
2025-09-30,9,Primaria 5°,EduMax,224,17,207
2025-09-30,9,Primaria 5°,EduMax,237,3,234
2025-09-30,9,Primaria 5°,TopKids,237,5,232
2025-09-30,9,Primaria 5°,EduMax,190,16,174
2025-09-30,9,Primaria 5°,EduMax,135,10,125
2025-09-30,9,Primaria 5°,SuperSchool,264,23,241
2025-09-30,9,Primaria 5°,TopKids,209,16,193
2025-09-30,9,Primaria 5°,EduMax,205,1,204
2025-09-30,9,Primaria 5°,EduMax,271,20,251
2025-09-30,9,Primaria 5°,SuperSchool,219,2,217
2025-09-30,9,Primaria 5°,TopKids,151,2,149
2025-09-30,9,Primaria 5°,EduMax,159,6,153
2025-09-30,9,Primaria 5°,SuperSchool,140,8,132
2025-09-30,9,Primaria 6°,SuperSchool,226,20,206
2025-09-30,9,Primaria 6°,EduMax,111,5,106
2025-09-30,9,Primaria 6°,EduMax,110,20,90
2025-09-30,9,Primaria 6°,EduMax,282,8,274
2025-09-30,9,Primaria 6°,TopKids,269,18,251
2025-09-30,9,Primaria 6°,SuperSchool,51,22,29
2025-09-30,9,Primaria 6°,EduMax,279,6,273
2025-09-30,10,Preescolar,TopKids,187,13,174
2025-09-30,10,Preescolar,SuperSchool,141,19,122
2025-09-30,10,Preescolar,TopKids,51,20,31
2025-09-30,10,Preescolar,SuperSchool,191,1,190
2025-09-30,10,Preescolar,TopKids,93,18,75
2025-09-30,10,Preescolar,SuperSchool,134,19,115
2025-09-30,10,Preescolar,EduMax,220,17,203
2025-09-30,10,Preescolar,EduMax,64,16,48
2025-09-30,10,Preescolar,TopKids,95,17,78
2025-09-30,10,Preescolar,EduMax,277,3,274
2025-09-30,10,Preescolar,EduMax,295,6,289
2025-09-30,10,Preescolar,EduMax,268,22,246
2025-09-30,10,Preescolar,EduMax,213,7,206
2025-09-30,10,Preescolar,TopKids,227,12,215
2025-09-30,10,Preescolar,EduMax,246,10,236
2025-09-30,10,Kínder,EduMax,84,9,75
2025-09-30,10,Kínder,SuperSchool,76,10,66
2025-09-30,10,Kínder,SuperSchool,108,10,98
2025-09-30,10,Kínder,SuperSchool,87,4,83
2025-09-30,10,Kínder,TopKids,229,9,220
2025-09-30,10,Primaria 1°,TopKids,295,10,285
2025-09-30,10,Primaria 1°,EduMax,126,5,121
2025-09-30,10,Primaria 1°,TopKids,181,3,178
2025-09-30,10,Primaria 1°,EduMax,72,5,67
2025-09-30,10,Primaria 1°,EduMax,148,5,143
2025-09-30,10,Primaria 1°,SuperSchool,141,6,135
2025-09-30,10,Primaria 1°,TopKids,172,18,154
2025-09-30,10,Primaria 1°,EduMax,263,6,257
2025-09-30,10,Primaria 1°,SuperSchool,271,8,263
2025-09-30,10,Primaria 1°,TopKids,168,15,153
2025-09-30,10,Primaria 1°,SuperSchool,272,5,267
2025-09-30,10,Primaria 1°,TopKids,239,17,222
2025-09-30,10,Primaria 1°,SuperSchool,69,16,53
2025-09-30,10,Primaria 1°,EduMax,286,3,283
2025-09-30,10,Primaria 1°,TopKids,151,15,136
2025-09-30,10,Primaria 1°,TopKids,180,21,159
2025-09-30,10,Primaria 2°,TopKids,230,3,227
2025-09-30,10,Primaria 2°,EduMax,57,16,41
2025-09-30,10,Primaria 2°,TopKids,103,11,92
2025-09-30,10,Primaria 2°,EduMax,210,8,202
2025-09-30,10,Primaria 2°,TopKids,195,18,177
2025-09-30,10,Primaria 2°,SuperSchool,71,11,60
2025-09-30,10,Primaria 2°,EduMax,131,6,125
2025-09-30,10,Primaria 2°,SuperSchool,186,20,166
2025-09-30,10,Primaria 2°,SuperSchool,111,5,106
2025-09-30,10,Primaria 2°,TopKids,71,17,54
2025-09-30,10,Primaria 2°,TopKids,185,19,166
2025-09-30,10,Primaria 2°,EduMax,157,16,141
2025-09-30,10,Primaria 2°,EduMax,117,8,109
2025-09-30,10,Primaria 2°,TopKids,201,12,189
2025-09-30,10,Primaria 2°,TopKids,190,8,182
2025-09-30,10,Primaria 2°,EduMax,222,4,218
2025-09-30,10,Primaria 2°,EduMax,240,1,239
2025-09-30,10,Primaria 3°,TopKids,240,10,230
2025-09-30,10,Primaria 3°,EduMax,188,7,181
2025-09-30,10,Primaria 3°,EduMax,285,21,264
2025-09-30,10,Primaria 3°,EduMax,141,6,135
2025-09-30,10,Primaria 3°,EduMax,138,4,134
2025-09-30,10,Primaria 3°,EduMax,298,7,291
2025-09-30,10,Primaria 3°,SuperSchool,103,7,96
2025-09-30,10,Primaria 3°,SuperSchool,70,22,48
2025-09-30,10,Primaria 3°,SuperSchool,147,10,137
2025-09-30,10,Primaria 3°,SuperSchool,159,5,154
2025-09-30,10,Primaria 3°,EduMax,230,5,225
2025-09-30,10,Primaria 3°,TopKids,156,5,151
2025-09-30,10,Primaria 3°,SuperSchool,74,6,68
2025-09-30,10,Primaria 3°,SuperSchool,208,1,207
2025-09-30,10,Primaria 3°,TopKids,173,5,168
2025-09-30,10,Primaria 4°,EduMax,201,19,182
2025-09-30,10,Primaria 4°,EduMax,280,15,265
2025-09-30,10,Primaria 4°,EduMax,122,7,115
2025-09-30,10,Primaria 4°,TopKids,50,13,37
2025-09-30,10,Primaria 4°,EduMax,91,5,86
2025-09-30,10,Primaria 4°,SuperSchool,84,5,79
2025-09-30,10,Primaria 5°,EduMax,259,20,239
2025-09-30,10,Primaria 5°,EduMax,265,23,242
2025-09-30,10,Primaria 5°,TopKids,232,18,214
2025-09-30,10,Primaria 5°,EduMax,96,12,84
2025-09-30,10,Primaria 5°,SuperSchool,177,4,173
2025-09-30,10,Primaria 5°,SuperSchool,285,11,274
2025-09-30,10,Primaria 5°,EduMax,282,1,281
2025-09-30,10,Primaria 5°,EduMax,113,6,107
2025-09-30,10,Primaria 5°,TopKids,253,23,230
2025-09-30,10,Primaria 5°,SuperSchool,180,1,179
2025-09-30,10,Primaria 5°,TopKids,269,18,251
2025-09-30,10,Primaria 5°,SuperSchool,263,20,243
2025-09-30,10,Primaria 5°,EduMax,293,7,286
2025-09-30,10,Primaria 5°,SuperSchool,53,10,43
2025-09-30,10,Primaria 5°,EduMax,83,4,79
2025-09-30,10,Primaria 6°,SuperSchool,242,16,226
2025-09-30,10,Primaria 6°,SuperSchool,222,14,208
2025-09-30,10,Primaria 6°,TopKids,170,20,150
2025-09-30,10,Primaria 6°,EduMax,57,10,47
2025-09-30,10,Primaria 6°,TopKids,216,5,211
2025-09-30,10,Primaria 6°,TopKids,91,18,73
2025-09-30,11,Preescolar,TopKids,181,10,171
2025-09-30,11,Preescolar,EduMax,227,18,209
2025-09-30,11,Preescolar,TopKids,94,14,80
2025-09-30,11,Preescolar,EduMax,95,1,94
2025-09-30,11,Preescolar,SuperSchool,59,14,45
2025-09-30,11,Preescolar,TopKids,200,7,193
2025-09-30,11,Preescolar,EduMax,96,21,75
2025-09-30,11,Preescolar,TopKids,282,10,272
2025-09-30,11,Preescolar,SuperSchool,188,22,166
2025-09-30,11,Preescolar,EduMax,99,5,94
2025-09-30,11,Preescolar,EduMax,240,18,222
2025-09-30,11,Preescolar,TopKids,291,20,271
2025-09-30,11,Preescolar,SuperSchool,87,12,75
2025-09-30,11,Kínder,TopKids,63,12,51
2025-09-30,11,Kínder,SuperSchool,293,2,291
2025-09-30,11,Kínder,SuperSchool,176,4,172
2025-09-30,11,Kínder,TopKids,91,17,74
2025-09-30,11,Kínder,TopKids,134,10,124
2025-09-30,11,Kínder,SuperSchool,162,16,146
2025-09-30,11,Kínder,TopKids,138,13,125
2025-09-30,11,Kínder,TopKids,168,18,150
2025-09-30,11,Kínder,TopKids,278,8,270
2025-09-30,11,Kínder,EduMax,272,7,265
2025-09-30,11,Kínder,EduMax,67,23,44
2025-09-30,11,Primaria 1°,SuperSchool,297,9,288
2025-09-30,11,Primaria 1°,EduMax,168,8,160
2025-09-30,11,Primaria 1°,EduMax,120,7,113
2025-09-30,11,Primaria 1°,SuperSchool,273,5,268
2025-09-30,11,Primaria 1°,EduMax,262,20,242
2025-09-30,11,Primaria 1°,TopKids,190,14,176
2025-09-30,11,Primaria 1°,SuperSchool,56,24,32
2025-09-30,11,Primaria 1°,SuperSchool,117,9,108
2025-09-30,11,Primaria 1°,TopKids,223,3,220
2025-09-30,11,Primaria 1°,SuperSchool,149,23,126
2025-09-30,11,Primaria 2°,EduMax,53,2,51
2025-09-30,11,Primaria 2°,EduMax,106,4,102
2025-09-30,11,Primaria 2°,SuperSchool,250,2,248
2025-09-30,11,Primaria 2°,EduMax,162,1,161
2025-09-30,11,Primaria 2°,TopKids,55,16,39
2025-09-30,11,Primaria 2°,SuperSchool,214,9,205
2025-09-30,11,Primaria 3°,EduMax,216,15,201
2025-09-30,11,Primaria 3°,EduMax,234,23,211
2025-09-30,11,Primaria 3°,SuperSchool,113,3,110
2025-09-30,11,Primaria 3°,TopKids,174,23,151
2025-09-30,11,Primaria 3°,EduMax,85,12,73
2025-09-30,11,Primaria 3°,EduMax,254,7,247
2025-09-30,11,Primaria 3°,TopKids,236,16,220
2025-09-30,11,Primaria 3°,EduMax,143,7,136
2025-09-30,11,Primaria 3°,TopKids,179,1,178
2025-09-30,11,Primaria 4°,EduMax,97,13,84
2025-09-30,11,Primaria 4°,EduMax,52,14,38
2025-09-30,11,Primaria 4°,EduMax,284,19,265
2025-09-30,11,Primaria 4°,TopKids,165,2,163
2025-09-30,11,Primaria 4°,TopKids,265,6,259
2025-09-30,11,Primaria 4°,SuperSchool,239,24,215
2025-09-30,11,Primaria 4°,SuperSchool,85,13,72
2025-09-30,11,Primaria 4°,TopKids,82,16,66
2025-09-30,11,Primaria 4°,SuperSchool,229,5,224
2025-09-30,11,Primaria 4°,SuperSchool,130,2,128
2025-09-30,11,Primaria 4°,SuperSchool,83,11,72
2025-09-30,11,Primaria 4°,SuperSchool,256,9,247
2025-09-30,11,Primaria 4°,EduMax,100,4,96
2025-09-30,11,Primaria 4°,SuperSchool,226,15,211
2025-09-30,11,Primaria 4°,TopKids,264,13,251
2025-09-30,11,Primaria 5°,SuperSchool,218,18,200
2025-09-30,11,Primaria 5°,SuperSchool,258,17,241
2025-09-30,11,Primaria 5°,TopKids,142,22,120
2025-09-30,11,Primaria 5°,EduMax,284,2,282
2025-09-30,11,Primaria 5°,EduMax,289,17,272
2025-09-30,11,Primaria 5°,SuperSchool,210,22,188
2025-09-30,11,Primaria 5°,SuperSchool,247,11,236
2025-09-30,11,Primaria 5°,EduMax,229,5,224
2025-09-30,11,Primaria 5°,SuperSchool,50,16,34
2025-09-30,11,Primaria 5°,TopKids,188,22,166
2025-09-30,11,Primaria 5°,EduMax,178,13,165
2025-09-30,11,Primaria 5°,SuperSchool,159,17,142
2025-09-30,11,Primaria 6°,EduMax,141,17,124
2025-09-30,11,Primaria 6°,SuperSchool,279,4,275
2025-09-30,11,Primaria 6°,EduMax,213,24,189
2025-09-30,11,Primaria 6°,TopKids,118,14,104
2025-09-30,11,Primaria 6°,TopKids,136,8,128
2025-09-30,11,Primaria 6°,EduMax,233,11,222
2025-09-30,11,Primaria 6°,TopKids,200,13,187
2025-09-30,11,Primaria 6°,EduMax,154,15,139
2025-09-30,11,Primaria 6°,SuperSchool,153,2,151
2025-09-30,11,Primaria 6°,TopKids,110,8,102
2025-09-30,11,Primaria 6°,SuperSchool,202,17,185
2025-09-30,11,Primaria 6°,EduMax,201,19,182
2025-09-30,11,Primaria 6°,EduMax,101,13,88
2025-09-30,11,Primaria 6°,EduMax,168,15,153
2025-09-30,12,Preescolar,SuperSchool,84,16,68
2025-09-30,12,Preescolar,SuperSchool,68,8,60
2025-09-30,12,Preescolar,EduMax,292,13,279
2025-09-30,12,Preescolar,TopKids,203,5,198
2025-09-30,12,Preescolar,EduMax,54,21,33
2025-09-30,12,Preescolar,TopKids,221,6,215
2025-09-30,12,Preescolar,EduMax,264,7,257
2025-09-30,12,Preescolar,EduMax,177,9,168
2025-09-30,12,Preescolar,EduMax,206,17,189
2025-09-30,12,Preescolar,TopKids,247,19,228
2025-09-30,12,Preescolar,TopKids,143,18,125
2025-09-30,12,Preescolar,SuperSchool,146,5,141
2025-09-30,12,Preescolar,SuperSchool,60,24,36
2025-09-30,12,Preescolar,SuperSchool,59,22,37
2025-09-30,12,Kínder,TopKids,137,2,135
2025-09-30,12,Kínder,TopKids,195,18,177
2025-09-30,12,Kínder,EduMax,96,17,79
2025-09-30,12,Kínder,TopKids,297,23,274
2025-09-30,12,Kínder,TopKids,293,15,278
2025-09-30,12,Kínder,SuperSchool,222,18,204
2025-09-30,12,Kínder,SuperSchool,224,18,206
2025-09-30,12,Kínder,TopKids,195,24,171
2025-09-30,12,Primaria 1°,EduMax,207,22,185
2025-09-30,12,Primaria 1°,SuperSchool,198,16,182
2025-09-30,12,Primaria 1°,SuperSchool,243,13,230
2025-09-30,12,Primaria 1°,SuperSchool,71,24,47
2025-09-30,12,Primaria 1°,EduMax,68,19,49
2025-09-30,12,Primaria 1°,EduMax,142,18,124
2025-09-30,12,Primaria 1°,EduMax,264,15,249
2025-09-30,12,Primaria 1°,EduMax,234,16,218
2025-09-30,12,Primaria 1°,TopKids,94,23,71
2025-09-30,12,Primaria 1°,SuperSchool,195,24,171
2025-09-30,12,Primaria 1°,SuperSchool,257,6,251
2025-09-30,12,Primaria 1°,SuperSchool,280,1,279
2025-09-30,12,Primaria 1°,TopKids,232,7,225
2025-09-30,12,Primaria 1°,TopKids,216,1,215
2025-09-30,12,Primaria 1°,SuperSchool,296,23,273
2025-09-30,12,Primaria 1°,TopKids,174,16,158
2025-09-30,12,Primaria 1°,SuperSchool,87,24,63
2025-09-30,12,Primaria 1°,EduMax,182,12,170
2025-09-30,12,Primaria 1°,SuperSchool,286,5,281
2025-09-30,12,Primaria 2°,EduMax,275,20,255
2025-09-30,12,Primaria 2°,EduMax,193,12,181
2025-09-30,12,Primaria 2°,TopKids,181,23,158
2025-09-30,12,Primaria 2°,SuperSchool,125,2,123
2025-09-30,12,Primaria 2°,EduMax,201,11,190
2025-09-30,12,Primaria 2°,SuperSchool,202,7,195
2025-09-30,12,Primaria 2°,SuperSchool,136,14,122
2025-09-30,12,Primaria 2°,TopKids,203,10,193
2025-09-30,12,Primaria 2°,TopKids,105,15,90
2025-09-30,12,Primaria 2°,EduMax,222,4,218
2025-09-30,12,Primaria 2°,SuperSchool,101,18,83
2025-09-30,12,Primaria 2°,TopKids,71,4,67
2025-09-30,12,Primaria 2°,SuperSchool,265,22,243
2025-09-30,12,Primaria 2°,EduMax,109,6,103
2025-09-30,12,Primaria 2°,SuperSchool,253,9,244
2025-09-30,12,Primaria 2°,TopKids,172,13,159
2025-09-30,12,Primaria 2°,SuperSchool,143,3,140
2025-09-30,12,Primaria 2°,TopKids,139,19,120
2025-09-30,12,Primaria 2°,SuperSchool,262,13,249
2025-09-30,12,Primaria 3°,EduMax,285,24,261
2025-09-30,12,Primaria 3°,TopKids,79,24,55
2025-09-30,12,Primaria 3°,EduMax,170,6,164
2025-09-30,12,Primaria 3°,EduMax,154,22,132
2025-09-30,12,Primaria 3°,SuperSchool,173,12,161
2025-09-30,12,Primaria 3°,SuperSchool,200,17,183
2025-09-30,12,Primaria 3°,TopKids,72,21,51
2025-09-30,12,Primaria 3°,SuperSchool,211,4,207
2025-09-30,12,Primaria 3°,SuperSchool,61,2,59
2025-09-30,12,Primaria 4°,TopKids,174,4,170
2025-09-30,12,Primaria 4°,EduMax,183,7,176
2025-09-30,12,Primaria 4°,TopKids,227,24,203
2025-09-30,12,Primaria 4°,SuperSchool,54,22,32
2025-09-30,12,Primaria 4°,EduMax,59,18,41
2025-09-30,12,Primaria 4°,SuperSchool,124,17,107
2025-09-30,12,Primaria 4°,EduMax,156,5,151
2025-09-30,12,Primaria 4°,EduMax,255,16,239
2025-09-30,12,Primaria 4°,EduMax,82,24,58
2025-09-30,12,Primaria 4°,SuperSchool,246,8,238
2025-09-30,12,Primaria 4°,EduMax,89,9,80
2025-09-30,12,Primaria 4°,TopKids,293,3,290
2025-09-30,12,Primaria 4°,EduMax,97,11,86
2025-09-30,12,Primaria 5°,SuperSchool,59,21,38
2025-09-30,12,Primaria 5°,EduMax,249,6,243
2025-09-30,12,Primaria 5°,TopKids,83,8,75
2025-09-30,12,Primaria 5°,SuperSchool,142,3,139
2025-09-30,12,Primaria 5°,EduMax,263,12,251
2025-09-30,12,Primaria 5°,EduMax,260,7,253
2025-09-30,12,Primaria 6°,TopKids,169,23,146
2025-09-30,12,Primaria 6°,SuperSchool,181,21,160
2025-09-30,12,Primaria 6°,EduMax,213,18,195
2025-09-30,12,Primaria 6°,TopKids,126,3,123
2025-09-30,12,Primaria 6°,SuperSchool,226,1,225
2025-09-30,12,Primaria 6°,SuperSchool,188,19,169
2025-09-30,12,Primaria 6°,TopKids,138,14,124
2025-09-30,12,Primaria 6°,TopKids,73,22,51
2025-09-30,12,Primaria 6°,TopKids,228,16,212
2025-09-30,12,Primaria 6°,SuperSchool,171,14,157
2025-09-30,12,Primaria 6°,EduMax,128,18,110
2025-09-30,13,Preescolar,SuperSchool,81,24,57
2025-09-30,13,Preescolar,EduMax,58,12,46
2025-09-30,13,Preescolar,SuperSchool,170,4,166
2025-09-30,13,Preescolar,EduMax,287,4,283
2025-09-30,13,Preescolar,EduMax,91,5,86
2025-09-30,13,Preescolar,TopKids,184,10,174
2025-09-30,13,Preescolar,EduMax,109,20,89
2025-09-30,13,Preescolar,TopKids,286,15,271
2025-09-30,13,Preescolar,SuperSchool,176,5,171
2025-09-30,13,Preescolar,SuperSchool,79,16,63
2025-09-30,13,Preescolar,TopKids,87,4,83
2025-09-30,13,Preescolar,EduMax,72,23,49
2025-09-30,13,Preescolar,EduMax,225,19,206
2025-09-30,13,Preescolar,EduMax,156,14,142
2025-09-30,13,Preescolar,TopKids,192,1,191
2025-09-30,13,Preescolar,TopKids,141,10,131
2025-09-30,13,Kínder,EduMax,201,6,195
2025-09-30,13,Kínder,EduMax,295,19,276
2025-09-30,13,Kínder,EduMax,133,20,113
2025-09-30,13,Kínder,EduMax,188,22,166
2025-09-30,13,Kínder,TopKids,226,20,206
2025-09-30,13,Primaria 1°,EduMax,268,6,262
2025-09-30,13,Primaria 1°,TopKids,143,10,133
2025-09-30,13,Primaria 1°,TopKids,54,4,50
2025-09-30,13,Primaria 1°,TopKids,85,15,70
2025-09-30,13,Primaria 1°,TopKids,87,4,83
2025-09-30,13,Primaria 1°,TopKids,51,15,36
2025-09-30,13,Primaria 1°,TopKids,275,13,262
2025-09-30,13,Primaria 1°,SuperSchool,63,9,54
2025-09-30,13,Primaria 1°,EduMax,186,17,169
2025-09-30,13,Primaria 1°,EduMax,212,22,190
2025-09-30,13,Primaria 1°,SuperSchool,285,5,280
2025-09-30,13,Primaria 1°,EduMax,194,5,189
2025-09-30,13,Primaria 1°,SuperSchool,103,15,88
2025-09-30,13,Primaria 2°,SuperSchool,123,16,107
2025-09-30,13,Primaria 2°,SuperSchool,111,23,88
2025-09-30,13,Primaria 2°,SuperSchool,65,17,48
2025-09-30,13,Primaria 2°,TopKids,92,14,78
2025-09-30,13,Primaria 2°,SuperSchool,120,14,106
2025-09-30,13,Primaria 2°,EduMax,176,5,171
2025-09-30,13,Primaria 2°,TopKids,56,22,34
2025-09-30,13,Primaria 2°,EduMax,153,10,143
2025-09-30,13,Primaria 2°,TopKids,199,23,176
2025-09-30,13,Primaria 2°,TopKids,287,20,267
2025-09-30,13,Primaria 2°,TopKids,295,3,292
2025-09-30,13,Primaria 2°,TopKids,155,7,148
2025-09-30,13,Primaria 2°,TopKids,219,14,205
2025-09-30,13,Primaria 2°,SuperSchool,264,20,244
2025-09-30,13,Primaria 2°,SuperSchool,183,15,168
2025-09-30,13,Primaria 2°,SuperSchool,255,9,246
2025-09-30,13,Primaria 2°,EduMax,273,6,267
2025-09-30,13,Primaria 2°,SuperSchool,196,15,181
2025-09-30,13,Primaria 2°,EduMax,241,19,222
2025-09-30,13,Primaria 3°,TopKids,131,24,107
2025-09-30,13,Primaria 3°,EduMax,100,9,91
2025-09-30,13,Primaria 3°,TopKids,284,4,280
2025-09-30,13,Primaria 3°,EduMax,285,23,262
2025-09-30,13,Primaria 3°,SuperSchool,278,1,277
2025-09-30,13,Primaria 4°,SuperSchool,216,1,215
2025-09-30,13,Primaria 4°,SuperSchool,116,23,93
2025-09-30,13,Primaria 4°,SuperSchool,201,13,188
2025-09-30,13,Primaria 4°,EduMax,197,20,177
2025-09-30,13,Primaria 4°,SuperSchool,134,8,126
2025-09-30,13,Primaria 4°,EduMax,200,23,177
2025-09-30,13,Primaria 4°,TopKids,194,2,192
2025-09-30,13,Primaria 4°,EduMax,265,1,264
2025-09-30,13,Primaria 4°,SuperSchool,298,13,285
2025-09-30,13,Primaria 4°,TopKids,81,10,71
2025-09-30,13,Primaria 4°,EduMax,237,22,215
2025-09-30,13,Primaria 4°,TopKids,64,20,44
2025-09-30,13,Primaria 4°,EduMax,264,2,262
2025-09-30,13,Primaria 5°,EduMax,145,17,128
2025-09-30,13,Primaria 5°,TopKids,74,12,62
2025-09-30,13,Primaria 5°,SuperSchool,61,21,40
2025-09-30,13,Primaria 5°,TopKids,231,17,214
2025-09-30,13,Primaria 5°,EduMax,123,24,99
2025-09-30,13,Primaria 5°,EduMax,293,2,291
2025-09-30,13,Primaria 5°,TopKids,101,1,100
2025-09-30,13,Primaria 5°,EduMax,192,24,168
2025-09-30,13,Primaria 5°,TopKids,183,17,166
2025-09-30,13,Primaria 5°,SuperSchool,178,18,160
2025-09-30,13,Primaria 5°,TopKids,275,3,272
2025-09-30,13,Primaria 5°,TopKids,138,1,137
2025-09-30,13,Primaria 5°,SuperSchool,87,16,71
2025-09-30,13,Primaria 5°,TopKids,90,12,78
2025-09-30,13,Primaria 5°,EduMax,204,24,180
2025-09-30,13,Primaria 5°,TopKids,283,7,276
2025-09-30,13,Primaria 5°,EduMax,94,11,83
2025-09-30,13,Primaria 6°,SuperSchool,89,5,84
2025-09-30,13,Primaria 6°,TopKids,245,4,241
2025-09-30,13,Primaria 6°,SuperSchool,282,1,281
2025-09-30,13,Primaria 6°,EduMax,256,13,243
2025-09-30,13,Primaria 6°,TopKids,86,18,68
2025-09-30,13,Primaria 6°,SuperSchool,92,21,71
2025-09-30,13,Primaria 6°,TopKids,53,7,46
2025-09-30,13,Primaria 6°,EduMax,78,4,74
2025-09-30,13,Primaria 6°,TopKids,145,10,135
2025-09-30,13,Primaria 6°,TopKids,291,1,290
2025-09-30,13,Primaria 6°,SuperSchool,282,17,265
2025-09-30,13,Primaria 6°,SuperSchool,233,23,210
2025-09-30,13,Primaria 6°,TopKids,127,9,118
2025-09-30,13,Primaria 6°,SuperSchool,281,7,274
2025-09-30,13,Primaria 6°,EduMax,147,2,145
2025-09-30,13,Primaria 6°,SuperSchool,133,17,116
2025-09-30,13,Primaria 6°,EduMax,230,5,225
2025-09-30,13,Primaria 6°,SuperSchool,150,4,146
2025-09-30,14,Preescolar,EduMax,171,11,160
2025-09-30,14,Preescolar,SuperSchool,181,9,172
2025-09-30,14,Preescolar,TopKids,84,3,81
2025-09-30,14,Preescolar,TopKids,82,13,69
2025-09-30,14,Preescolar,SuperSchool,221,8,213
2025-09-30,14,Preescolar,TopKids,297,6,291
2025-09-30,14,Preescolar,EduMax,222,3,219
2025-09-30,14,Preescolar,SuperSchool,155,13,142
2025-09-30,14,Preescolar,TopKids,185,11,174
2025-09-30,14,Preescolar,EduMax,174,19,155
2025-09-30,14,Preescolar,SuperSchool,104,2,102
2025-09-30,14,Preescolar,EduMax,97,16,81
2025-09-30,14,Preescolar,TopKids,124,16,108
2025-09-30,14,Preescolar,EduMax,214,9,205
2025-09-30,14,Preescolar,TopKids,230,21,209
2025-09-30,14,Preescolar,SuperSchool,175,6,169
2025-09-30,14,Kínder,EduMax,96,11,85
2025-09-30,14,Kínder,EduMax,110,2,108
2025-09-30,14,Kínder,SuperSchool,206,6,200
2025-09-30,14,Kínder,TopKids,290,9,281
2025-09-30,14,Kínder,EduMax,117,9,108
2025-09-30,14,Kínder,EduMax,241,4,237
2025-09-30,14,Kínder,SuperSchool,284,11,273
2025-09-30,14,Kínder,TopKids,131,8,123
2025-09-30,14,Kínder,EduMax,128,10,118
2025-09-30,14,Kínder,EduMax,243,10,233
2025-09-30,14,Kínder,TopKids,256,22,234
2025-09-30,14,Kínder,EduMax,226,3,223
2025-09-30,14,Kínder,SuperSchool,234,5,229
2025-09-30,14,Kínder,SuperSchool,232,24,208
2025-09-30,14,Kínder,TopKids,273,12,261
2025-09-30,14,Kínder,SuperSchool,232,15,217
2025-09-30,14,Primaria 1°,EduMax,266,19,247
2025-09-30,14,Primaria 1°,TopKids,237,3,234
2025-09-30,14,Primaria 1°,EduMax,188,14,174
2025-09-30,14,Primaria 1°,SuperSchool,150,13,137
2025-09-30,14,Primaria 1°,EduMax,61,7,54
2025-09-30,14,Primaria 1°,TopKids,121,9,112
2025-09-30,14,Primaria 1°,SuperSchool,213,12,201
2025-09-30,14,Primaria 1°,EduMax,238,15,223
2025-09-30,14,Primaria 1°,TopKids,223,7,216
2025-09-30,14,Primaria 1°,TopKids,270,16,254
2025-09-30,14,Primaria 1°,TopKids,89,11,78
2025-09-30,14,Primaria 1°,SuperSchool,290,7,283
2025-09-30,14,Primaria 1°,EduMax,221,20,201
2025-09-30,14,Primaria 1°,EduMax,145,21,124
2025-09-30,14,Primaria 1°,SuperSchool,76,6,70
2025-09-30,14,Primaria 2°,TopKids,147,12,135
2025-09-30,14,Primaria 2°,TopKids,213,7,206
2025-09-30,14,Primaria 2°,SuperSchool,156,16,140
2025-09-30,14,Primaria 2°,EduMax,208,9,199
2025-09-30,14,Primaria 2°,EduMax,62,4,58
2025-09-30,14,Primaria 2°,TopKids,188,16,172
2025-09-30,14,Primaria 2°,EduMax,197,19,178
2025-09-30,14,Primaria 2°,SuperSchool,271,6,265
2025-09-30,14,Primaria 2°,SuperSchool,176,18,158
2025-09-30,14,Primaria 2°,TopKids,195,11,184
2025-09-30,14,Primaria 2°,EduMax,109,24,85
2025-09-30,14,Primaria 2°,TopKids,288,18,270
2025-09-30,14,Primaria 2°,TopKids,92,10,82
2025-09-30,14,Primaria 2°,SuperSchool,133,18,115
2025-09-30,14,Primaria 3°,EduMax,70,13,57
2025-09-30,14,Primaria 3°,EduMax,72,10,62
2025-09-30,14,Primaria 3°,SuperSchool,221,13,208
2025-09-30,14,Primaria 3°,SuperSchool,295,5,290
2025-09-30,14,Primaria 3°,TopKids,189,4,185
2025-09-30,14,Primaria 3°,TopKids,191,3,188
2025-09-30,14,Primaria 3°,EduMax,281,7,274
2025-09-30,14,Primaria 3°,EduMax,243,18,225
2025-09-30,14,Primaria 3°,EduMax,258,14,244
2025-09-30,14,Primaria 3°,EduMax,291,17,274
2025-09-30,14,Primaria 3°,SuperSchool,289,10,279
2025-09-30,14,Primaria 3°,EduMax,214,14,200
2025-09-30,14,Primaria 3°,EduMax,153,1,152
2025-09-30,14,Primaria 4°,TopKids,70,5,65
2025-09-30,14,Primaria 4°,SuperSchool,186,18,168
2025-09-30,14,Primaria 4°,SuperSchool,111,16,95
2025-09-30,14,Primaria 4°,EduMax,170,4,166
2025-09-30,14,Primaria 4°,SuperSchool,168,18,150
2025-09-30,14,Primaria 4°,SuperSchool,281,12,269
2025-09-30,14,Primaria 4°,EduMax,268,17,251
2025-09-30,14,Primaria 4°,TopKids,297,2,295
2025-09-30,14,Primaria 4°,TopKids,285,19,266
2025-09-30,14,Primaria 4°,EduMax,283,10,273
2025-09-30,14,Primaria 4°,EduMax,107,22,85
2025-09-30,14,Primaria 4°,TopKids,267,20,247
2025-09-30,14,Primaria 4°,EduMax,293,18,275
2025-09-30,14,Primaria 5°,SuperSchool,137,15,122
2025-09-30,14,Primaria 5°,TopKids,106,20,86
2025-09-30,14,Primaria 5°,TopKids,95,7,88
2025-09-30,14,Primaria 5°,SuperSchool,200,9,191
2025-09-30,14,Primaria 5°,TopKids,131,13,118
2025-09-30,14,Primaria 5°,TopKids,96,4,92
2025-09-30,14,Primaria 5°,EduMax,251,7,244
2025-09-30,14,Primaria 5°,EduMax,222,18,204
2025-09-30,14,Primaria 5°,TopKids,295,9,286
2025-09-30,14,Primaria 5°,TopKids,65,8,57
2025-09-30,14,Primaria 5°,SuperSchool,150,15,135
2025-09-30,14,Primaria 5°,EduMax,243,5,238
2025-09-30,14,Primaria 5°,EduMax,143,19,124
2025-09-30,14,Primaria 5°,EduMax,76,13,63
2025-09-30,14,Primaria 5°,EduMax,208,4,204
2025-09-30,14,Primaria 5°,TopKids,99,6,93
2025-09-30,14,Primaria 5°,TopKids,188,17,171
2025-09-30,14,Primaria 5°,EduMax,65,19,46
2025-09-30,14,Primaria 6°,TopKids,141,21,120
2025-09-30,14,Primaria 6°,TopKids,200,14,186
2025-09-30,14,Primaria 6°,SuperSchool,98,22,76
2025-09-30,14,Primaria 6°,SuperSchool,249,19,230
2025-09-30,14,Primaria 6°,SuperSchool,172,5,167
2025-09-30,14,Primaria 6°,SuperSchool,156,14,142
2025-09-30,14,Primaria 6°,EduMax,268,12,256
2025-09-30,14,Primaria 6°,TopKids,154,11,143
2025-09-30,14,Primaria 6°,SuperSchool,114,18,96
2025-09-30,14,Primaria 6°,TopKids,191,4,187
2025-09-30,14,Primaria 6°,SuperSchool,198,10,188
2025-09-30,14,Primaria 6°,TopKids,182,3,179
2025-09-30,14,Primaria 6°,EduMax,261,9,252
2025-09-30,14,Primaria 6°,EduMax,92,1,91
2025-09-30,14,Primaria 6°,TopKids,240,16,224
2025-09-30,15,Preescolar,EduMax,170,3,167
2025-09-30,15,Preescolar,TopKids,140,13,127
2025-09-30,15,Preescolar,TopKids,274,23,251
2025-09-30,15,Preescolar,TopKids,193,15,178
2025-09-30,15,Preescolar,EduMax,139,22,117
2025-09-30,15,Preescolar,TopKids,96,20,76
2025-09-30,15,Preescolar,EduMax,258,14,244
2025-09-30,15,Preescolar,EduMax,266,18,248
2025-09-30,15,Preescolar,SuperSchool,242,14,228
2025-09-30,15,Preescolar,TopKids,207,1,206
2025-09-30,15,Preescolar,SuperSchool,74,3,71
2025-09-30,15,Preescolar,TopKids,131,14,117
2025-09-30,15,Preescolar,TopKids,83,20,63
2025-09-30,15,Kínder,TopKids,190,4,186
2025-09-30,15,Kínder,SuperSchool,83,13,70
2025-09-30,15,Kínder,EduMax,53,13,40
2025-09-30,15,Kínder,SuperSchool,264,1,263
2025-09-30,15,Kínder,TopKids,116,23,93
2025-09-30,15,Kínder,TopKids,189,24,165
2025-09-30,15,Kínder,SuperSchool,81,17,64
2025-09-30,15,Kínder,SuperSchool,54,21,33
2025-09-30,15,Kínder,TopKids,166,7,159
2025-09-30,15,Kínder,TopKids,86,12,74
2025-09-30,15,Kínder,TopKids,82,22,60
2025-09-30,15,Kínder,TopKids,225,18,207
2025-09-30,15,Kínder,TopKids,142,5,137
2025-09-30,15,Kínder,SuperSchool,58,12,46
2025-09-30,15,Kínder,TopKids,122,18,104
2025-09-30,15,Kínder,TopKids,295,11,284
2025-09-30,15,Kínder,EduMax,66,1,65
2025-09-30,15,Kínder,SuperSchool,240,3,237
2025-09-30,15,Kínder,SuperSchool,199,1,198
2025-09-30,15,Primaria 1°,SuperSchool,181,22,159
2025-09-30,15,Primaria 1°,TopKids,81,14,67
2025-09-30,15,Primaria 1°,EduMax,149,5,144
2025-09-30,15,Primaria 1°,TopKids,277,8,269
2025-09-30,15,Primaria 1°,TopKids,57,4,53
2025-09-30,15,Primaria 1°,TopKids,61,2,59
2025-09-30,15,Primaria 1°,TopKids,127,19,108
2025-09-30,15,Primaria 1°,SuperSchool,271,17,254
2025-09-30,15,Primaria 1°,SuperSchool,229,21,208
2025-09-30,15,Primaria 1°,SuperSchool,91,7,84
2025-09-30,15,Primaria 1°,EduMax,234,16,218
2025-09-30,15,Primaria 1°,SuperSchool,164,6,158
2025-09-30,15,Primaria 1°,EduMax,283,10,273
2025-09-30,15,Primaria 1°,SuperSchool,292,17,275
2025-09-30,15,Primaria 1°,EduMax,261,3,258
2025-09-30,15,Primaria 1°,SuperSchool,182,13,169
2025-09-30,15,Primaria 1°,EduMax,177,9,168
2025-09-30,15,Primaria 1°,SuperSchool,153,10,143
2025-09-30,15,Primaria 1°,EduMax,174,20,154
2025-09-30,15,Primaria 2°,EduMax,209,12,197
2025-09-30,15,Primaria 2°,SuperSchool,65,3,62
2025-09-30,15,Primaria 2°,SuperSchool,257,17,240
2025-09-30,15,Primaria 2°,TopKids,219,22,197
2025-09-30,15,Primaria 2°,EduMax,70,2,68
2025-09-30,15,Primaria 2°,EduMax,106,5,101
2025-09-30,15,Primaria 2°,EduMax,101,1,100
2025-09-30,15,Primaria 2°,TopKids,180,21,159
2025-09-30,15,Primaria 2°,TopKids,233,18,215
2025-09-30,15,Primaria 2°,TopKids,99,1,98
2025-09-30,15,Primaria 2°,EduMax,162,20,142
2025-09-30,15,Primaria 2°,TopKids,162,1,161
2025-09-30,15,Primaria 2°,TopKids,232,14,218
2025-09-30,15,Primaria 2°,SuperSchool,105,6,99
2025-09-30,15,Primaria 2°,SuperSchool,127,7,120
2025-09-30,15,Primaria 2°,TopKids,121,24,97
2025-09-30,15,Primaria 2°,EduMax,270,9,261
2025-09-30,15,Primaria 2°,TopKids,239,2,237
2025-09-30,15,Primaria 3°,EduMax,156,4,152
2025-09-30,15,Primaria 3°,EduMax,131,2,129
2025-09-30,15,Primaria 3°,SuperSchool,223,13,210
2025-09-30,15,Primaria 3°,SuperSchool,60,22,38
2025-09-30,15,Primaria 3°,TopKids,215,17,198
2025-09-30,15,Primaria 3°,TopKids,170,7,163
2025-09-30,15,Primaria 3°,EduMax,244,18,226
2025-09-30,15,Primaria 3°,SuperSchool,137,21,116
2025-09-30,15,Primaria 3°,TopKids,207,14,193
2025-09-30,15,Primaria 3°,SuperSchool,153,24,129
2025-09-30,15,Primaria 3°,TopKids,227,12,215
2025-09-30,15,Primaria 3°,EduMax,122,2,120
2025-09-30,15,Primaria 4°,SuperSchool,252,22,230
2025-09-30,15,Primaria 4°,EduMax,74,8,66
2025-09-30,15,Primaria 4°,SuperSchool,71,5,66
2025-09-30,15,Primaria 4°,SuperSchool,60,12,48
2025-09-30,15,Primaria 4°,SuperSchool,55,1,54
2025-09-30,15,Primaria 4°,EduMax,201,14,187
2025-09-30,15,Primaria 4°,SuperSchool,125,23,102
2025-09-30,15,Primaria 4°,TopKids,55,23,32
2025-09-30,15,Primaria 4°,SuperSchool,70,16,54
2025-09-30,15,Primaria 4°,SuperSchool,95,9,86
2025-09-30,15,Primaria 4°,SuperSchool,281,14,267
2025-09-30,15,Primaria 4°,TopKids,246,16,230
2025-09-30,15,Primaria 5°,TopKids,236,3,233
2025-09-30,15,Primaria 5°,SuperSchool,116,19,97
2025-09-30,15,Primaria 5°,TopKids,114,22,92
2025-09-30,15,Primaria 5°,TopKids,267,15,252
2025-09-30,15,Primaria 5°,TopKids,74,7,67
2025-09-30,15,Primaria 5°,TopKids,143,24,119
2025-09-30,15,Primaria 5°,SuperSchool,297,16,281
2025-09-30,15,Primaria 5°,EduMax,297,6,291
2025-09-30,15,Primaria 5°,EduMax,191,5,186
2025-09-30,15,Primaria 5°,TopKids,234,23,211
2025-09-30,15,Primaria 5°,TopKids,127,17,110
2025-09-30,15,Primaria 5°,TopKids,242,17,225
2025-09-30,15,Primaria 5°,SuperSchool,193,3,190
2025-09-30,15,Primaria 5°,EduMax,162,16,146
2025-09-30,15,Primaria 6°,SuperSchool,100,15,85
2025-09-30,15,Primaria 6°,TopKids,176,7,169
2025-09-30,15,Primaria 6°,EduMax,120,6,114
2025-09-30,15,Primaria 6°,EduMax,147,7,140
2025-09-30,15,Primaria 6°,SuperSchool,172,2,170
2025-09-30,15,Primaria 6°,EduMax,277,16,261
2025-09-30,15,Primaria 6°,EduMax,155,23,132
2025-09-30,15,Primaria 6°,EduMax,180,14,166
2025-09-30,15,Primaria 6°,SuperSchool,235,11,224
2025-09-30,15,Primaria 6°,TopKids,198,11,187
2025-09-30,15,Primaria 6°,SuperSchool,247,22,225
2025-09-30,15,Primaria 6°,EduMax,152,6,146
2025-09-30,15,Primaria 6°,EduMax,199,16,183
2025-09-30,15,Primaria 6°,EduMax,107,7,100
2025-09-30,15,Primaria 6°,TopKids,172,19,153
2025-09-30,15,Primaria 6°,EduMax,96,21,75
2025-09-30,15,Primaria 6°,EduMax,283,3,280
2025-09-30,15,Primaria 6°,SuperSchool,164,21,143
2025-09-30,16,Preescolar,TopKids,80,22,58
2025-09-30,16,Preescolar,TopKids,130,23,107
2025-09-30,16,Preescolar,TopKids,243,5,238
2025-09-30,16,Preescolar,SuperSchool,78,3,75
2025-09-30,16,Preescolar,TopKids,99,15,84
2025-09-30,16,Preescolar,SuperSchool,202,11,191
2025-09-30,16,Kínder,SuperSchool,161,24,137
2025-09-30,16,Kínder,TopKids,117,22,95
2025-09-30,16,Kínder,TopKids,107,12,95
2025-09-30,16,Kínder,SuperSchool,155,10,145
2025-09-30,16,Kínder,TopKids,278,5,273
2025-09-30,16,Kínder,SuperSchool,117,24,93
2025-09-30,16,Kínder,EduMax,179,3,176
2025-09-30,16,Kínder,SuperSchool,149,8,141
2025-09-30,16,Kínder,SuperSchool,77,22,55
2025-09-30,16,Primaria 1°,EduMax,54,5,49
2025-09-30,16,Primaria 1°,TopKids,208,20,188
2025-09-30,16,Primaria 1°,SuperSchool,180,2,178
2025-09-30,16,Primaria 1°,TopKids,254,24,230
2025-09-30,16,Primaria 1°,EduMax,125,15,110
2025-09-30,16,Primaria 1°,SuperSchool,173,22,151
2025-09-30,16,Primaria 1°,EduMax,270,13,257
2025-09-30,16,Primaria 1°,TopKids,96,20,76
2025-09-30,16,Primaria 1°,EduMax,279,15,264
2025-09-30,16,Primaria 1°,SuperSchool,170,12,158
2025-09-30,16,Primaria 1°,EduMax,54,17,37
2025-09-30,16,Primaria 1°,SuperSchool,109,13,96
2025-09-30,16,Primaria 1°,TopKids,229,2,227
2025-09-30,16,Primaria 1°,SuperSchool,230,3,227
2025-09-30,16,Primaria 1°,TopKids,60,10,50
2025-09-30,16,Primaria 1°,TopKids,188,17,171
2025-09-30,16,Primaria 1°,SuperSchool,56,1,55
2025-09-30,16,Primaria 1°,TopKids,56,4,52
2025-09-30,16,Primaria 2°,TopKids,69,3,66
2025-09-30,16,Primaria 2°,SuperSchool,69,10,59
2025-09-30,16,Primaria 2°,SuperSchool,276,5,271
2025-09-30,16,Primaria 2°,TopKids,166,10,156
2025-09-30,16,Primaria 2°,SuperSchool,252,1,251
2025-09-30,16,Primaria 2°,EduMax,271,20,251
2025-09-30,16,Primaria 2°,SuperSchool,264,4,260
2025-09-30,16,Primaria 2°,TopKids,72,21,51
2025-09-30,16,Primaria 2°,EduMax,213,8,205
2025-09-30,16,Primaria 2°,SuperSchool,211,21,190
2025-09-30,16,Primaria 2°,EduMax,120,3,117
2025-09-30,16,Primaria 3°,TopKids,259,6,253
2025-09-30,16,Primaria 3°,EduMax,101,14,87
2025-09-30,16,Primaria 3°,SuperSchool,243,16,227
2025-09-30,16,Primaria 3°,TopKids,105,8,97
2025-09-30,16,Primaria 3°,TopKids,254,1,253
2025-09-30,16,Primaria 3°,EduMax,117,13,104
2025-09-30,16,Primaria 3°,EduMax,285,12,273
2025-09-30,16,Primaria 3°,SuperSchool,215,11,204
2025-09-30,16,Primaria 3°,EduMax,52,11,41
2025-09-30,16,Primaria 4°,TopKids,181,10,171
2025-09-30,16,Primaria 4°,SuperSchool,190,4,186
2025-09-30,16,Primaria 4°,EduMax,254,22,232
2025-09-30,16,Primaria 4°,TopKids,74,15,59
2025-09-30,16,Primaria 4°,SuperSchool,213,6,207
2025-09-30,16,Primaria 4°,EduMax,211,6,205
2025-09-30,16,Primaria 4°,SuperSchool,244,20,224
2025-09-30,16,Primaria 4°,TopKids,170,11,159
2025-09-30,16,Primaria 4°,TopKids,206,21,185
2025-09-30,16,Primaria 4°,SuperSchool,134,21,113
2025-09-30,16,Primaria 4°,TopKids,224,22,202
2025-09-30,16,Primaria 4°,EduMax,60,23,37
2025-09-30,16,Primaria 4°,EduMax,147,14,133
2025-09-30,16,Primaria 5°,EduMax,202,16,186
2025-09-30,16,Primaria 5°,SuperSchool,243,7,236
2025-09-30,16,Primaria 5°,EduMax,119,2,117
2025-09-30,16,Primaria 5°,EduMax,97,10,87
2025-09-30,16,Primaria 5°,SuperSchool,71,16,55
2025-09-30,16,Primaria 5°,TopKids,224,13,211
2025-09-30,16,Primaria 5°,SuperSchool,291,18,273
2025-09-30,16,Primaria 5°,SuperSchool,52,12,40
2025-09-30,16,Primaria 5°,EduMax,125,11,114
2025-09-30,16,Primaria 5°,SuperSchool,68,19,49
2025-09-30,16,Primaria 5°,EduMax,286,18,268
2025-09-30,16,Primaria 5°,TopKids,53,22,31
2025-09-30,16,Primaria 5°,EduMax,127,5,122
2025-09-30,16,Primaria 6°,TopKids,83,16,67
2025-09-30,16,Primaria 6°,TopKids,247,11,236
2025-09-30,16,Primaria 6°,SuperSchool,172,10,162
2025-09-30,16,Primaria 6°,EduMax,213,2,211
2025-09-30,16,Primaria 6°,TopKids,209,19,190
2025-09-30,16,Primaria 6°,TopKids,186,4,182
2025-09-30,16,Primaria 6°,EduMax,62,9,53
2025-09-30,16,Primaria 6°,EduMax,203,24,179
2025-09-30,16,Primaria 6°,SuperSchool,93,22,71
2025-09-30,16,Primaria 6°,EduMax,126,18,108
2025-09-30,16,Primaria 6°,SuperSchool,107,19,88
2025-09-30,16,Primaria 6°,TopKids,171,17,154
2025-09-30,16,Primaria 6°,TopKids,293,7,286
2025-09-30,16,Primaria 6°,TopKids,216,6,210
2025-09-30,16,Primaria 6°,EduMax,269,1,268
2025-09-30,16,Primaria 6°,EduMax,134,22,112
2025-09-30,16,Primaria 6°,TopKids,58,10,48
